time,subj_course_id,sec_code,sec_id,prof,available,waitlist,total,enrolled_ct
1731500706819,AAPI 198,A00,795102,Solomon; Amanda Lee Albaniel,9999,0,9999,0
1731500707857,AAS 10,A01,734476,Butler; Elizabeth Annette,32,0,34,2
1731500707857,AAS 10,A02,734477,Butler; Elizabeth Annette,33,0,34,1
1731500708890,AAS 11,A01,734479,Butler; Elizabeth Annette,33,0,34,1
1731500708890,AAS 11,A02,734480,Butler; Elizabeth Annette,33,0,34,1
1731500709924,AESE 241,A00,733587,Erat; Sanjiv & Wade; Jon P,35,0,35,0
1731500710958,AESE 278B,A00,733588,Gessner; Richard K.,35,0,35,0
1731500711989,AESE 278C,A00,733589,Wade; Jon P,35,0,35,0
1731500713023,AESE 279A,A00,733591,Zak; Alexander & Wade; Jon P,35,0,35,0
1731500714056,ANAR 121,A01,733532,Staff,39,0,40,1
1731500715093,ANAR 143,A00,799583,Dunseth; Zachary Clark,29,0,30,1
1731500716128,ANAR 158,A00,733535,Goldstein; Paul S,36,0,40,4
1731500717163,ANAR 164,A00,733536,Staff,44,0,45,1
1731500718192,ANAR 165,A00,799586,Staff,30,0,30,0
1731500719223,ANBI 100,A00,733537,Fox; Patrick Keolu Ozer,39,0,40,1
1731500720259,ANBI 130,A00,733538,Non; Amy L,55,0,70,15
1731500721291,ANBI 134,A00,733552,Simonson; Tatum Sasha Summ,28,0,30,2
1731500722322,ANBI 140,A00,733553,Staff,34,0,40,6
1731500723356,ANBI 143,A00,733554,Wilder; Linnea Lorene,36,0,40,4
1731500724388,ANBI 173,A00,733555,Wilder; Linnea Lorene,69,0,70,1
1731500725416,ANES 296,001,791559,Staff,10,0,10,0
1731500725416,ANES 296,002,791560,Staff,10,0,10,0
1731500725416,ANES 296,003,791561,Staff,10,0,10,0
1731500726451,ANSC 101A,A00,733558,Kang; Byung Chu,148,0,150,2
1731500727483,ANSC 109,A00,733559,Pedersen; David,40,0,40,0
1731500728521,ANSC 125,A00,733560,Brenner; Suzanne A,65,0,70,5
1731500729554,ANSC 135,A00,733561,Stone; Annika Britt,38,0,40,2
1731500730589,ANSC 139,A00,733562,Csordas; Thomas J.,20,0,20,0
1731500731623,ANSC 146,A00,733563,Kang; Byung Chu,69,0,70,1
1731500732655,ANSC 148,A00,733564,Schonberg; Jeffrey,46,0,46,0
1731500733687,ANSC 150,A00,733565,Sloane; Julia Kathryn,35,0,35,0
1731500734715,ANSC 154,A00,733566,Brenner; Suzanne A,10,0,12,2
1731500735745,ANSC 164,A00,733567,Stewart; Alexander B,37,0,40,3
1731500736777,ANSC 184,A00,733568,Fortier; Jana,40,0,40,0
1731500737811,ANSC 190,A00,733569,Jassal; Aftab,39,0,40,1
1731500738844,ANTH 5,A00,733397,Semendeferi; Ekaterini,20,0,20,0
1731500739877,ANTH 10,A00,733400,Staff,247,0,250,3
1731500740910,ANTH 21,A01,733407,Stone; Annika Britt,30,0,30,0
1731500740910,ANTH 21,A02,733409,Stone; Annika Britt,29,0,30,1
1731500740910,ANTH 21,A03,733411,Stone; Annika Britt,27,0,30,3
1731500740910,ANTH 21,A04,733414,Stone; Annika Britt,24,0,30,6
1731500740910,ANTH 21,A05,733416,Stone; Annika Britt,27,0,30,3
1731500741943,ANTH 23,A01,733472,Stewart; Alexander B,35,0,35,0
1731500741943,ANTH 23,A02,733501,Stewart; Alexander B,34,0,35,1
1731500741943,ANTH 23,A03,733502,Stewart; Alexander B,34,0,35,1
1731500741943,ANTH 23,A04,733507,Stewart; Alexander B,35,0,35,0
1731500741943,ANTH 23,A05,733525,Stewart; Alexander B,35,0,35,0
1731500741943,ANTH 23,A06,733528,Stewart; Alexander B,35,0,35,0
1731500742970,ANTH 45,A00,733530,Jassal; Aftab,30,0,30,0
1731500744000,ANTH 87,A00,795649,Pedersen; David,20,0,20,0
1731500745034,ANTH 102,A00,733570,Fox; Patrick Keolu Ozer,144,0,150,6
1731500746062,ANTH 106,A00,733571,Sloane; Julia Kathryn,30,0,30,0
1731500747097,ANTH 107,A00,733572,Shtienberg; Gilad,28,0,30,2
1731500748124,ANTH 111,A00,733573,Bialecki; Jon Anthony,39,0,40,1
1731500749152,ANTH 128A,A01,733576,Lewis; Leslie R,12,0,12,0
1731500750181,ANTH 196B,A00,733577,Varma; Saiba,15,0,15,0
1731500751211,ANTH 200,A00,733578,Fox; Patrick Keolu Ozer,15,0,15,0
1731500752241,ANTH 203,A00,733579,Gagneux; Pascal,9,0,15,6
1731500753277,ANTH 212,A00,733582,Marchetto; Maria Carolina,14,0,15,1
1731500754308,ANTH 230,001,799994,Gagneux; Pascal,19,0,20,1
1731500755336,ANTH 231,A00,799587,Staff,13,0,15,2
1731500756369,ANTH 236,A00,733583,Csordas; Thomas J.,9,0,12,3
1731500757400,ANTH 269,A00,733584,Lampland; Martha,5,0,5,0
1731500758429,ANTH 273,A00,733585,McKenzie; Kerry V.,5,0,5,0
1731500759460,ANTH 280F,A00,733586,Yeh; Rihan Wen Xin,13,0,15,2
1731500760512,ANTH 295,001,799995,Algaze; Guillermo,3,0,3,0
1731500760512,ANTH 295,002,799996,Brenner; Suzanne A,3,0,3,0
1731500760512,ANTH 295,003,799997,Csordas; Thomas J.,3,0,3,0
1731500760512,ANTH 295,004,799998,Fox; Patrick Keolu Ozer,3,0,3,0
1731500760512,ANTH 295,005,799999,Gagneux; Pascal,3,0,3,0
1731500760512,ANTH 295,006,800000,Goldstein; Paul S,3,0,3,0
1731500760512,ANTH 295,007,800001,Hankins; Joseph D.,3,0,3,0
1731500760512,ANTH 295,008,800002,Jassal; Aftab,3,0,3,0
1731500760512,ANTH 295,009,800035,Jenkins; Janis A.,3,0,3,0
1731500760512,ANTH 295,010,800036,Kaiser; Bronwyn Nicole,3,0,3,0
1731500760512,ANTH 295,011,800037,Kang; Byung Chu,3,0,3,0
1731500760512,ANTH 295,012,800038,Marchetto; Maria Carolina,3,0,3,0
1731500760512,ANTH 295,013,800039,Non; Amy L,3,0,3,0
1731500760512,ANTH 295,014,800040,Pedersen; David,3,0,3,0
1731500760512,ANTH 295,015,800041,Rivera-Collazo; Isabel C,3,0,3,0
1731500760512,ANTH 295,016,800042,Varma; Saiba,3,0,3,0
1731500760512,ANTH 295,017,800043,Yeh; Rihan Wen Xin,3,0,3,0
1731500761546,ANTH 296,001,800044,Braswell; Geoffrey E.,3,0,3,0
1731500761546,ANTH 296,002,800045,Marchetto; Maria Carolina,3,0,3,0
1731500761546,ANTH 296,003,800107,Rivera-Collazo; Isabel C,3,0,3,0
1731500761546,ANTH 296,004,800108,Varma; Saiba,2,0,3,1
1731500761546,ANTH 296,005,800109,Algaze; Guillermo,3,0,3,0
1731500761546,ANTH 296,006,800110,Brenner; Suzanne A,3,0,3,0
1731500761546,ANTH 296,007,800111,Csordas; Thomas J.,3,0,3,0
1731500761546,ANTH 296,008,800112,Fox; Patrick Keolu Ozer,3,0,3,0
1731500761546,ANTH 296,009,800113,Gagneux; Pascal,3,0,3,0
1731500761546,ANTH 296,010,800114,Goldstein; Paul S,2,0,3,1
1731500761546,ANTH 296,011,800116,Hankins; Joseph D.,3,0,3,0
1731500761546,ANTH 296,012,800117,Jassal; Aftab,3,0,3,0
1731500761546,ANTH 296,013,800118,Jenkins; Janis A.,3,0,3,0
1731500761546,ANTH 296,014,800119,Kaiser; Bronwyn Nicole,2,0,3,1
1731500761546,ANTH 296,015,800120,Kang; Byung Chu,3,0,3,0
1731500761546,ANTH 296,016,800121,Levy; Thomas E,3,0,3,0
1731500761546,ANTH 296,017,800122,Non; Amy L,3,0,3,0
1731500761546,ANTH 296,018,800123,Pedersen; David,3,0,3,0
1731500761546,ANTH 296,019,800184,Postero; Nancy Grey,3,0,3,0
1731500761546,ANTH 296,020,800185,Semendeferi; Ekaterini,3,0,3,0
1731500761546,ANTH 296,021,800186,Yeh; Rihan Wen Xin,3,0,3,0
1731500762575,ASTR 3,A01,733595,Trumbo; Samantha Kathleen,294,0,300,6
1731500763608,ASTR 20B,A01,733598,Konopacky; Quinn Morgan,49,0,50,1
1731500764643,ASTR 99,001,799856,Konopacky; Quinn Morgan,9999,0,9999,0
1731500765674,ASTR 102,A01,733600,Diamond; Patrick H & Konopacky; Quinn Morgan,29,0,30,1
1731500766707,ASTR 105,A01,733607,Boggs; Steven Edward,30,0,30,0
1731500767737,ASTR 122,A01,733609,Keres; Dusan,40,0,40,0
1731500768773,ASTR 150,A01,733641,Theissen; Christopher Alexander,28,0,30,2
1731500768773,ASTR 150,A02,733642,Theissen; Christopher Alexander,28,0,30,2
1731500769819,ASTR 201,A00,790490,Burgasser; Adam Jonathan,9,0,15,6
1731500770849,ASTR 210,A00,733648,Staff,12,0,15,3
1731500771885,ASTR 220,A00,733650,Wright; Shelley Adams,12,0,15,3
1731500772914,ASTR 250,A00,733652,Theissen; Christopher Alexander & Hosseinzadeh; Griffin Alex,22,0,30,8
1731500773946,ASTR 251,A00,733653,Theissen; Christopher Alexander & Hosseinzadeh; Griffin Alex,23,0,30,7
1731500774978,AUD 236,A01,791504,Harris; Jeffrey Paul,5,0,5,0
1731500776010,AUD 263,A00,791538,Zettner; Erika,13,0,13,0
1731500777041,AUD 276,A00,791507,Zettner; Erika,13,0,13,0
1731500778069,AUD 284,A01,791509,Zettner; Erika,13,0,13,0
1731500779098,AUD 291,A00,791534,Zettner; Erika,13,0,13,0
1731500780129,AUD 296,A00,791535,Zettner; Erika,13,0,13,0
1731500781167,AWP 3,002,733077,Ajo; Frances Margaret,12,0,12,0
1731500781167,AWP 3,003,733078,Given; William Allan,12,0,12,0
1731500781167,AWP 3,004,733080,Ajo; Frances Margaret,12,0,12,0
1731500781167,AWP 3,005,733082,Westerfeld; Kevin John,12,0,12,0
1731500781167,AWP 3,007,733085,O'Neil; Courtney L,12,0,12,0
1731500781167,AWP 3,008,733087,O'Neil; Courtney L,12,0,12,0
1731500781167,AWP 3,009,733138,Zimmerman; Guy,12,0,12,0
1731500781167,AWP 3,010,733139,Zimmerman; Guy,12,0,12,0
1731500781167,AWP 3,011,733140,Westerfeld; Kevin John,12,0,12,0
1731500781167,AWP 3,012,733141,Zimmerman; Guy,11,0,12,1
1731500781167,AWP 3,013,733142,Sartor; Alexandra,12,0,12,0
1731500781167,AWP 3,014,733143,Sartor; Alexandra,12,0,12,0
1731500781167,AWP 3,015,733144,Vaughn; Kelsey Sara,12,0,12,0
1731500781167,AWP 3,016,733145,Vaughn; Kelsey Sara,12,0,12,0
1731500781167,AWP 3,019,733148,Kolodezh; Samuel,12,0,12,0
1731500781167,AWP 3,020,733149,Kolodezh; Samuel,12,0,12,0
1731500781167,AWP 3,022,733151,Kolodezh; Samuel,12,0,12,0
1731500782205,AWP 4A,001,733154,Tsurska Svetina; Olena,13,0,14,1
1731500782205,AWP 4A,002,733156,Tsurska Svetina; Olena,10,0,14,4
1731500782205,AWP 4A,003,733157,Chandler; Bailee Daniele,12,0,14,2
1731500782205,AWP 4A,004,733158,Chandler; Bailee Daniele,13,0,14,1
1731500782205,AWP 4A,005,733159,Hall; Graham T,14,0,14,0
1731500782205,AWP 4A,006,733160,Hall; Graham T,14,0,14,0
1731500782205,AWP 4A,007,733161,Falcon; Jennifer A,14,0,14,0
1731500782205,AWP 4A,008,733162,Falcon; Jennifer A,13,0,14,1
1731500782205,AWP 4A,011,733165,Tiernan; Christa Michelle,14,0,14,0
1731500782205,AWP 4A,012,733166,Tiernan; Christa Michelle,12,0,14,2
1731500782205,AWP 4A,013,733168,Gardella; Alexander Drew,14,0,14,0
1731500782205,AWP 4A,014,733169,Gardella; Alexander Drew,12,0,14,2
1731500782205,AWP 4A,016,733171,Coulter; Jane Elisabeth,14,0,14,0
1731500782205,AWP 4A,017,733172,Spicer; Jacqueline,14,0,14,0
1731500782205,AWP 4A,018,733173,Spicer; Jacqueline,14,0,14,0
1731500782205,AWP 4A,019,733174,Christie; Veronica Ann,14,0,14,0
1731500782205,AWP 4A,020,733175,Bolin; Jillian,14,0,14,0
1731500782205,AWP 4A,021,733176,Bolin; Jillian,14,0,14,0
1731500782205,AWP 4A,022,733177,Zroka; Amy Liane,14,0,14,0
1731500782205,AWP 4A,023,733178,Zroka; Amy Liane,14,0,14,0
1731500782205,AWP 4A,024,733179,Christie; Veronica Ann,13,0,14,1
1731500782205,AWP 4A,025,733181,Steinberg; Stacy A,14,0,14,0
1731500782205,AWP 4A,026,733182,Steinberg; Stacy A,12,0,14,2
1731500782205,AWP 4A,027,733184,Gilmore; Lauren Monica,14,0,14,0
1731500782205,AWP 4A,028,733185,Gilmore; Lauren Monica,14,0,14,0
1731500782205,AWP 4A,032,733195,Grant; Melinda G,14,0,14,0
1731500782205,AWP 4A,033,733198,Grant; Melinda G,14,0,14,0
1731500782205,AWP 4A,037,733286,Jones; William Jadie,13,0,14,1
1731500782205,AWP 4A,038,733310,Jones; William Jadie,14,0,14,0
1731500782205,AWP 4A,039,733318,Heiser; Jerrod A,14,0,14,0
1731500782205,AWP 4A,040,733320,Heiser; Jerrod A,13,0,14,1
1731500782205,AWP 4A,041,733321,Bourdeau; Joseph Albert,14,0,14,0
1731500782205,AWP 4A,042,733331,Bourdeau; Joseph Albert,14,0,14,0
1731500782205,AWP 4A,043,733337,Wilson; Natalie Ann,13,0,14,1
1731500782205,AWP 4A,044,733378,Wilson; Natalie Ann,12,0,14,2
1731500782205,AWP 4A,045,733379,Staff,14,0,14,0
1731500782205,AWP 4A,046,733380,Staff,14,0,14,0
1731500782205,AWP 4A,047,733385,Staff,14,0,14,0
1731500782205,AWP 4A,048,733386,Staff,14,0,14,0
1731500782205,AWP 4A,049,733388,Staff,0,0,0,0
1731500782205,AWP 4A,050,733389,Staff,0,0,0,0
1731500782205,AWP 4A,051,733390,Staff,0,0,0,0
1731500782205,AWP 4A,052,733392,Staff,0,0,0,0
1731500782205,AWP 4A,053,733394,Staff,0,0,0,0
1731500782205,AWP 4A,054,733395,Staff,0,0,0,0
1731500783238,BENG 1,A01,733659,Sah; Robert Lie-Yuan,62,0,65,3
1731500783238,BENG 1,A02,733715,Sah; Robert Lie-Yuan,60,0,65,5
1731500783238,BENG 1,A03,733716,Sah; Robert Lie-Yuan,63,0,65,2
1731500784269,BENG 112A,A01,733831,Schmid-Schoenbein; Geert W,28,0,35,7
1731500784269,BENG 112A,A02,733832,Schmid-Schoenbein; Geert W,34,0,35,1
1731500785299,BENG 119B,A00,733833,Taylor Amos; Alyssa C,22,0,30,8
1731500786332,BENG 120,A01,733837,Huang; Xiaohua,35,0,35,0
1731500786332,BENG 120,A02,733843,Huang; Xiaohua,33,0,35,2
1731500787368,BENG 123,A01,733846,Palsson; Bernhard O.,24,0,30,6
1731500787368,BENG 123,A02,733847,Palsson; Bernhard O.,24,0,30,6
1731500788399,BENG 126B,A00,733850,Taylor Amos; Alyssa C,26,0,30,4
1731500789428,BENG 127B,A00,733860,Taylor Amos; Alyssa C,30,0,30,0
1731500790461,BENG 128B,A00,733862,Taylor Amos; Alyssa C,30,0,30,0
1731500791490,BENG 129B,A00,733865,Taylor Amos; Alyssa C,30,0,30,0
1731500792525,BENG 130,A00,733907,Subramaniam; Shankar,141,0,145,4
1731500793556,BENG 139B,A00,734022,Taylor Amos; Alyssa C,30,0,30,0
1731500794587,BENG 140A,A01,734136,Silva; Gabriel,27,0,30,3
1731500794587,BENG 140A,A02,734141,Silva; Gabriel,25,0,30,5
1731500794587,BENG 140A,A03,734146,Silva; Gabriel,25,0,30,5
1731500795621,BENG 147B,A00,734149,Taylor Amos; Alyssa C,28,0,30,2
1731500796649,BENG 148B,A00,734154,Taylor Amos; Alyssa C,25,0,30,5
1731500797679,BENG 149B,A00,734172,Taylor Amos; Alyssa C,30,0,30,0
1731500798714,BENG 152,A01,734185,Taylor Amos; Alyssa C,19,0,20,1
1731500799742,BENG 161B,A00,734193,Huang; Xiaohua,55,0,70,15
1731500800772,BENG 168,A01,734228,Shi; Lingyan,22,0,40,18
1731500800772,BENG 168,A02,734229,Shi; Lingyan,39,0,40,1
1731500800772,BENG 168,A03,734231,Shi; Lingyan,37,0,40,3
1731500801804,BENG 169B,A00,734233,Taylor Amos; Alyssa C,24,0,30,6
1731500802833,BENG 179B,A00,734243,Taylor Amos; Alyssa C,28,0,30,2
1731500803864,BENG 181,A01,734246,Pevzner; Pavel Arkadjevich,37,0,40,3
1731500804951,BENG 186B,A01,734248,Cauwenberghs; Gert,69,0,70,1
1731500805980,BENG 187C,A00,734249,Taylor Amos; Alyssa C,121,0,170,49
1731500807010,BENG 189,A00,734250,Contijoch; Francisco,26,0,30,4
1731500808039,BENG 191,A00,734252,Lal; Ratnesh,15,0,20,5
1731500809072,BENG 202,A00,734255,Pevzner; Pavel Arkadjevich,25,0,25,0
1731500810102,BENG 204,A01,734257,Subramaniam; Shankar,0,0,50,50
1731500811140,BENG 207,A00,734258,Friend; James Robert,0,0,0,0
1731500812173,BENG 212,A00,734259,Palsson; Bernhard O.,0,0,20,20
1731500813206,BENG 223,A00,734260,Kravets; Vira V.,0,0,60,60
1731500814236,BENG 225,A01,734263,Bartko; Andrew Peter,0,0,0,0
1731500815267,BENG 230B,A00,734289,Engler; Adam J.,38,0,120,82
1731500816300,BENG 238,A00,734290,Chen; Ju & Sun; Wei & Shyy; Yeun-Jund & Sheikh; Farah & Ross; Robert Scott & King; Kevin R & Evans; Sylvia M & Cho; Yoshitake,0,0,40,40
1731500817330,BENG 241A,A01,734314,Cyphert; Erika Leah,0,0,50,50
1731500818359,BENG 241B,A00,734333,Khojah; Reem I,35,0,70,35
1731500819398,BENG 247B,A00,734334,Wang; Joseph,0,0,40,40
1731500820429,BENG 277,A00,734336,Khojah; Reem I,0,0,0,0
1731500821462,BENG 278,A00,734340,Contijoch; Francisco,0,0,0,0
1731500822493,BENG 280B,A00,734351,El Kaffas; Ahmed,20,0,56,36
1731500823521,BENG 281,A00,734352,Aguado; Brian Alberto,25,0,120,95
1731500824554,BENG 291,A00,734356,Lal; Ratnesh,15,0,30,15
1731500825588,BENG 292,A01,734364,Ross; Camille,20,0,20,0
1731500826621,BENG 294B,A01,734430,Schmid-Schoenbein; Geert W,12,0,20,8
1731500827652,BENG 295,A00,734431,Watson; John Thomas,9999,0,9999,0
1731500828684,BGGN 206B,A00,765115,Oegema; Karen & Desai; Arshad,28,0,60,32
1731500829717,BGGN 207,A01,765121,Ross; Camille,0,0,0,0
1731500830752,BGGN 209,A00,765126,Neal; Sonya E,0,0,30,30
1731500831782,BGGN 213,A00,765129,Grant; Barry J,24,0,30,6
1731500832810,BGGN 216,A01,765138,Mueller; Liam O'Connor,0,0,0,24
1731500833841,BGGN 225,A00,765141,Lu; Li-Fan & Zuniga; Elina I,0,0,30,30
1731500834871,BGGN 228,A00,765144,Perry; Michael William & Kiger; Amy,0,0,30,30
1731500835901,BGGN 237,A01,765148,Goren; Alon M,10,0,10,0
1731500836931,BGGN 240,A01,765160,Benna; Marcus K,4,0,5,1
1731500836931,BGGN 240,A02,765210,Benna; Marcus K,1,0,5,4
1731500836931,BGGN 240,A03,765211,Benna; Marcus K,3,0,5,2
1731500836931,BGGN 240,A04,765212,Benna; Marcus K,2,0,5,3
1731500837960,BGGN 246A,A00,765223,Sejnowski; Terrence J,18,0,30,12
1731500838987,BGGN 249B,A00,765226,Abdel-Azim; Eiman,0,0,0,0
1731500840067,BGGN 271,001,798422,Ackerman; Susan,9999,0,9999,0
1731500840067,BGGN 271,002,798586,Akbari; Omar Sultan,9997,0,9999,2
1731500840067,BGGN 271,003,798588,Allen; Nicola J,9998,0,9999,1
1731500840067,BGGN 271,004,798599,Alperin; Mariann,9998,0,9999,1
1731500840067,BGGN 271,005,798600,Antal; Corina Elena,9998,0,9999,1
1731500840067,BGGN 271,006,798612,Bouvet; Michael,9999,0,9999,0
1731500840067,BGGN 271,007,798613,Breen; Ellen C.,9999,0,9999,0
1731500840067,BGGN 271,008,798637,Bui; Jack D,9998,0,9999,1
1731500840067,BGGN 271,009,798666,Burnett; Lindsey,9998,0,9999,1
1731500840067,BGGN 271,010,798745,Caffrey; Conor,9998,0,9999,1
1731500840067,BGGN 271,011,798780,Castle; Michael James,9998,0,9999,1
1731500840067,BGGN 271,012,798781,Chang; John Tzu-yu,9999,0,9999,0
1731500840067,BGGN 271,013,798782,Chen; Xu,9998,0,9999,1
1731500840067,BGGN 271,014,798783,Cheng; Christine Shiang-Ling,9999,0,9999,0
1731500840067,BGGN 271,015,798784,Cheresh; David A.,9998,0,9999,1
1731500840067,BGGN 271,016,798803,Cherqui; Stephanie,9999,0,9999,0
1731500840067,BGGN 271,017,798804,Chu; Hiutung,9998,0,9999,1
1731500840067,BGGN 271,018,798806,Church; Kellie Breen,9999,0,9999,0
1731500840067,BGGN 271,019,798807,Cleland; Elsa Eleanor,9998,0,9999,1
1731500840067,BGGN 271,020,798808,Coufal; Nicole Gabriele,9999,0,9999,0
1731500840067,BGGN 271,021,798809,Croker; Ben Adam,9999,0,9999,0
1731500840067,BGGN 271,022,798810,Crotty Alexander; Laura E,9997,0,9999,2
1731500840067,BGGN 271,023,798811,De Silva; Shermin,9999,0,9999,0
1731500840067,BGGN 271,024,798812,Dhar; Debanjan,9998,0,9999,1
1731500840067,BGGN 271,025,798813,Doherty; Taylor Alan,9997,0,9999,2
1731500840067,BGGN 271,026,798814,Dore; Kim Bohemie,9997,0,9999,2
1731500840067,BGGN 271,027,798815,Dulawa; Stephanie Carole,9999,0,9999,0
1731500840067,BGGN 271,028,798817,Farley; Emma Kristen,9998,0,9999,1
1731500840067,BGGN 271,029,798818,Feldstein; Ariel E,9999,0,9999,0
1731500840067,BGGN 271,030,798819,Feng; Gen-Sheng,9999,0,9999,0
1731500840067,BGGN 271,031,798820,Fisch; Kathleen Marie,9995,0,9999,4
1731500840067,BGGN 271,032,798822,Friedman; Rick Adam,9999,0,9999,0
1731500840067,BGGN 271,033,798823,Furnari; Frank,9999,0,9999,0
1731500840067,BGGN 271,034,798825,George; Olivier,9998,0,9999,1
1731500840067,BGGN 271,035,798826,Ghosh; Pradipta,9998,0,9999,1
1731500840067,BGGN 271,036,798828,Glasgow; Stacey Marie,9998,0,9999,1
1731500840067,BGGN 271,037,798832,Golden; James W,9998,0,9999,1
1731500840067,BGGN 271,038,798833,Golden; Susan S.,9999,0,9999,0
1731500840067,BGGN 271,039,798834,Goren; Alon M,9998,0,9999,1
1731500840067,BGGN 271,040,798835,Guatelli; John C,9998,0,9999,1
1731500840067,BGGN 271,041,798836,Guma; Monica,9998,0,9999,1
1731500840067,BGGN 271,042,798837,Gustafsson; Asa Birgitta,9999,0,9999,0
1731500840067,BGGN 271,043,798838,Hamdoun; Amr,9999,0,9999,0
1731500840067,BGGN 271,044,798839,Hao; Nan,9999,0,9999,0
1731500840067,BGGN 271,045,798841,Hasty; Jeff M,9999,0,9999,0
1731500840067,BGGN 271,046,798842,Ideker; Trey,9999,0,9999,0
1731500840067,BGGN 271,047,798843,Jiang; Qingfei,9998,0,9999,1
1731500840067,BGGN 271,048,798845,Jin; Yishi,9997,0,9999,2
1731500840067,BGGN 271,049,798846,Joshi; Shweta,9999,0,9999,0
1731500840067,BGGN 271,050,798849,Ju; Won-Kyu,9998,0,9999,1
1731500840067,BGGN 271,051,798850,Jun; Suckjoon,9999,0,9999,0
1731500840067,BGGN 271,052,798852,Kaech; Susan Michelle,9997,0,9999,2
1731500840067,BGGN 271,053,798853,Kauffman; Alexander,9997,0,9999,2
1731500840067,BGGN 271,054,798854,Kleinfeld; David,9998,0,9999,1
1731500840067,BGGN 271,055,798855,Koloski; Miranda Jane,9998,0,9999,1
1731500840067,BGGN 271,056,798856,Komiyama; Takaki,9998,0,9999,1
1731500840067,BGGN 271,057,798858,Kronenberg; Mitchell E.,9999,0,9999,0
1731500840067,BGGN 271,058,798859,Kufareva; Irina,9999,0,9999,0
1731500840067,BGGN 271,059,798860,Lee; Yun Sok,9999,0,9999,0
1731500840067,BGGN 271,060,798861,Leutgeb; Stefan,9999,0,9999,0
1731500840067,BGGN 271,061,798862,Li; Willis Xiaowei,9998,0,9999,1
1731500840067,BGGN 271,062,798864,Lim; Byungkook,9999,0,9999,0
1731500840067,BGGN 271,063,798865,Lo; Stanley M.,9999,0,9999,0
1731500840067,BGGN 271,064,798867,Lopez Ramirez; Miguel Alej,9998,0,9999,1
1731500840067,BGGN 271,065,798868,Lu; Pengzhe,9998,0,9999,1
1731500840067,BGGN 271,066,798869,Lyons; Deirdre Colleen,9998,0,9999,1
1731500840067,BGGN 271,067,798870,Lyumkis; Dmitry Evgenievich,9999,0,9999,0
1731500840067,BGGN 271,068,798871,McConville; Patrick James,9998,0,9999,1
1731500840067,BGGN 271,069,798873,McDonnell; Lisa Marie,9999,0,9999,0
1731500840067,BGGN 271,070,798877,Mertens; Jerome Stefan,9999,0,9999,0
1731500840067,BGGN 271,071,798900,Morris; Gerald P,9999,0,9999,0
1731500840067,BGGN 271,072,798911,Muotri; Alysson,9999,0,9999,0
1731500840067,BGGN 271,073,798916,Muroyama; Andrew David,9998,0,9999,1
1731500840067,BGGN 271,074,798919,Murre; Cornelis,9998,0,9999,1
1731500840067,BGGN 271,075,798920,Nieh; James Charles,9997,0,9999,2
1731500840067,BGGN 271,076,798922,Niwa; Maho,9999,0,9999,0
1731500840067,BGGN 271,077,798925,Parast; Mana,9999,0,9999,0
1731500840067,BGGN 271,078,798927,Perry; Michael William,9999,0,9999,0
1731500840067,BGGN 271,079,798929,Pillus; Lorraine,9998,0,9999,1
1731500840067,BGGN 271,080,798932,Pogliano; Joseph,9999,0,9999,0
1731500840067,BGGN 271,081,798936,Pride; David Tevis,9999,0,9999,0
1731500840067,BGGN 271,082,798939,Pruneda-Paz; Jose L.,9998,0,9999,1
1731500840067,BGGN 271,083,798940,Rana; Tariq,9999,0,9999,0
1731500840067,BGGN 271,084,798945,Rao; Anjana,9999,0,9999,0
1731500840067,BGGN 271,085,798950,Raz; Eyal,9997,0,9999,2
1731500840067,BGGN 271,086,798952,Ren; Bing,9999,0,9999,0
1731500840067,BGGN 271,087,798955,Rifkin; Scott,9998,0,9999,1
1731500840067,BGGN 271,088,798956,Risbrough; Victoria Blythe,9998,0,9999,1
1731500840067,BGGN 271,089,798958,Rose; Noah Hartmann,9999,0,9999,0
1731500840067,BGGN 271,090,798962,Rosenfeld; Michael G,9999,0,9999,0
1731500840067,BGGN 271,091,798964,Saier; Milton H.,9998,0,9999,1
1731500840067,BGGN 271,092,798966,Saltiel; Alan,9997,0,9999,2
1731500840067,BGGN 271,093,798967,Sanchez-Lopez; Elsa,9998,0,9999,1
1731500840067,BGGN 271,094,798969,Schroeder; Julian I,9998,0,9999,1
1731500840067,BGGN 271,095,798970,Sebat; Lilia Mikhailovna,9997,0,9999,2
1731500840067,BGGN 271,096,798972,Sen; George L,9999,0,9999,0
1731500840067,BGGN 271,097,798974,Shaner; Nathan C.,9999,0,9999,0
1731500840067,BGGN 271,098,798976,Shurin; Jonathan,9997,0,9999,2
1731500840067,BGGN 271,099,798982,Sicklick; Jason Keith,9999,0,9999,0
1731500840067,BGGN 271,100,798985,Signer; Robert,9999,0,9999,0
1731500840067,BGGN 271,101,798986,Simonson; Tatum Sasha Summ,9998,0,9999,1
1731500840067,BGGN 271,102,798990,Steinmetz; Nicole F,9999,0,9999,0
1731500840067,BGGN 271,103,798992,Su; Chih-Ying,9999,0,9999,0
1731500840067,BGGN 271,104,798994,Suel; Gurol Mehmet,9999,0,9999,0
1731500840067,BGGN 271,105,799024,Telese; Francesca,9999,0,9999,0
1731500840067,BGGN 271,106,799032,Towers; Christina Garlingt,9997,0,9999,2
1731500840067,BGGN 271,107,799089,Valdez-Jasso; Daniela,9999,0,9999,0
1731500840067,BGGN 271,108,799108,Wahlin; Karl Jonas,9997,0,9999,2
1731500840067,BGGN 271,109,799109,Webster; Nicholas J G,9999,0,9999,0
1731500840067,BGGN 271,110,799127,Welsbie; Derek,9999,0,9999,0
1731500840067,BGGN 271,111,799128,Wildonger; Jill Cathleen,9997,0,9999,2
1731500840067,BGGN 271,112,799129,Yaksh; Tony L.,9999,0,9999,0
1731500840067,BGGN 271,113,799150,Yeo; Eugene Wei-Ming,9998,0,9999,1
1731500840067,BGGN 271,114,799151,Ying; Wei,9997,0,9999,2
1731500840067,BGGN 271,115,799152,Young; Jared W.,9999,0,9999,0
1731500840067,BGGN 271,116,799153,Zage; Peter,9999,0,9999,0
1731500840067,BGGN 271,117,799154,Zengler; Karsten B,9998,0,9999,1
1731500840067,BGGN 271,118,799155,Zhang; Jin,9999,0,9999,0
1731500840067,BGGN 271,119,799156,Zhao; Yunde,9999,0,9999,0
1731500840067,BGGN 271,120,799157,Zheng; Ye,9998,0,9999,1
1731500840067,BGGN 271,121,799158,Zhou; Huilin,9999,0,9999,0
1731500840067,BGGN 271,122,799159,Zou; Yimin,9998,0,9999,1
1731500841103,BGGN 275,A00,765242,Flagg; Matthew Paul,0,0,0,12
1731500842132,BGGN 276,A00,765243,Flagg; Matthew Paul,0,0,0,12
1731500843170,BGGN 290,A00,765245,Pasquinelli; Amy & Hampton; Randolph Y.,0,0,0,8
1731500844197,BGGN 293,A00,765250,Tour; Ella,0,0,30,30
1731500844197,BGGN 293,B00,765260,Petrie; Katherine Lynn,0,0,0,12
1731500845243,BGJC 204,A00,765301,Lu; Li-Fan & Chang; John Tzu-yu,9982,0,9999,17
1731500846319,BGRD 200,001,799275,Ackerman; Susan,9999,0,9999,0
1731500846319,BGRD 200,002,799276,Akbari; Omar Sultan,9997,0,9999,2
1731500846319,BGRD 200,003,799277,Allen; Eric,9999,0,9999,0
1731500846319,BGRD 200,004,799278,Allen; Nicola J,9998,0,9999,1
1731500846319,BGRD 200,005,799279,Alperin; Mariann,9998,0,9999,1
1731500846319,BGRD 200,006,799280,Amaro; Rommie E,9999,0,9999,0
1731500846319,BGRD 200,007,799281,Antal; Corina Elena,9998,0,9999,1
1731500846319,BGRD 200,008,799282,Asahina; Kenta,9999,0,9999,0
1731500846319,BGRD 200,009,799283,Augustine; Vineet,9999,0,9999,0
1731500846319,BGRD 200,010,799284,Ayres; Janelle Samantha,9998,0,9999,1
1731500846319,BGRD 200,011,799285,Banghart; Matthew Ryan,9999,0,9999,0
1731500846319,BGRD 200,012,799286,Barton; Andrew David,9999,0,9999,0
1731500846319,BGRD 200,013,799287,Benna; Marcus K,9999,0,9999,0
1731500846319,BGRD 200,014,799288,Bennett; Eric J,9999,0,9999,0
1731500846319,BGRD 200,015,799289,Biering; Scott B,9999,0,9999,0
1731500846319,BGRD 200,016,799290,Bloodgood; Brenda Laurie,9999,0,9999,0
1731500846319,BGRD 200,017,799291,Bouvet; Michael,9999,0,9999,0
1731500846319,BGRD 200,018,799292,Breen; Ellen C.,9999,0,9999,0
1731500846319,BGRD 200,019,799293,Briggs; Steven,9999,0,9999,0
1731500846319,BGRD 200,020,799294,Bui; Jack D,9998,0,9999,1
1731500846319,BGRD 200,021,799295,Burnett; Lindsey,9998,0,9999,1
1731500846319,BGRD 200,022,799296,Caffrey; Conor,9998,0,9999,1
1731500846319,BGRD 200,023,799297,Callaway; Edward M,9999,0,9999,0
1731500846319,BGRD 200,024,799298,Castle; Michael James,9999,0,9999,0
1731500846319,BGRD 200,025,799299,Chaim; Isaac,9999,0,9999,0
1731500846319,BGRD 200,026,799300,Chang; John Tzu-yu,9998,0,9999,1
1731500846319,BGRD 200,027,799301,Chen; Xu,9999,0,9999,0
1731500846319,BGRD 200,028,799302,Cheng; Christine Shiang-Ling,9999,0,9999,0
1731500846319,BGRD 200,029,799303,Cheresh; David A.,9998,0,9999,1
1731500846319,BGRD 200,030,799304,Cherqui; Stephanie,9999,0,9999,0
1731500846319,BGRD 200,031,799305,Chu; Hiutung,9998,0,9999,1
1731500846319,BGRD 200,032,799306,Church; Kellie Breen,9999,0,9999,0
1731500846319,BGRD 200,033,799307,Cleland; Elsa Eleanor,9997,0,9999,2
1731500846319,BGRD 200,034,799308,Cooper; Kimberly Lynn,9999,0,9999,0
1731500846319,BGRD 200,035,799309,Coufal; Nicole Gabriele,9999,0,9999,0
1731500846319,BGRD 200,036,799310,Croker; Ben Adam,9999,0,9999,0
1731500846319,BGRD 200,037,799311,Crotty Alexander; Laura E,9997,0,9999,2
1731500846319,BGRD 200,038,799313,Daugherty; Matthew Dorton,9998,0,9999,1
1731500846319,BGRD 200,039,799314,De Silva; Shermin,9999,0,9999,0
1731500846319,BGRD 200,040,799315,Desai; Arshad,9999,0,9999,0
1731500846319,BGRD 200,041,799316,Dhar; Debanjan,9998,0,9999,1
1731500846319,BGRD 200,042,799317,Dickinson; Alexandra Jazz,9999,0,9999,0
1731500846319,BGRD 200,043,799318,Dixon; Jesse,9998,0,9999,1
1731500846319,BGRD 200,044,799319,Doherty; Taylor Alan,9997,0,9999,2
1731500846319,BGRD 200,045,799320,Dore; Kim Bohemie,9997,0,9999,2
1731500846319,BGRD 200,046,799321,Dulawa; Stephanie Carole,9999,0,9999,0
1731500846319,BGRD 200,047,799323,Ecker; Joseph R,9998,0,9999,1
1731500846319,BGRD 200,048,799324,Engle; Dannielle D,9999,0,9999,0
1731500846319,BGRD 200,049,799325,Ernst; Andreas,9998,0,9999,1
1731500846319,BGRD 200,050,799326,Esko; Jeffrey D.,9999,0,9999,0
1731500846319,BGRD 200,051,799327,Farley; Emma Kristen,9998,0,9999,1
1731500846319,BGRD 200,052,799328,Feldstein; Ariel E,9999,0,9999,0
1731500846319,BGRD 200,053,799329,Feng; Gen-Sheng,9999,0,9999,0
1731500846319,BGRD 200,054,799330,Fisch; Kathleen Marie,9995,0,9999,4
1731500846319,BGRD 200,055,799331,Friedman; Rick Adam,9999,0,9999,0
1731500846319,BGRD 200,056,799332,Furnari; Frank,9999,0,9999,0
1731500846319,BGRD 200,057,799333,Gage; Fred H,9999,0,9999,0
1731500846319,BGRD 200,058,799334,George; Olivier,9998,0,9999,1
1731500846319,BGRD 200,059,799335,Ghosh; Pradipta,9998,0,9999,1
1731500846319,BGRD 200,060,799336,Glasgow; Stacey Marie,9998,0,9999,1
1731500846319,BGRD 200,061,799337,Glass; Christopher,9999,0,9999,0
1731500846319,BGRD 200,062,799338,Golden; James W,9998,0,9999,1
1731500846319,BGRD 200,063,799339,Golden; Susan S.,9999,0,9999,0
1731500846319,BGRD 200,064,799340,Goren; Alon M,9998,0,9999,1
1731500846319,BGRD 200,065,799341,Guatelli; John C,9998,0,9999,1
1731500846319,BGRD 200,066,799342,Guma; Monica,9998,0,9999,1
1731500846319,BGRD 200,067,799343,Gustafsson; Asa Birgitta,9999,0,9999,0
1731500846319,BGRD 200,068,799344,Gutkind; Jorge Silvio,9999,0,9999,0
1731500846319,BGRD 200,069,799345,Hamdoun; Amr,9999,0,9999,0
1731500846319,BGRD 200,070,799346,Hampton; Randolph Y.,9998,0,9999,1
1731500846319,BGRD 200,071,799347,Hao; Nan,9999,0,9999,0
1731500846319,BGRD 200,072,799348,Hargreaves; Diana Clare,9998,0,9999,1
1731500846319,BGRD 200,073,799349,Hasty; Jeff M,9999,0,9999,0
1731500846319,BGRD 200,074,799350,Hollern; Daniel Patrick,9998,0,9999,1
1731500846319,BGRD 200,075,799351,Holway; David A.,9999,0,9999,0
1731500846319,BGRD 200,076,799352,Huffaker; Alisa,9998,0,9999,1
1731500846319,BGRD 200,077,799353,Hui; Enfu,9999,0,9999,0
1731500846319,BGRD 200,078,799354,Hwa; Terence T.,9999,0,9999,0
1731500846319,BGRD 200,079,799355,Ideker; Trey,9999,0,9999,0
1731500846319,BGRD 200,080,799356,Jackrel; Sara,9997,0,9999,2
1731500846319,BGRD 200,081,799357,Jiang; Qingfei,9998,0,9999,1
1731500846319,BGRD 200,082,799358,Jin; Yishi,9997,0,9999,2
1731500846319,BGRD 200,083,799359,Joshi; Shweta,9999,0,9999,0
1731500846319,BGRD 200,084,799360,Ju; Won-Kyu,9998,0,9999,1
1731500846319,BGRD 200,085,799361,Jun; Suckjoon,9999,0,9999,0
1731500846319,BGRD 200,086,799362,Kadonaga; James T,9999,0,9999,0
1731500846319,BGRD 200,087,799363,Kaech; Susan Michelle,9995,0,9999,4
1731500846319,BGRD 200,088,799364,Kauffman; Alexander,9997,0,9999,2
1731500846319,BGRD 200,089,799365,Kleinfeld; David,9999,0,9999,0
1731500846319,BGRD 200,090,799366,Knight; Robin,9999,0,9999,0
1731500846319,BGRD 200,091,799367,Koloski; Miranda Jane,9998,0,9999,1
1731500846319,BGRD 200,092,799368,Komiyama; Takaki,9997,0,9999,2
1731500846319,BGRD 200,093,799369,Kosuri; Pallav,9998,0,9999,1
1731500846319,BGRD 200,094,799370,Kronenberg; Mitchell E.,9999,0,9999,0
1731500846319,BGRD 200,095,799371,Staff,9999,0,9999,0
1731500846319,BGRD 200,096,799372,Kryazhimskiy; Sergey A,9999,0,9999,0
1731500846319,BGRD 200,097,799373,Kufareva; Irina,9999,0,9999,0
1731500846319,BGRD 200,098,799374,Lee; Kuo Fen,9999,0,9999,0
1731500846319,BGRD 200,099,799375,Lee; Yun Sok,9999,0,9999,0
1731500846319,BGRD 200,100,799376,Leutgeb; Jill K.,9999,0,9999,0
1731500846319,BGRD 200,101,799377,Leutgeb; Stefan,9999,0,9999,0
1731500846319,BGRD 200,102,799378,Li; Willis Xiaowei,9998,0,9999,1
1731500846319,BGRD 200,103,799379,Lim; Byungkook,9998,0,9999,1
1731500846319,BGRD 200,104,799380,Lo; Stanley M.,9999,0,9999,0
1731500846319,BGRD 200,105,799381,Looger; Loren Lee,9998,0,9999,1
1731500846319,BGRD 200,106,799382,Lopez Ramirez; Miguel Alej,9998,0,9999,1
1731500846319,BGRD 200,107,799383,Lovett-Barron; Matthew Rod,9997,0,9999,2
1731500846319,BGRD 200,108,799384,Lu; Li-Fan,9998,0,9999,1
1731500846319,BGRD 200,109,799385,Lu; Pengzhe,9998,0,9999,1
1731500846319,BGRD 200,110,799386,Lykke-Andersen; Jens,9998,0,9999,1
1731500846319,BGRD 200,111,799387,Lyons; Deirdre Colleen,9998,0,9999,1
1731500846319,BGRD 200,112,799388,Lyumkis; Dmitry Evgenievich,9998,0,9999,1
1731500846319,BGRD 200,113,799389,Manor; Uri,9999,0,9999,0
1731500846319,BGRD 200,114,799390,Mayfield; Stephen P.,9998,0,9999,1
1731500846319,BGRD 200,115,799391,McConville; Patrick James,9999,0,9999,0
1731500846319,BGRD 200,116,799392,McDonnell; Lisa Marie,9999,0,9999,0
1731500846319,BGRD 200,117,799393,Mertens; Jerome Stefan,9999,0,9999,0
1731500846319,BGRD 200,118,799394,Meyer; Justin Raymond,9999,0,9999,0
1731500846319,BGRD 200,119,799395,Morris; Gerald P,9999,0,9999,0
1731500846319,BGRD 200,120,799396,Mueller; Lena,9998,0,9999,1
1731500846319,BGRD 200,121,799397,Muotri; Alysson,9999,0,9999,0
1731500846319,BGRD 200,122,799398,Muroyama; Andrew David,9995,0,9999,4
1731500846319,BGRD 200,123,799399,Murre; Cornelis,9998,0,9999,1
1731500846319,BGRD 200,124,799400,Reyes De Barboza; Nabora S,9999,0,9999,0
1731500846319,BGRD 200,125,799401,Neal; Sonya E,9998,0,9999,1
1731500846319,BGRD 200,126,799402,Nieh; James Charles,9997,0,9999,2
1731500846319,BGRD 200,127,799403,Nimmerjahn; Axel,9999,0,9999,0
1731500846319,BGRD 200,128,799404,Niwa; Maho,9999,0,9999,0
1731500846319,BGRD 200,129,799405,Nizet; Victor F.,9999,0,9999,0
1731500846319,BGRD 200,130,799406,Oegema; Karen,9999,0,9999,0
1731500846319,BGRD 200,131,799407,Panda; Satchidananda,9998,0,9999,1
1731500846319,BGRD 200,132,799408,Parast; Mana,9999,0,9999,0
1731500846319,BGRD 200,133,799409,Pasquinelli; Amy,9998,0,9999,1
1731500846319,BGRD 200,134,799410,Pekkurnaz Banghart; Gulcin,9999,0,9999,0
1731500846319,BGRD 200,135,799411,Perry; Michael William,9999,0,9999,0
1731500846319,BGRD 200,136,799413,Pillus; Lorraine,9998,0,9999,1
1731500846319,BGRD 200,137,799414,Pogliano; Joseph,9999,0,9999,0
1731500846319,BGRD 200,138,799415,Pogliano; Kit J.,9999,0,9999,0
1731500846319,BGRD 200,139,799416,Pride; David Tevis,9999,0,9999,0
1731500846319,BGRD 200,140,799417,Pruneda-Paz; Jose L.,9998,0,9999,1
1731500846319,BGRD 200,141,799418,Ramanan; Deepshika,9998,0,9999,1
1731500846319,BGRD 200,142,799419,Rana; Tariq,9998,0,9999,1
1731500846319,BGRD 200,143,799420,Rao; Anjana,9999,0,9999,0
1731500846319,BGRD 200,144,799421,Raz; Eyal,9997,0,9999,2
1731500846319,BGRD 200,145,799422,Reck-Peterson; Samara L,9999,0,9999,0
1731500846319,BGRD 200,146,799423,Ren; Bing,9999,0,9999,0
1731500846319,BGRD 200,147,799424,Rennison; Diana,9998,0,9999,1
1731500846319,BGRD 200,148,799425,Rifkin; Scott,9999,0,9999,0
1731500846319,BGRD 200,149,799426,Risbrough; Victoria Blythe,9998,0,9999,1
1731500846319,BGRD 200,150,799427,Rivera; Fabian Chavez,9997,0,9999,2
1731500846319,BGRD 200,151,799428,Rohner; Patrick Thomas,9999,0,9999,0
1731500846319,BGRD 200,152,799429,Rose; Noah Hartmann,9999,0,9999,0
1731500846319,BGRD 200,153,799430,Rosenfeld; Michael G,9999,0,9999,0
1731500846319,BGRD 200,154,799431,Russell; Alistair B,9999,0,9999,0
1731500846319,BGRD 200,155,799432,Saier; Milton H.,9998,0,9999,1
1731500846319,BGRD 200,156,799433,Saltiel; Alan,9997,0,9999,2
1731500846319,BGRD 200,157,799434,Sanchez-Lopez; Elsa,9999,0,9999,0
1731500846319,BGRD 200,158,799435,Saphire; Erica Ollmann,9999,0,9999,0
1731500846319,BGRD 200,159,799436,Schroeder; Julian I,9997,0,9999,2
1731500846319,BGRD 200,160,799437,Sebat; Lilia Mikhailovna,9997,0,9999,2
1731500846319,BGRD 200,161,799438,Sen; George L,9999,0,9999,0
1731500846319,BGRD 200,162,799439,Shah; Sameer B,9999,0,9999,0
1731500846319,BGRD 200,163,799440,Shaner; Nathan C.,9999,0,9999,0
1731500846319,BGRD 200,164,799441,Sharpee; Tatyana,9999,0,9999,0
1731500846319,BGRD 200,165,799442,Shaw; Reuben,9999,0,9999,0
1731500846319,BGRD 200,166,799443,Shurin; Jonathan,9997,0,9999,2
1731500846319,BGRD 200,167,799444,Sicklick; Jason Keith,9999,0,9999,0
1731500846319,BGRD 200,168,799445,Signer; Robert,9999,0,9999,0
1731500846319,BGRD 200,169,799446,Simonson; Tatum Sasha Summ,9998,0,9999,1
1731500846319,BGRD 200,170,799447,Soncin; Francesca,9999,0,9999,0
1731500846319,BGRD 200,171,799448,Steinmetz; Nicole F,9999,0,9999,0
1731500846319,BGRD 200,172,799449,Su; Chih-Ying,9998,0,9999,1
1731500846319,BGRD 200,173,799450,Suel; Gurol Mehmet,9997,0,9999,2
1731500846319,BGRD 200,174,799451,Sun; Xin,9998,0,9999,1
1731500846319,BGRD 200,175,799452,Telese; Francesca,9998,0,9999,1
1731500846319,BGRD 200,176,799453,Towers; Christina Garlingt,9995,0,9999,4
1731500846319,BGRD 200,177,799454,Traver; David,9999,0,9999,0
1731500846319,BGRD 200,178,799455,Troemel; Emily Ruth,9998,0,9999,1
1731500846319,BGRD 200,179,799456,Valdez-Jasso; Daniela,9999,0,9999,0
1731500846319,BGRD 200,180,799457,Vijayanand; Pandurangan,9999,0,9999,0
1731500846319,BGRD 200,181,799458,Villa Rodriguez; Elizabeth,9999,0,9999,0
1731500846319,BGRD 200,182,799459,Wahlin; Karl Jonas,9997,0,9999,2
1731500846319,BGRD 200,183,799460,Wang; Jean Yin Jen,9999,0,9999,0
1731500846319,BGRD 200,184,799461,Webster; Nicholas J G,9999,0,9999,0
1731500846319,BGRD 200,185,799462,Welsbie; Derek,9999,0,9999,0
1731500846319,BGRD 200,186,799463,Wildonger; Jill Cathleen,9996,0,9999,3
1731500846319,BGRD 200,187,799464,Winzeler; Elizabeth A,9999,0,9999,0
1731500846319,BGRD 200,188,799465,Yaksh; Tony L.,9999,0,9999,0
1731500846319,BGRD 200,189,799466,Yelon; Deborah,9997,0,9999,2
1731500846319,BGRD 200,190,799467,Yeo; Eugene Wei-Ming,9998,0,9999,1
1731500846319,BGRD 200,191,799468,Ying; Wei,9997,0,9999,2
1731500846319,BGRD 200,192,799469,Young; Jared W.,9999,0,9999,0
1731500846319,BGRD 200,193,799470,Zage; Peter,9999,0,9999,0
1731500846319,BGRD 200,194,799471,Zengler; Karsten B,9997,0,9999,2
1731500846319,BGRD 200,195,799472,Zhang; Dong-Er,9999,0,9999,0
1731500846319,BGRD 200,196,799473,Zhang; Jin,9999,0,9999,0
1731500846319,BGRD 200,197,799474,Zhao; Yunde,9999,0,9999,0
1731500846319,BGRD 200,198,799475,Zheng; Binhai,9999,0,9999,0
1731500846319,BGRD 200,199,799476,Zheng; Ye,9998,0,9999,1
1731500846319,BGRD 200,200,799477,Zhou; Huilin,9999,0,9999,0
1731500846319,BGRD 200,201,799478,Zou; Yimin,9998,0,9999,1
1731500846319,BGRD 200,202,799479,Zuniga; Elina I,9998,0,9999,1
1731500847351,BGSE 200,A00,765304,Tour; Ella & Petrie; Katherine Lynn,9987,0,9999,12
1731500848382,BGSE 205,A00,765321,Bennett; Eric J,43,0,50,7
1731500848382,BGSE 205,B00,765322,Bennett; Eric J,46,0,50,4
1731500848382,BGSE 205,C00,765369,Bennett; Eric J,36,0,50,14
1731500848382,BGSE 205,D00,765470,Bennett; Eric J,40,0,50,10
1731500848382,BGSE 205,E00,765471,Bennett; Eric J,45,0,50,5
1731500849412,BIBC 100,A01,786720,Hui; Enfu,70,0,73,3
1731500849412,BIBC 100,A02,786721,Hui; Enfu,64,0,73,9
1731500849412,BIBC 100,A03,786723,Hui; Enfu,67,0,73,6
1731500849412,BIBC 100,A04,786775,Hui; Enfu,67,0,73,6
1731500850444,BIBC 102,A01,786782,Feng; Gen-Sheng,72,0,73,1
1731500850444,BIBC 102,A02,786783,Feng; Gen-Sheng,71,0,73,2
1731500850444,BIBC 102,A03,786784,Feng; Gen-Sheng,73,0,73,0
1731500850444,BIBC 102,A04,786790,Feng; Gen-Sheng,73,0,73,0
1731500850444,BIBC 102,B01,786791,Dickinson; Alexandra Jazz,61,0,73,12
1731500850444,BIBC 102,B02,786792,Dickinson; Alexandra Jazz,64,0,73,9
1731500850444,BIBC 102,B03,786845,Dickinson; Alexandra Jazz,68,0,73,5
1731500850444,BIBC 102,B04,786859,Dickinson; Alexandra Jazz,50,0,73,23
1731500851480,BIBC 103,A01,757720,Coleman; Aaron B.,21,0,24,3
1731500851480,BIBC 103,A02,757773,Coleman; Aaron B.,22,0,24,2
1731500851480,BIBC 103,B01,757783,Coleman; Aaron B.,18,0,24,6
1731500851480,BIBC 103,B02,757784,Coleman; Aaron B.,21,0,24,3
1731500851480,BIBC 103,C01,758001,Burg; Michael,17,0,24,7
1731500851480,BIBC 103,C02,758019,Burg; Michael,24,0,24,0
1731500852508,BIBC 120,A01,758029,Hampton; Randolph Y.,61,0,87,26
1731500852508,BIBC 120,A02,758032,Hampton; Randolph Y.,65,0,87,22
1731500852508,BIBC 120,A03,758038,Hampton; Randolph Y.,77,0,87,10
1731500852508,BIBC 120,A04,758119,Hampton; Randolph Y.,74,0,87,13
1731500853540,BIBC 194,A00,758136,Hui; Enfu,25,0,32,7
1731500853540,BIBC 194,B00,758137,Niwa; Maho,25,0,32,7
1731500853540,BIBC 194,C00,758138,Corbett; Kevin Daniel,25,0,32,7
1731500854570,BICD 100,A01,786869,Troemel; Emily Ruth,72,0,73,1
1731500854570,BICD 100,A02,786870,Troemel; Emily Ruth,73,0,73,0
1731500854570,BICD 100,A03,786871,Troemel; Emily Ruth,73,0,73,0
1731500854570,BICD 100,A04,786872,Troemel; Emily Ruth,73,0,73,0
1731500854570,BICD 100,B01,786873,Grossman; Emily N,66,0,73,7
1731500854570,BICD 100,B02,786874,Grossman; Emily N,66,0,73,7
1731500854570,BICD 100,B03,786875,Grossman; Emily N,71,0,73,2
1731500854570,BICD 100,B04,786876,Grossman; Emily N,70,0,73,3
1731500854570,BICD 100,C01,786877,Grossman; Emily N,64,0,73,9
1731500854570,BICD 100,C02,786878,Grossman; Emily N,71,0,73,2
1731500854570,BICD 100,C03,786879,Grossman; Emily N,70,0,73,3
1731500854570,BICD 100,C04,786880,Grossman; Emily N,71,0,73,2
1731500855607,BICD 110,A01,758191,Chaim; Isaac,54,0,63,9
1731500855607,BICD 110,A02,758193,Chaim; Isaac,42,0,63,21
1731500855607,BICD 110,A03,758194,Chaim; Isaac,61,0,63,2
1731500855607,BICD 110,A04,758196,Chaim; Isaac,56,0,61,5
1731500855607,BICD 110,B01,758200,Manor; Uri,60,0,63,3
1731500855607,BICD 110,B02,758201,Manor; Uri,63,0,63,0
1731500855607,BICD 110,B03,758202,Manor; Uri,55,0,63,8
1731500855607,BICD 110,B04,758204,Manor; Uri,56,0,61,5
1731500856659,BICD 120,A01,758206,Estelle; Mark,20,0,23,3
1731500856659,BICD 120,A02,758208,Estelle; Mark,22,0,23,1
1731500856659,BICD 120,A03,758209,Estelle; Mark,23,0,23,0
1731500856659,BICD 120,A04,758214,Estelle; Mark,17,0,21,4
1731500857690,BICD 194,A00,758215,Hueschen; Christina Lynn,29,0,32,3
1731500858721,BIEB 102,A01,758218,Jackrel; Sara,46,0,48,2
1731500858721,BIEB 102,A02,758219,Jackrel; Sara,47,0,48,1
1731500858721,BIEB 102,A03,758220,Jackrel; Sara,48,0,48,0
1731500858721,BIEB 102,A04,758222,Jackrel; Sara,48,0,48,0
1731500859751,BIEB 121,A00,758224,Butler; Shannon Rhey,8,0,32,24
1731500859751,BIEB 121,B00,758225,Butler; Shannon Rhey,20,0,32,12
1731500860786,BIEB 134,A01,758227,Barton; Andrew David,10,0,11,1
1731500860786,BIEB 134,A02,758230,Barton; Andrew David,11,0,11,0
1731500860786,BIEB 134,A03,758231,Barton; Andrew David,9,0,11,2
1731500860786,BIEB 134,A04,758232,Barton; Andrew David,11,0,11,0
1731500860786,BIEB 134,A05,758233,Barton; Andrew David,7,0,11,4
1731500860786,BIEB 134,A06,758236,Barton; Andrew David,9,0,10,1
1731500860786,BIEB 134,A07,758237,Barton; Andrew David,10,0,10,0
1731500860786,BIEB 134,A08,758239,Barton; Andrew David,10,0,10,0
1731500861817,BIEB 135,A01,758241,Shurin; Jonathan,20,0,36,16
1731500862854,BIEB 140,A01,758243,Roy; Kaustuv,35,0,40,5
1731500862854,BIEB 140,A02,758248,Roy; Kaustuv,36,0,40,4
1731500862854,BIEB 140,A03,758250,Roy; Kaustuv,35,0,40,5
1731500862854,BIEB 140,A04,758251,Roy; Kaustuv,32,0,40,8
1731500863887,BIEB 152,A01,758255,Wodarz; Dominik Franz Xave,57,0,63,6
1731500863887,BIEB 152,A02,758256,Wodarz; Dominik Franz Xave,62,0,63,1
1731500863887,BIEB 152,A03,758257,Wodarz; Dominik Franz Xave,54,0,63,9
1731500863887,BIEB 152,A04,758260,Wodarz; Dominik Franz Xave,50,0,61,11
1731500864917,BIEB 156,A01,758262,Rose; Noah Hartmann & Rennison; Diana,26,0,29,3
1731500864917,BIEB 156,A02,758267,Rose; Noah Hartmann & Rennison; Diana,26,0,29,3
1731500864917,BIEB 156,A03,758269,Rose; Noah Hartmann & Rennison; Diana,29,0,29,0
1731500864917,BIEB 156,A04,758272,Rose; Noah Hartmann & Rennison; Diana,28,0,28,0
1731500865948,BILD 1,A01,786580,Ochoa Mikrut; Stacy Daniel,93,0,100,7
1731500865948,BILD 1,A02,786585,Ochoa Mikrut; Stacy Daniel,100,0,100,0
1731500865948,BILD 1,A03,786589,Ochoa Mikrut; Stacy Daniel,98,0,100,2
1731500865948,BILD 1,A04,786591,Ochoa Mikrut; Stacy Daniel,96,0,100,4
1731500865948,BILD 1,B01,786593,Madigan; Cressida Ariana,85,0,100,15
1731500865948,BILD 1,B02,786612,Madigan; Cressida Ariana,73,0,100,27
1731500865948,BILD 1,B03,786613,Madigan; Cressida Ariana,93,0,100,7
1731500865948,BILD 1,B04,786614,Madigan; Cressida Ariana,97,0,100,3
1731500865948,BILD 1,C01,786630,Cooper; Andrew Michael,97,0,100,3
1731500865948,BILD 1,C02,786631,Cooper; Andrew Michael,99,0,100,1
1731500865948,BILD 1,C03,786669,Cooper; Andrew Michael,100,0,100,0
1731500865948,BILD 1,C04,786704,Cooper; Andrew Michael,99,0,100,1
1731500866979,BILD 2,A01,786707,Owens; Melinda Tsao-Ying,64,0,65,1
1731500866979,BILD 2,A02,786708,Owens; Melinda Tsao-Ying,58,0,60,2
1731500866979,BILD 2,A03,786709,Owens; Melinda Tsao-Ying,57,0,60,3
1731500866979,BILD 2,A04,786710,Owens; Melinda Tsao-Ying,60,0,60,0
1731500866979,BILD 2,B01,786920,Owens; Melinda Tsao-Ying,59,0,60,1
1731500866979,BILD 2,B02,786975,Owens; Melinda Tsao-Ying,60,0,60,0
1731500866979,BILD 2,B03,786976,Owens; Melinda Tsao-Ying,64,0,65,1
1731500866979,BILD 2,B04,786979,Owens; Melinda Tsao-Ying,64,0,65,1
1731500866979,BILD 2,C01,786980,Su; Chih-Ying,61,0,63,2
1731500866979,BILD 2,C02,786981,Su; Chih-Ying,58,0,63,5
1731500866979,BILD 2,C03,786983,Su; Chih-Ying,60,0,63,3
1731500866979,BILD 2,C04,786985,Su; Chih-Ying,61,0,61,0
1731500868016,BILD 3,A01,786711,Hammond; LaTisha Marie,49,0,60,11
1731500868016,BILD 3,A02,786712,Hammond; LaTisha Marie,44,0,60,16
1731500868016,BILD 3,A03,786713,Hammond; LaTisha Marie,59,0,60,1
1731500868016,BILD 3,A04,786714,Hammond; LaTisha Marie,54,0,60,6
1731500868016,BILD 3,B01,786715,Hammond; LaTisha Marie,58,0,60,2
1731500868016,BILD 3,B02,786716,Hammond; LaTisha Marie,60,0,60,0
1731500868016,BILD 3,B03,786717,Hammond; LaTisha Marie,55,0,60,5
1731500868016,BILD 3,B04,786719,Hammond; LaTisha Marie,59,0,60,1
1731500868016,BILD 3,D01,786997,Pirino; Giorgia,58,0,60,2
1731500868016,BILD 3,D02,786998,Pirino; Giorgia,58,0,60,2
1731500868016,BILD 3,D03,786999,Pirino; Giorgia,58,0,60,2
1731500868016,BILD 3,D04,787001,Pirino; Giorgia,60,0,60,0
1731500869051,BILD 4,A01,757384,Gonzalez Gamboa; Ivonne,20,0,24,4
1731500869051,BILD 4,A02,757387,Gonzalez Gamboa; Ivonne,22,0,24,2
1731500869051,BILD 4,A03,757388,Gonzalez Gamboa; Ivonne,24,0,24,0
1731500869051,BILD 4,A04,757396,Gonzalez Gamboa; Ivonne,24,0,24,0
1731500869051,BILD 4,A05,757397,Gonzalez Gamboa; Ivonne,22,0,24,2
1731500869051,BILD 4,A06,757399,Gonzalez Gamboa; Ivonne,24,0,24,0
1731500869051,BILD 4,A07,757403,Gonzalez Gamboa; Ivonne,23,0,24,1
1731500869051,BILD 4,A08,757404,Gonzalez Gamboa; Ivonne,22,0,24,2
1731500869051,BILD 4,B01,757410,Gonzalez Gamboa; Ivonne,15,0,24,9
1731500869051,BILD 4,B02,757413,Gonzalez Gamboa; Ivonne,21,0,24,3
1731500869051,BILD 4,B03,757416,Gonzalez Gamboa; Ivonne,23,0,24,1
1731500869051,BILD 4,B04,757417,Gonzalez Gamboa; Ivonne,23,0,24,1
1731500869051,BILD 4,B05,757419,Gonzalez Gamboa; Ivonne,23,0,24,1
1731500869051,BILD 4,B06,757421,Gonzalez Gamboa; Ivonne,23,0,24,1
1731500869051,BILD 4,B07,757423,Gonzalez Gamboa; Ivonne,23,0,24,1
1731500869051,BILD 4,B08,757434,Gonzalez Gamboa; Ivonne,23,0,24,1
1731500869051,BILD 4,C01,757437,Ochoa Mikrut; Stacy Daniel,22,0,24,2
1731500869051,BILD 4,C02,757439,Ochoa Mikrut; Stacy Daniel,23,0,24,1
1731500869051,BILD 4,C03,757440,Ochoa Mikrut; Stacy Daniel,24,0,24,0
1731500869051,BILD 4,C04,757495,Ochoa Mikrut; Stacy Daniel,23,0,24,1
1731500869051,BILD 4,C05,757496,Ochoa Mikrut; Stacy Daniel,24,0,24,0
1731500869051,BILD 4,C06,757497,Ochoa Mikrut; Stacy Daniel,24,0,24,0
1731500869051,BILD 4,C07,757498,Ochoa Mikrut; Stacy Daniel,24,0,24,0
1731500869051,BILD 4,C08,757499,Ochoa Mikrut; Stacy Daniel,24,0,24,0
1731500869051,BILD 4,D01,757501,Lo; Stanley M.,14,0,24,10
1731500869051,BILD 4,D02,757502,Lo; Stanley M.,22,0,24,2
1731500869051,BILD 4,D03,757503,Lo; Stanley M.,24,0,24,0
1731500869051,BILD 4,D04,757504,Lo; Stanley M.,22,0,24,2
1731500869051,BILD 4,D05,757505,Lo; Stanley M.,22,0,24,2
1731500869051,BILD 4,D06,757506,Lo; Stanley M.,22,0,24,2
1731500869051,BILD 4,D07,757507,Lo; Stanley M.,24,0,24,0
1731500869051,BILD 4,D08,757508,Lo; Stanley M.,22,0,24,2
1731500870080,BILD 5,A01,786885,Mueller; Liam O'Connor,60,0,65,5
1731500870080,BILD 5,A02,786886,Mueller; Liam O'Connor,58,0,65,7
1731500870080,BILD 5,A03,786887,Mueller; Liam O'Connor,64,0,65,1
1731500870080,BILD 5,A04,786888,Mueller; Liam O'Connor,64,0,65,1
1731500870080,BILD 5,B01,786889,Reuther; Keefe,65,0,65,0
1731500870080,BILD 5,B02,786890,Reuther; Keefe,60,0,65,5
1731500870080,BILD 5,B03,786891,Reuther; Keefe,64,0,65,1
1731500870080,BILD 5,B04,786892,Reuther; Keefe,65,0,65,0
1731500871110,BILD 12,A01,757527,Komiyama; Takaki,24,0,24,0
1731500871110,BILD 12,A02,757530,Komiyama; Takaki,24,0,24,0
1731500871110,BILD 12,A03,757531,Komiyama; Takaki,21,0,24,3
1731500871110,BILD 12,A04,757532,Komiyama; Takaki,24,0,24,0
1731500872144,BILD 22,A01,757534,Strause; Linda G.,69,0,75,6
1731500872144,BILD 22,A02,757535,Strause; Linda G.,70,0,75,5
1731500872144,BILD 22,A03,757544,Strause; Linda G.,75,0,75,0
1731500872144,BILD 22,A04,757547,Strause; Linda G.,74,0,75,1
1731500873179,BILD 28,A01,757549,Idoyaga; Juliana,30,0,30,0
1731500873179,BILD 28,A02,757550,Idoyaga; Juliana,30,0,30,0
1731500873179,BILD 28,A03,757551,Idoyaga; Juliana,30,0,30,0
1731500873179,BILD 28,A04,757552,Idoyaga; Juliana,30,0,30,0
1731500874211,BILD 60,A01,757569,Meharena; Hiruy Sibhatu,16,0,16,0
1731500874211,BILD 60,A02,757570,Meharena; Hiruy Sibhatu,16,0,16,0
1731500874211,BILD 60,A03,757571,Meharena; Hiruy Sibhatu,16,0,16,0
1731500874211,BILD 60,A04,757572,Meharena; Hiruy Sibhatu,16,0,16,0
1731500875241,BILD 62,A01,757574,Juavinett; Ashley Lauren,22,0,24,2
1731500875241,BILD 62,A02,757575,Juavinett; Ashley Lauren,23,0,24,1
1731500875241,BILD 62,A03,757576,Juavinett; Ashley Lauren,21,0,24,3
1731500875241,BILD 62,A04,757712,Juavinett; Ashley Lauren,22,0,24,2
1731500876269,BILD 87,A00,757714,Saier; Milton H.,20,0,20,0
1731500876269,BILD 87,B00,757715,Saier; Milton H.,19,0,20,1
1731500877299,BIMM 100,A01,785694,Cook-Andersen; Heidi Leigh,46,0,48,2
1731500877299,BIMM 100,A02,785696,Cook-Andersen; Heidi Leigh,48,0,48,0
1731500877299,BIMM 100,A03,785706,Cook-Andersen; Heidi Leigh,42,0,48,6
1731500877299,BIMM 100,A04,785714,Cook-Andersen; Heidi Leigh,48,0,48,0
1731500877299,BIMM 100,B01,785715,Akbari; Omar Sultan,45,0,48,3
1731500877299,BIMM 100,B02,785716,Akbari; Omar Sultan,39,0,48,9
1731500877299,BIMM 100,B03,785717,Akbari; Omar Sultan,46,0,48,2
1731500877299,BIMM 100,B04,785718,Akbari; Omar Sultan,46,0,48,2
1731500878327,BIMM 101,A01,758279,Meaders; Clara Leigh,0,0,24,24
1731500878327,BIMM 101,A02,758280,Meaders; Clara Leigh,0,0,24,24
1731500878327,BIMM 101,B01,758282,Tour; Ella,8,0,24,16
1731500878327,BIMM 101,B02,758283,Tour; Ella,14,0,24,10
1731500878327,BIMM 101,C01,758285,Day; Christopher D,19,0,24,5
1731500878327,BIMM 101,C02,758286,Day; Christopher D,22,0,24,2
1731500878327,BIMM 101,D01,758293,Cooper; Andrew Michael,19,0,24,5
1731500878327,BIMM 101,D02,758323,Cooper; Andrew Michael,20,0,24,4
1731500878327,BIMM 101,E01,758342,Rusert; Jessica Marie,21,0,24,3
1731500878327,BIMM 101,E02,758343,Rusert; Jessica Marie,24,0,24,0
1731500878327,BIMM 101,F01,758345,Rusert; Jessica Marie,23,0,24,1
1731500878327,BIMM 101,F02,758346,Rusert; Jessica Marie,24,0,24,0
1731500879354,BIMM 112,A01,758422,Kadonaga; James T,38,0,40,2
1731500879354,BIMM 112,A02,758427,Kadonaga; James T,33,0,40,7
1731500879354,BIMM 112,A03,758428,Kadonaga; James T,35,0,40,5
1731500879354,BIMM 112,A04,758429,Kadonaga; James T,39,0,40,1
1731500880386,BIMM 114,A01,758433,Daugherty; Matthew Dorton,39,0,48,9
1731500880386,BIMM 114,A02,758434,Daugherty; Matthew Dorton,46,0,48,2
1731500880386,BIMM 114,A03,758441,Daugherty; Matthew Dorton,45,0,48,3
1731500880386,BIMM 114,A04,758449,Daugherty; Matthew Dorton,42,0,48,6
1731500881419,BIMM 121,A01,758694,Gustafson-Brown; Cindy,13,0,24,11
1731500881419,BIMM 121,A02,758695,Gustafson-Brown; Cindy,20,0,24,4
1731500881419,BIMM 121,B01,758854,Gustafson-Brown; Cindy,18,0,24,6
1731500881419,BIMM 121,B02,758855,Gustafson-Brown; Cindy,19,0,24,5
1731500881419,BIMM 121,C01,758859,Pirino; Giorgia,4,0,24,20
1731500881419,BIMM 121,C02,758860,Pirino; Giorgia,11,0,24,13
1731500882450,BIMM 134,A01,758866,Burg; Michael,76,0,103,27
1731500882450,BIMM 134,A02,758867,Burg; Michael,102,0,103,1
1731500882450,BIMM 134,A03,758868,Burg; Michael,84,0,103,19
1731500882450,BIMM 134,A04,758870,Burg; Michael,97,0,101,4
1731500883479,BIMM 143,A01,758872,Grant; Barry J,12,0,40,28
1731500883479,BIMM 143,B01,759109,Bozinovic; Goran,30,0,40,10
1731500884511,BIMM 143R,A01,759111,Bozinovic; Goran,23,0,40,17
1731500885538,BIMM 172,A01,759115,Briggs; Steven,10,0,15,5
1731500885538,BIMM 172,A02,759116,Briggs; Steven,11,0,15,4
1731500885538,BIMM 172,A03,759117,Briggs; Steven,5,0,15,10
1731500885538,BIMM 172,A04,759119,Briggs; Steven,10,0,15,5
1731500886568,BIMM 181,A01,759121,Pevzner; Pavel Arkadjevich,31,0,60,29
1731500887596,BIMM 194,A00,759122,Akbari; Omar Sultan,31,0,32,1
1731500887596,BIMM 194,B00,759123,Lykke-Andersen; Jens,11,0,32,21
1731500887596,BIMM 194,C00,759125,Hasty; Jeff M,29,0,32,3
1731500888628,BIOM 200C,A00,734458,Benner; Christopher William,2,0,28,26
1731500889659,BIOM 202,A01,734460,Corbett; Kevin Daniel,23,0,35,12
1731500890691,BIOM 203B,A00,800936,Gustafsson; Asa Birgitta,35,0,35,0
1731500891718,BIOM 218,A00,734462,Gagneux; Pascal,12,0,12,0
1731500892747,BIOM 246,A00,796600,Gordts; Philip & Lewis; Amanda Lark & Godula; Kamil & Gagneux; Pascal & Esko; Jeffrey D. & Bode; Lars,0,0,0,0
1731500893778,BIOM 253,A00,734463,Nizet; Victor F.,7,0,15,8
1731500894806,BIOM 255,A00,734466,Joiner; William J.,0,0,0,0
1731500895834,BIOM 256,A00,734467,Yang; Jing,0,0,0,0
1731500896867,BIOM 262,A01,734469,Goren; Alon M,19,0,20,1
1731500897897,BIOM 275,A01,734471,Antal; Corina Elena & Obara; Christopher & Mendiola; Andrew & Gonzalez; David J,1,0,28,27
1731500898930,BIOM 277,A01,797835,Klemke; Richard,0,0,0,0
1731500899962,BIOM 287,A00,734472,Khojah; Reem I,0,0,0,0
1731500900992,BIOM 295,A00,734474,Joiner; William J.,0,0,0,0
1731500902026,BIPN 100,A01,787002,Maita; Isabella Vincenza,57,0,61,4
1731500902026,BIPN 100,A02,787005,Maita; Isabella Vincenza,58,0,61,3
1731500902026,BIPN 100,A03,787008,Maita; Isabella Vincenza,58,0,61,3
1731500902026,BIPN 100,A04,787009,Maita; Isabella Vincenza,60,0,62,2
1731500902026,BIPN 100,B01,786881,Reyes Gonzalez; Catalina,61,0,61,0
1731500902026,BIPN 100,B02,786882,Reyes Gonzalez; Catalina,60,0,61,1
1731500902026,BIPN 100,B03,786883,Reyes Gonzalez; Catalina,55,0,61,6
1731500902026,BIPN 100,B04,786884,Reyes Gonzalez; Catalina,55,0,62,7
1731500902026,BIPN 100,C01,787011,Marino; Marc J,53,0,61,8
1731500902026,BIPN 100,C02,787013,Marino; Marc J,56,0,61,5
1731500902026,BIPN 100,C03,787014,Marino; Marc J,59,0,61,2
1731500902026,BIPN 100,C04,787015,Marino; Marc J,53,0,62,9
1731500902026,BIPN 100,D01,794575,Yang; Mingyu,35,0,36,1
1731500902026,BIPN 100,D02,794600,Yang; Mingyu,35,0,36,1
1731500902026,BIPN 100,D03,794576,Yang; Mingyu,35,0,36,1
1731500902026,BIPN 100,D04,794601,Yang; Mingyu,37,0,37,0
1731500903054,BIPN 102,A01,759131,Reyes Gonzalez; Catalina,36,0,61,25
1731500903054,BIPN 102,A02,759133,Reyes Gonzalez; Catalina,56,0,61,5
1731500903054,BIPN 102,A03,759134,Reyes Gonzalez; Catalina,56,0,61,5
1731500903054,BIPN 102,A04,759135,Reyes Gonzalez; Catalina,59,0,62,3
1731500904081,BIPN 105,A01,759139,Armour; Jon Christopher,4,0,21,17
1731500904081,BIPN 105,A02,759140,Armour; Jon Christopher,15,0,21,6
1731500904081,BIPN 105,B01,759144,Armour; Jon Christopher,14,0,21,7
1731500904081,BIPN 105,B02,759147,Armour; Jon Christopher,21,0,21,0
1731500905109,BIPN 140,A01,759149,Lovett-Barron; Matthew Rod,31,0,40,9
1731500905109,BIPN 140,A02,759150,Lovett-Barron; Matthew Rod,40,0,40,0
1731500905109,BIPN 140,A03,759152,Lovett-Barron; Matthew Rod,38,0,40,2
1731500905109,BIPN 140,A04,759154,Lovett-Barron; Matthew Rod,37,0,38,1
1731500906144,BIPN 145,A01,759171,Juavinett; Ashley Lauren,34,0,42,8
1731500906144,BIPN 145,B01,759173,Maita; Isabella Vincenza,40,0,42,2
1731500906144,BIPN 145,C01,759176,Marino; Marc J,30,0,42,12
1731500907175,BIPN 154,A01,759178,Lim; Byungkook,26,0,30,4
1731500907175,BIPN 154,A02,759179,Lim; Byungkook,28,0,30,2
1731500907175,BIPN 154,A03,759180,Lim; Byungkook,28,0,30,2
1731500907175,BIPN 154,A04,759181,Lim; Byungkook,26,0,31,5
1731500908206,BIPN 160,A01,759183,Root; Cory Matthew,45,0,62,17
1731500908206,BIPN 160,A02,759186,Root; Cory Matthew,58,0,62,4
1731500908206,BIPN 160,A03,759187,Root; Cory Matthew,61,0,62,1
1731500908206,BIPN 160,A04,759188,Root; Cory Matthew,51,0,61,10
1731500909232,BIPN 162,A01,759190,Benna; Marcus K,4,0,7,3
1731500909232,BIPN 162,A02,759191,Benna; Marcus K,2,0,7,5
1731500909232,BIPN 162,A03,759192,Benna; Marcus K,4,0,7,3
1731500909232,BIPN 162,A04,759194,Benna; Marcus K,8,0,9,1
1731500910262,BIPN 194,A00,759195,Ackerman; Susan,31,0,32,1
1731500910262,BIPN 194,B00,759196,Leutgeb; Jill K.,14,0,32,18
1731500910262,BIPN 194,C00,759197,Banghart; Matthew Ryan,28,0,32,4
1731500910262,BIPN 194,E00,759201,Meharena; Hiruy Sibhatu,32,0,32,0
1731500911290,BISP 193,001,795783,Maita; Isabella Vincenza,9999,0,9999,0
1731500912344,BISP 194,A00,759202,Newsam; John,14,0,32,18
1731500912344,BISP 194,B00,759203,Cooper; Kimberly Lynn,20,0,32,12
1731500913373,BNFO 262,A01,734447,Goren; Alon M,4,0,5,1
1731500914400,BNFO 281,A00,734448,Gaasterland; Theresa,74,0,100,26
1731500915429,BNFO 283,A00,734456,Fisch; Kathleen Marie & Sahoo; Debashis,7,0,23,16
1731500915429,BNFO 283,B00,734457,Abagyan; Ruben & Bansal; Vikas,11,0,23,12
1731500916476,BNFO 286,A00,734451,Ideker; Trey,26,0,30,4
1731500917502,BNFO 294,A01,734453,Ross; Camille,45,0,50,5
1731500918563,CAT 2,A01,740617,Bronstein; Phoebe Malan,16,0,16,0
1731500918563,CAT 2,A02,740618,Bronstein; Phoebe Malan,9,0,16,7
1731500918563,CAT 2,A03,740619,Bronstein; Phoebe Malan,0,0,16,16
1731500918563,CAT 2,A04,740620,Bronstein; Phoebe Malan,9,0,16,7
1731500918563,CAT 2,A05,740621,Bronstein; Phoebe Malan,8,0,16,8
1731500918563,CAT 2,A06,740623,Bronstein; Phoebe Malan,12,0,16,4
1731500918563,CAT 2,A07,740625,Bronstein; Phoebe Malan,14,0,16,2
1731500918563,CAT 2,A08,740628,Bronstein; Phoebe Malan,15,0,16,1
1731500918563,CAT 2,A09,740629,Bronstein; Phoebe Malan,16,0,16,0
1731500918563,CAT 2,A10,740679,Bronstein; Phoebe Malan,16,0,16,0
1731500918563,CAT 2,A11,740681,Bronstein; Phoebe Malan,13,0,16,3
1731500918563,CAT 2,A12,740686,Bronstein; Phoebe Malan,13,0,16,3
1731500918563,CAT 2,A13,740698,Bronstein; Phoebe Malan,12,0,16,4
1731500918563,CAT 2,A14,740703,Bronstein; Phoebe Malan,12,0,16,4
1731500918563,CAT 2,A15,740704,Bronstein; Phoebe Malan,15,0,16,1
1731500918563,CAT 2,A16,740709,Bronstein; Phoebe Malan,13,0,16,3
1731500918563,CAT 2,B01,740715,Bigham; David Joseph,15,0,16,1
1731500918563,CAT 2,B02,740761,Bigham; David Joseph,14,0,16,2
1731500918563,CAT 2,B03,740762,Bigham; David Joseph,12,0,16,4
1731500918563,CAT 2,B04,740763,Bigham; David Joseph,12,0,16,4
1731500918563,CAT 2,B05,740764,Bigham; David Joseph,16,0,16,0
1731500918563,CAT 2,B06,740765,Bigham; David Joseph,13,0,16,3
1731500918563,CAT 2,B07,740767,Bigham; David Joseph,16,0,16,0
1731500918563,CAT 2,B08,740768,Bigham; David Joseph,16,0,16,0
1731500918563,CAT 2,B09,740770,Bigham; David Joseph,16,0,16,0
1731500918563,CAT 2,B10,740772,Bigham; David Joseph,12,0,16,4
1731500918563,CAT 2,B11,740773,Bigham; David Joseph,15,0,16,1
1731500918563,CAT 2,B12,740774,Bigham; David Joseph,16,0,16,0
1731500918563,CAT 2,B13,740777,Bigham; David Joseph,14,0,16,2
1731500918563,CAT 2,B14,740780,Bigham; David Joseph,12,0,16,4
1731500918563,CAT 2,B15,740781,Bigham; David Joseph,16,0,16,0
1731500918563,CAT 2,B16,740848,Bigham; David Joseph,16,0,16,0
1731500918563,CAT 2,C01,740895,Marchisotto; Jennifer Anne,16,0,16,0
1731500918563,CAT 2,C02,740896,Marchisotto; Jennifer Anne,13,0,16,3
1731500918563,CAT 2,C03,740908,Marchisotto; Jennifer Anne,12,0,16,4
1731500918563,CAT 2,C04,740944,Marchisotto; Jennifer Anne,14,0,16,2
1731500918563,CAT 2,C05,740945,Marchisotto; Jennifer Anne,15,0,16,1
1731500918563,CAT 2,C06,740946,Marchisotto; Jennifer Anne,16,0,16,0
1731500918563,CAT 2,C07,740947,Marchisotto; Jennifer Anne,14,0,16,2
1731500918563,CAT 2,C08,740949,Marchisotto; Jennifer Anne,16,0,16,0
1731500918563,CAT 2,C09,740960,Marchisotto; Jennifer Anne,16,0,16,0
1731500918563,CAT 2,C10,740966,Marchisotto; Jennifer Anne,15,0,16,1
1731500918563,CAT 2,C11,741017,Marchisotto; Jennifer Anne,15,0,16,1
1731500918563,CAT 2,C12,741018,Marchisotto; Jennifer Anne,14,0,16,2
1731500918563,CAT 2,C13,741019,Marchisotto; Jennifer Anne,16,0,16,0
1731500918563,CAT 2,C14,741024,Marchisotto; Jennifer Anne,15,0,16,1
1731500918563,CAT 2,D01,741027,Nguyen; Hoang A.,14,0,16,2
1731500918563,CAT 2,D02,741028,Nguyen; Hoang A.,6,0,16,10
1731500918563,CAT 2,D03,741029,Nguyen; Hoang A.,9,0,16,7
1731500918563,CAT 2,D04,741031,Nguyen; Hoang A.,15,0,16,1
1731500918563,CAT 2,D05,741033,Nguyen; Hoang A.,16,0,16,0
1731500918563,CAT 2,D06,741034,Nguyen; Hoang A.,15,0,16,1
1731500918563,CAT 2,D07,741035,Nguyen; Hoang A.,16,0,16,0
1731500918563,CAT 2,D08,741036,Nguyen; Hoang A.,16,0,16,0
1731500918563,CAT 2,D09,741039,Nguyen; Hoang A.,14,0,16,2
1731500918563,CAT 2,D10,741042,Nguyen; Hoang A.,14,0,16,2
1731500918563,CAT 2,D11,741045,Nguyen; Hoang A.,15,0,16,1
1731500918563,CAT 2,D12,741047,Nguyen; Hoang A.,15,0,16,1
1731500918563,CAT 2,D13,741049,Nguyen; Hoang A.,15,0,16,1
1731500918563,CAT 2,D14,741054,Nguyen; Hoang A.,15,0,16,1
1731500919592,CAT 2CE,A01,741072,Popko; Elizabeth Ashley,24,0,25,1
1731500920624,CAT 87,A00,741105,Bronstein; Phoebe Malan,20,0,20,0
1731500920624,CAT 87,B00,795240,Delaville; Romain,20,0,20,0
1731500921654,CAT 124,A01,741118,Geibel; William,20,0,20,0
1731500921654,CAT 124,B01,799621,Staff,20,0,20,0
1731500922684,CAT 125,001,741143,Bigham; David Joseph,20,0,20,0
1731500922684,CAT 125,002,741149,Bigham; David Joseph,16,0,20,4
1731500922684,CAT 125,003,741152,Marchisotto; Jennifer Anne,20,0,20,0
1731500922684,CAT 125,004,741162,Marchisotto; Jennifer Anne,16,0,20,4
1731500922684,CAT 125,006,741164,Delaville; Romain,19,0,20,1
1731500922684,CAT 125,007,741180,Vanderschuit; Maya Alysia,19,0,20,1
1731500922684,CAT 125,008,741192,Vanderschuit; Maya Alysia,20,0,20,0
1731500922684,CAT 125,009,741193,Vanderschuit; Maya Alysia,19,0,20,1
1731500922684,CAT 125,010,741205,Morales; Celeste Georgianna,19,0,20,1
1731500922684,CAT 125,011,741207,Morales; Celeste Georgianna,20,0,20,0
1731500922684,CAT 125,012,741208,Morales; Celeste Georgianna,20,0,20,0
1731500922684,CAT 125,013,741209,Rose; Becca Rae,18,0,20,2
1731500922684,CAT 125,014,741215,Rose; Becca Rae,20,0,20,0
1731500922684,CAT 125,015,741222,Rose; Becca Rae,20,0,20,0
1731500922684,CAT 125,016,741224,Tosun; Adriana,18,0,20,2
1731500922684,CAT 125,017,741225,Tosun; Adriana,19,0,20,1
1731500923717,CAT 125R,A00,741229,Smith; Lauryn Alissa,17,0,20,3
1731500923717,CAT 125R,B00,741230,Smith; Lauryn Alissa,18,0,20,2
1731500923717,CAT 125R,C00,741231,Smith; Lauryn Alissa,16,0,20,4
1731500923717,CAT 125R,D00,741237,Hyland; Tina Mae,16,0,20,4
1731500923717,CAT 125R,E00,741240,Hyland; Tina Mae,17,0,20,3
1731500923717,CAT 125R,F00,741242,Hyland; Tina Mae,18,0,20,2
1731500923717,CAT 125R,G00,741243,Tosun; Adriana,15,0,20,5
1731500924756,CCE 1,001,744105,Labat Ii; Michael Luis,38,0,40,2
1731500924756,CCE 1,002,744106,Garcia; Kathryn Mary,37,0,40,3
1731500924756,CCE 1,003,744107,Lee; Kassandra,38,0,40,2
1731500924756,CCE 1,004,744108,Crawford; James,36,0,40,4
1731500924756,CCE 1,005,744109,Merryman; Ashley,39,0,40,1
1731500924756,CCE 1,006,744110,Santos; Vabianna Daria,39,0,40,1
1731500924756,CCE 1,007,744125,Bigley; Michele Heather,37,0,40,3
1731500925798,CCE 2,001,744126,Staff,19,0,20,1
1731500925798,CCE 2,002,744127,Garcia; Kathryn Mary,20,0,20,0
1731500925798,CCE 2,003,744128,Labat Ii; Michael Luis,20,0,20,0
1731500925798,CCE 2,004,744129,Labat Ii; Michael Luis,20,0,20,0
1731500925798,CCE 2,005,744130,Garcia; Kathryn Mary,20,0,20,0
1731500925798,CCE 2,006,744131,Lee; Kassandra,20,0,20,0
1731500925798,CCE 2,007,744132,Lee; Kassandra,20,0,20,0
1731500925798,CCE 2,008,744133,Santos; Vabianna Daria,20,0,20,0
1731500925798,CCE 2,009,744134,Santos; Vabianna Daria,19,0,20,1
1731500925798,CCE 2,010,744135,Bigley; Michele Heather,20,0,20,0
1731500925798,CCE 2,011,744167,Merryman; Ashley,20,0,20,0
1731500925798,CCE 2,012,744168,Merryman; Ashley,20,0,20,0
1731500926826,CCS 102,A00,795242,Werner; Bradley T.,15,0,20,5
1731500927856,CCS 123,A00,794510,Staff,25,0,25,0
1731500928885,CENG 15,A01,734482,Yang; Kesong,25,0,25,0
1731500929913,CENG 101A,A00,734483,Staff,49,0,50,1
1731500930940,CENG 101B,A00,734484,Liu; Ping,99,0,100,1
1731500931970,CENG 102,A00,734485,Powell; Alyssa,69,0,70,1
1731500931970,CENG 102,B00,734486,Powell; Alyssa,68,0,70,2
1731500932998,CENG 114,A00,734487,Jahed Motlagh; Zeinab,97,0,100,3
1731500934033,CENG 124A,A00,734488,Drews; Aaron,42,0,60,18
1731500934033,CENG 124A,B00,734489,Russ; Benjamin Edward,53,0,60,7
1731500935060,CENG 134,A00,734490,Pokorski; Jonathan Kyle,63,0,70,7
1731500936092,CENG 176A,A01,734492,Opatkiewicz; Justin Paul,11,0,48,37
1731500936092,CENG 176A,B01,734494,Zhang; Liangfang,55,0,60,5
1731500937122,CENG 205,A00,734495,Jahed Motlagh; Zeinab,40,0,60,20
1731500938148,CENG 213,A00,734496,Fenning; David,6,0,10,4
1731500939196,CENG 214,A00,734497,Li; Wan-Lu,10,0,10,0
1731500940222,CENG 215,A00,734498,Jokerst; Jesse Vincent,10,0,10,0
1731500941250,CENG 221B,A00,734499,Staff,28,0,50,22
1731500942277,CENG 251,A00,734500,Pascal; Tod A,29,0,50,21
1731500943303,CENG 252,A00,734501,Chen; Zheng,28,0,50,22
1731500944337,CENG 256,A00,734502,Meyers; Marc,10,0,10,0
1731500945366,CGS 101,A00,740473,Cuong; Marisol,35,0,35,0
1731500946413,CGS 108,A00,740486,Lu; Lillian,20,0,20,0
1731500947449,CGS 111,A00,740518,Martin Sandino; Amanda Maria Yoland,31,0,35,4
1731500948479,CGS 116,A00,740521,Cuong; Marisol,31,0,32,1
1731500949509,CGS 124,A00,740524,Martin Sandino; Amanda Maria Yoland,14,0,15,1
1731500950540,CGS 125,A00,740528,Browne; Errol Tsekani,19,0,20,1
1731500951571,CGS 135,A00,740534,Okonkwo; Holly,15,0,15,0
1731500952602,CGS 136,A00,740538,Chatti; Deepti,15,0,15,0
1731500953631,CGS 137,A00,740541,Martin Sandino; Amanda Maria Yoland,19,0,20,1
1731500954656,CGS 165,A00,740547,Browne; Errol Tsekani,13,0,15,2
1731500955694,CGS 167A,A00,740604,Patel; Shaista,11,0,12,1
1731500956722,CGS 187,A00,740608,Cuong; Marisol,13,0,15,2
1731500957751,CGS 196A,A00,740611,Taylor-Garcia; Daphne,1,0,1,0
1731500957751,CGS 196A,B00,799481,Hankins; Joseph D.,1,0,1,0
1731500957751,CGS 196A,C00,799482,Yapp; Hentyle T,1,0,1,0
1731500958783,CHEM 1,A00,734503,Brydges; Stacey,39,0,40,1
1731500959816,CHEM 6A,A01,784433,Lam; Tin Yiu,38,0,40,2
1731500959816,CHEM 6A,A02,784434,Lam; Tin Yiu,40,0,40,0
1731500959816,CHEM 6A,A03,784436,Lam; Tin Yiu,39,0,40,1
1731500959816,CHEM 6A,A04,784437,Lam; Tin Yiu,35,0,40,5
1731500959816,CHEM 6A,A05,784438,Lam; Tin Yiu,40,0,40,0
1731500959816,CHEM 6A,A06,784440,Lam; Tin Yiu,40,0,40,0
1731500959816,CHEM 6A,A07,784441,Lam; Tin Yiu,0,0,0,0
1731500959816,CHEM 6A,B01,784443,Lam; Tin Yiu,40,0,40,0
1731500959816,CHEM 6A,B02,784445,Lam; Tin Yiu,34,0,36,2
1731500959816,CHEM 6A,B03,784446,Lam; Tin Yiu,34,0,40,6
1731500959816,CHEM 6A,B04,784449,Lam; Tin Yiu,38,0,40,2
1731500959816,CHEM 6A,B05,784454,Lam; Tin Yiu,37,0,40,3
1731500959816,CHEM 6A,B06,784455,Lam; Tin Yiu,39,0,40,1
1731500959816,CHEM 6A,B07,784456,Lam; Tin Yiu,0,0,0,0
1731500959816,CHEM 6A,C01,784457,Ternansky; Robert J.,40,0,40,0
1731500959816,CHEM 6A,C02,784458,Ternansky; Robert J.,33,0,40,7
1731500959816,CHEM 6A,C03,784460,Ternansky; Robert J.,33,0,40,7
1731500959816,CHEM 6A,C04,784461,Ternansky; Robert J.,40,0,40,0
1731500959816,CHEM 6A,C05,784462,Ternansky; Robert J.,40,0,40,0
1731500959816,CHEM 6A,C06,784465,Ternansky; Robert J.,40,0,40,0
1731500959816,CHEM 6A,C07,784468,Ternansky; Robert J.,0,0,0,0
1731500960876,CHEM 6B,A01,784469,Kummel; Andrew C,40,0,40,0
1731500960876,CHEM 6B,A02,784470,Kummel; Andrew C,40,0,40,0
1731500960876,CHEM 6B,A03,784471,Kummel; Andrew C,39,0,40,1
1731500960876,CHEM 6B,A04,784472,Kummel; Andrew C,38,0,40,2
1731500960876,CHEM 6B,A05,784473,Kummel; Andrew C,37,0,40,3
1731500960876,CHEM 6B,A06,784474,Kummel; Andrew C,39,0,40,1
1731500960876,CHEM 6B,A07,784475,Kummel; Andrew C,0,0,0,0
1731500960876,CHEM 6B,B01,784481,Sailor; Michael Joseph,39,0,40,1
1731500960876,CHEM 6B,B02,784482,Sailor; Michael Joseph,39,0,40,1
1731500960876,CHEM 6B,B03,784483,Sailor; Michael Joseph,39,0,40,1
1731500960876,CHEM 6B,B04,784484,Sailor; Michael Joseph,40,0,40,0
1731500960876,CHEM 6B,B05,784485,Sailor; Michael Joseph,40,0,40,0
1731500960876,CHEM 6B,B06,784486,Sailor; Michael Joseph,40,0,40,0
1731500960876,CHEM 6B,B07,784487,Sailor; Michael Joseph,0,0,0,0
1731500960876,CHEM 6B,C01,784489,Stallings; Dontarie M,33,0,40,7
1731500960876,CHEM 6B,C02,784490,Stallings; Dontarie M,20,0,24,4
1731500960876,CHEM 6B,C03,784491,Stallings; Dontarie M,37,0,40,3
1731500960876,CHEM 6B,C04,784525,Stallings; Dontarie M,36,0,40,4
1731500960876,CHEM 6B,C05,784529,Stallings; Dontarie M,40,0,40,0
1731500960876,CHEM 6B,C06,784532,Stallings; Dontarie M,39,0,40,1
1731500960876,CHEM 6B,C07,784534,Stallings; Dontarie M,0,0,0,0
1731500960876,CHEM 6B,D01,784537,Stallings; Dontarie M,29,0,40,11
1731500960876,CHEM 6B,D02,784540,Stallings; Dontarie M,33,0,40,7
1731500960876,CHEM 6B,D03,784543,Stallings; Dontarie M,37,0,40,3
1731500960876,CHEM 6B,D04,784544,Stallings; Dontarie M,37,0,40,3
1731500960876,CHEM 6B,D05,784546,Stallings; Dontarie M,38,0,40,2
1731500960876,CHEM 6B,D06,784547,Stallings; Dontarie M,38,0,40,2
1731500960876,CHEM 6B,D07,784553,Stallings; Dontarie M,0,0,0,0
1731500960876,CHEM 6B,E01,784556,Young; Mark,40,0,40,0
1731500960876,CHEM 6B,E02,784557,Young; Mark,40,0,40,0
1731500960876,CHEM 6B,E03,784566,Young; Mark,40,0,40,0
1731500960876,CHEM 6B,E04,784568,Young; Mark,40,0,40,0
1731500960876,CHEM 6B,E05,784571,Young; Mark,40,0,40,0
1731500960876,CHEM 6B,E06,784572,Young; Mark,39,0,40,1
1731500960876,CHEM 6B,E07,784574,Young; Mark,0,0,0,0
1731500960876,CHEM 6B,F01,784578,Young; Mark,40,0,40,0
1731500960876,CHEM 6B,F02,784581,Young; Mark,40,0,40,0
1731500960876,CHEM 6B,F03,784582,Young; Mark,40,0,40,0
1731500960876,CHEM 6B,F04,784584,Young; Mark,40,0,40,0
1731500960876,CHEM 6B,F05,784585,Young; Mark,40,0,40,0
1731500960876,CHEM 6B,F06,784589,Young; Mark,40,0,40,0
1731500960876,CHEM 6B,F07,784591,Young; Mark,0,0,0,0
1731500960876,CHEM 6B,G01,785227,Schurmeier; Kimberly,35,0,40,5
1731500960876,CHEM 6B,G02,785228,Schurmeier; Kimberly,37,0,40,3
1731500960876,CHEM 6B,G03,785229,Schurmeier; Kimberly,35,0,40,5
1731500960876,CHEM 6B,G04,785230,Schurmeier; Kimberly,0,0,0,0
1731500960876,CHEM 6B,G05,785231,Schurmeier; Kimberly,39,0,40,1
1731500960876,CHEM 6B,G06,785233,Schurmeier; Kimberly,34,0,40,6
1731500960876,CHEM 6B,G07,785234,Schurmeier; Kimberly,39,0,40,1
1731500961906,CHEM 6BH,A01,785675,Yuen Zhou; Joel,49,0,50,1
1731500962940,CHEM 6C,A01,785073,Ternansky; Robert J.,40,0,40,0
1731500962940,CHEM 6C,A02,785074,Ternansky; Robert J.,37,0,40,3
1731500962940,CHEM 6C,A03,785148,Ternansky; Robert J.,38,0,40,2
1731500962940,CHEM 6C,A04,785155,Ternansky; Robert J.,40,0,40,0
1731500962940,CHEM 6C,A05,785158,Ternansky; Robert J.,0,0,0,0
1731500962940,CHEM 6C,A06,785159,Ternansky; Robert J.,36,0,40,4
1731500962940,CHEM 6C,A07,785160,Ternansky; Robert J.,40,0,40,0
1731500962940,CHEM 6C,B01,784597,Albizati; Kim F.,26,0,40,14
1731500962940,CHEM 6C,B02,784600,Albizati; Kim F.,38,0,40,2
1731500962940,CHEM 6C,B03,784603,Albizati; Kim F.,34,0,40,6
1731500962940,CHEM 6C,B04,784604,Albizati; Kim F.,34,0,40,6
1731500962940,CHEM 6C,B05,784606,Albizati; Kim F.,39,0,40,1
1731500962940,CHEM 6C,B06,784607,Albizati; Kim F.,38,0,40,2
1731500962940,CHEM 6C,B07,784610,Albizati; Kim F.,0,0,0,0
1731500963980,CHEM 7L,A01,734519,Leigh; Brian,24,0,24,0
1731500963980,CHEM 7L,A02,734520,Leigh; Brian,23,0,24,1
1731500963980,CHEM 7L,A03,734521,Leigh; Brian,24,0,24,0
1731500963980,CHEM 7L,A04,734522,Leigh; Brian,21,0,21,0
1731500963980,CHEM 7L,A05,734523,Leigh; Brian,22,0,24,2
1731500963980,CHEM 7L,A06,734524,Leigh; Brian,24,0,24,0
1731500963980,CHEM 7L,A07,734525,Leigh; Brian,23,0,24,1
1731500963980,CHEM 7L,A08,734526,Leigh; Brian,23,0,24,1
1731500963980,CHEM 7L,A09,734527,Leigh; Brian,23,0,24,1
1731500963980,CHEM 7L,A10,734528,Leigh; Brian,19,0,21,2
1731500963980,CHEM 7L,B01,734530,Leigh; Brian,14,0,24,10
1731500963980,CHEM 7L,B02,734531,Leigh; Brian,22,0,24,2
1731500963980,CHEM 7L,B03,734532,Leigh; Brian,24,0,24,0
1731500963980,CHEM 7L,B04,734533,Leigh; Brian,24,0,24,0
1731500963980,CHEM 7L,B05,734534,Leigh; Brian,24,0,24,0
1731500963980,CHEM 7L,B06,734535,Leigh; Brian,22,0,24,2
1731500963980,CHEM 7L,B07,734536,Leigh; Brian,20,0,21,1
1731500963980,CHEM 7L,B08,734537,Leigh; Brian,13,0,24,11
1731500963980,CHEM 7L,B09,734538,Leigh; Brian,21,0,24,3
1731500963980,CHEM 7L,B10,734539,Leigh; Brian,22,0,24,2
1731500963980,CHEM 7L,C01,734541,Leigh; Brian,21,0,24,3
1731500963980,CHEM 7L,C02,734542,Leigh; Brian,23,0,24,1
1731500963980,CHEM 7L,C03,734543,Leigh; Brian,23,0,24,1
1731500963980,CHEM 7L,C04,734624,Leigh; Brian,24,0,24,0
1731500963980,CHEM 7L,C05,734625,Leigh; Brian,20,0,24,4
1731500963980,CHEM 7L,C06,734626,Leigh; Brian,23,0,24,1
1731500963980,CHEM 7L,C07,734658,Leigh; Brian,21,0,24,3
1731500963980,CHEM 7L,C08,734668,Leigh; Brian,23,0,24,1
1731500963980,CHEM 7L,C09,734754,Leigh; Brian,24,0,24,0
1731500963980,CHEM 7L,C10,734758,Leigh; Brian,19,0,21,2
1731500965011,CHEM 11,A01,785161,Huang; Xuemei,36,0,40,4
1731500965011,CHEM 11,A02,785164,Huang; Xuemei,39,0,40,1
1731500965011,CHEM 11,A03,785168,Huang; Xuemei,39,0,40,1
1731500965011,CHEM 11,A04,785169,Huang; Xuemei,40,0,40,0
1731500965011,CHEM 11,A05,785175,Huang; Xuemei,39,0,40,1
1731500965011,CHEM 11,A06,785177,Huang; Xuemei,35,0,40,5
1731500965011,CHEM 11,A07,785178,Huang; Xuemei,39,0,40,1
1731500965011,CHEM 11,A08,785179,Huang; Xuemei,39,0,40,1
1731500966042,CHEM 40A,A01,784614,Cohen; Seth M,29,0,40,11
1731500966042,CHEM 40A,A02,784615,Cohen; Seth M,38,0,40,2
1731500966042,CHEM 40A,A03,784617,Cohen; Seth M,32,0,39,7
1731500966042,CHEM 40A,A04,784632,Cohen; Seth M,38,0,40,2
1731500966042,CHEM 40A,A05,784657,Cohen; Seth M,36,0,40,4
1731500966042,CHEM 40A,A06,784658,Cohen; Seth M,38,0,40,2
1731500966042,CHEM 40A,A07,784689,Cohen; Seth M,40,0,40,0
1731500966042,CHEM 40A,A08,784695,Cohen; Seth M,40,0,40,0
1731500967077,CHEM 40B,A01,785501,Weizman; Haim,38,0,40,2
1731500967077,CHEM 40B,A02,785503,Weizman; Haim,30,0,40,10
1731500967077,CHEM 40B,A03,785504,Weizman; Haim,25,0,40,15
1731500967077,CHEM 40B,A04,785505,Weizman; Haim,38,0,40,2
1731500967077,CHEM 40B,A05,785506,Weizman; Haim,39,0,40,1
1731500967077,CHEM 40B,A06,785507,Weizman; Haim,0,0,0,0
1731500967077,CHEM 40B,A07,798353,Weizman; Haim,35,0,40,5
1731500967077,CHEM 40B,A08,798354,Weizman; Haim,38,0,40,2
1731500967077,CHEM 40B,B01,785184,Romero; Erik Anthony,37,0,40,3
1731500967077,CHEM 40B,B02,785185,Romero; Erik Anthony,39,0,40,1
1731500967077,CHEM 40B,B03,785186,Romero; Erik Anthony,40,0,40,0
1731500967077,CHEM 40B,B04,785187,Romero; Erik Anthony,37,0,40,3
1731500967077,CHEM 40B,B05,785190,Romero; Erik Anthony,40,0,40,0
1731500967077,CHEM 40B,B06,785191,Romero; Erik Anthony,0,0,0,0
1731500967077,CHEM 40B,B07,795158,Romero; Erik Anthony,40,0,40,0
1731500967077,CHEM 40B,B08,795161,Romero; Erik Anthony,40,0,40,0
1731500967077,CHEM 40B,C01,785509,Pun; Andrew Brian,31,0,38,7
1731500967077,CHEM 40B,C02,785510,Pun; Andrew Brian,31,0,40,9
1731500967077,CHEM 40B,C03,785512,Pun; Andrew Brian,38,0,40,2
1731500967077,CHEM 40B,C04,785513,Pun; Andrew Brian,37,0,40,3
1731500967077,CHEM 40B,C05,785514,Pun; Andrew Brian,39,0,40,1
1731500967077,CHEM 40B,C06,785515,Pun; Andrew Brian,34,0,40,6
1731500967077,CHEM 40B,C07,795106,Pun; Andrew Brian,29,0,40,11
1731500967077,CHEM 40B,C08,795148,Pun; Andrew Brian,0,0,0,0
1731500968105,CHEM 41A,A01,785193,Yang; Jerry,35,0,36,1
1731500968105,CHEM 41A,A02,785220,Yang; Jerry,31,0,36,5
1731500968105,CHEM 41A,A03,785221,Yang; Jerry,35,0,37,2
1731500968105,CHEM 41A,A04,785222,Yang; Jerry,37,0,37,0
1731500969137,CHEM 41B,A01,785594,Theodorakis; Emmanuel,35,0,40,5
1731500969137,CHEM 41B,A02,785595,Theodorakis; Emmanuel,40,0,40,0
1731500969137,CHEM 41B,A03,785598,Theodorakis; Emmanuel,36,0,40,4
1731500969137,CHEM 41B,A04,785599,Theodorakis; Emmanuel,24,0,24,0
1731500969137,CHEM 41B,A05,785656,Theodorakis; Emmanuel,39,0,40,1
1731500969137,CHEM 41B,A06,785657,Theodorakis; Emmanuel,40,0,40,0
1731500969137,CHEM 41B,A07,785658,Theodorakis; Emmanuel,37,0,40,3
1731500970196,CHEM 43A,A01,734984,Figueroa; Joshua,13,0,24,11
1731500970196,CHEM 43A,A02,734985,Figueroa; Joshua,22,0,24,2
1731500970196,CHEM 43A,A03,734986,Figueroa; Joshua,24,0,24,0
1731500970196,CHEM 43A,A04,734987,Figueroa; Joshua,22,0,24,2
1731500970196,CHEM 43A,A05,734988,Figueroa; Joshua,0,0,0,0
1731500970196,CHEM 43A,A06,735039,Figueroa; Joshua,0,0,0,0
1731500970196,CHEM 43A,A07,735040,Figueroa; Joshua,0,0,0,0
1731500970196,CHEM 43A,A08,735130,Figueroa; Joshua,0,0,0,0
1731500970196,CHEM 43A,B01,735277,Tor; Yitzhak,0,0,24,24
1731500970196,CHEM 43A,B02,735279,Tor; Yitzhak,12,0,24,12
1731500970196,CHEM 43A,B03,735281,Tor; Yitzhak,19,0,24,5
1731500970196,CHEM 43A,B04,735282,Tor; Yitzhak,16,0,24,8
1731500970196,CHEM 43A,B05,735284,Tor; Yitzhak,0,0,0,0
1731500970196,CHEM 43A,B06,735288,Tor; Yitzhak,0,0,0,0
1731500970196,CHEM 43A,B07,735289,Tor; Yitzhak,0,0,0,0
1731500970196,CHEM 43A,B08,735290,Tor; Yitzhak,0,0,0,0
1731500970196,CHEM 43A,C01,735300,Klosterman; Jeremy K,0,0,0,0
1731500970196,CHEM 43A,C02,735304,Klosterman; Jeremy K,0,0,0,0
1731500970196,CHEM 43A,C03,735308,Klosterman; Jeremy K,0,0,0,0
1731500970196,CHEM 43A,C04,735312,Klosterman; Jeremy K,20,0,24,4
1731500970196,CHEM 43A,C05,735317,Klosterman; Jeremy K,23,0,24,1
1731500970196,CHEM 43A,C06,735319,Klosterman; Jeremy K,24,0,24,0
1731500970196,CHEM 43A,C07,735320,Klosterman; Jeremy K,16,0,17,1
1731500970196,CHEM 43A,C08,735331,Klosterman; Jeremy K,24,0,24,0
1731500971230,CHEM 100A,A01,735347,Slade; Jonathan,19,0,23,4
1731500971230,CHEM 100A,A02,735632,Slade; Jonathan,21,0,24,3
1731500971230,CHEM 100A,A03,735636,Slade; Jonathan,19,0,23,4
1731500971230,CHEM 100A,A04,735637,Slade; Jonathan,21,0,24,3
1731500971230,CHEM 100A,A05,735638,Slade; Jonathan,19,0,24,5
1731500971230,CHEM 100A,A06,735639,Slade; Jonathan,22,0,23,1
1731500972263,CHEM 100B,A01,735649,Pomeroy; Robert S.,18,0,26,8
1731500973291,CHEM 105A,A01,735653,Sinha; Amitabha,31,0,42,11
1731500974320,CHEM 108,A01,735655,Jennings; Patricia A.,9,0,20,11
1731500974320,CHEM 108,A02,735658,Jennings; Patricia A.,23,0,24,1
1731500974320,CHEM 108,B01,735663,Jennings; Patricia A.,13,0,20,7
1731500974320,CHEM 108,B02,735666,Jennings; Patricia A.,21,0,24,3
1731500975353,CHEM 109,A01,735680,Piercy; Marc Anthony,6,0,20,14
1731500975353,CHEM 109,A02,735689,Piercy; Marc Anthony,19,0,24,5
1731500975353,CHEM 109,B01,735768,Piercy; Marc Anthony,17,0,20,3
1731500975353,CHEM 109,B02,735769,Piercy; Marc Anthony,23,0,24,1
1731500976403,CHEM 114A,A01,784696,Komor; Alexis C,39,0,40,1
1731500976403,CHEM 114A,A02,784723,Komor; Alexis C,38,0,40,2
1731500976403,CHEM 114A,A03,784725,Komor; Alexis C,38,0,40,2
1731500977441,CHEM 114B,A01,785242,Budin; Itay,26,0,40,14
1731500977441,CHEM 114B,A02,785299,Budin; Itay,40,0,40,0
1731500977441,CHEM 114B,A03,785306,Budin; Itay,37,0,40,3
1731500977441,CHEM 114B,A04,785309,Budin; Itay,39,0,40,1
1731500977441,CHEM 114B,B01,785313,Ghosh; Partho,39,0,40,1
1731500977441,CHEM 114B,B02,785375,Ghosh; Partho,38,0,40,2
1731500977441,CHEM 114B,B03,785407,Ghosh; Partho,40,0,40,0
1731500977441,CHEM 114B,B04,785410,Ghosh; Partho,40,0,40,0
1731500978470,CHEM 115,A00,735864,Komor; Alexis C,1,0,30,29
1731500979499,CHEM 120A,A01,785412,Stauber; Julia Megan,28,0,40,12
1731500979499,CHEM 120A,A02,785415,Stauber; Julia Megan,37,0,40,3
1731500979499,CHEM 120A,A03,785417,Stauber; Julia Megan,39,0,39,0
1731500979499,CHEM 120A,A04,785423,Stauber; Julia Megan,38,0,39,1
1731500980534,CHEM 126A,A01,784731,Yong; Haiwang,39,0,40,1
1731500980534,CHEM 126A,A02,784732,Yong; Haiwang,38,0,40,2
1731500980534,CHEM 126A,A03,784737,Yong; Haiwang,38,0,40,2
1731500981565,CHEM 126B,A01,785659,Tauber; Michael,14,0,40,26
1731500981565,CHEM 126B,A02,785664,Tauber; Michael,32,0,40,8
1731500981565,CHEM 126B,A03,785665,Tauber; Michael,20,0,40,20
1731500981565,CHEM 126B,A04,785668,Tauber; Michael,39,0,40,1
1731500981565,CHEM 126B,A05,785669,Tauber; Michael,35,0,40,5
1731500981565,CHEM 126B,A06,785671,Tauber; Michael,33,0,40,7
1731500982602,CHEM 131,A01,785425,Galperin; Michael,37,0,40,3
1731500982602,CHEM 131,A02,785499,Galperin; Michael,38,0,40,2
1731500982602,CHEM 131,A03,785500,Galperin; Michael,39,0,40,1
1731500983634,CHEM 134,A00,735869,Pokorski; Jonathan Kyle,16,0,18,2
1731500984680,CHEM 143B,A01,735871,Weizman; Haim,21,0,24,3
1731500984680,CHEM 143B,A02,735872,Weizman; Haim,20,0,24,4
1731500984680,CHEM 143B,A03,735914,Weizman; Haim,11,0,24,13
1731500984680,CHEM 143B,A04,735916,Weizman; Haim,0,0,0,0
1731500984680,CHEM 143B,A05,735918,Weizman; Haim,0,0,0,0
1731500985710,CHEM 151,A00,735919,Donoghue; Daniel J.,86,0,100,14
1731500986741,CHEM 154,A00,735922,Romero; Nathan A & Schmidt; Valerie A,29,0,30,1
1731500987771,CHEM 155,A00,735925,Theodorakis; Emmanuel,10,0,10,0
1731500988801,CHEM 168,A01,785516,Devaraj; Neal Krishna,39,0,40,1
1731500988801,CHEM 168,A02,785551,Devaraj; Neal Krishna,39,0,40,1
1731500988801,CHEM 168,A03,785554,Devaraj; Neal Krishna,37,0,40,3
1731500988801,CHEM 168,A04,785557,Devaraj; Neal Krishna,37,0,40,3
1731500988801,CHEM 168,A05,785559,Devaraj; Neal Krishna,34,0,40,6
1731500988801,CHEM 168,A06,785566,Devaraj; Neal Krishna,36,0,40,4
1731500989834,CHEM 169,A00,794456,Jinich; Adrian,48,0,50,2
1731500990863,CHEM 172,A01,785676,Pomeroy; Robert S.,46,0,50,4
1731500991891,CHEM 187,A00,735955,Brydges; Stacey,19,0,20,1
1731500992920,CHEM 194,A00,735956,Newsam; John,13,0,18,5
1731500993948,CHEM 200B,A00,735957,Pomeroy; Robert S.,8,0,20,12
1731500994976,CHEM 212,A00,735958,Budin; Itay,14,0,30,16
1731500996008,CHEM 213B,A00,735990,Debelouchina; Galia T,32,0,50,18
1731500997041,CHEM 215,A00,735991,Komor; Alexis C,12,0,30,18
1731500998072,CHEM 219C,A00,735992,Jennings; Patricia A.,9,0,15,6
1731500999101,CHEM 223,A00,735993,Oconnor; Joseph M.,25,0,30,5
1731501000130,CHEM 227,A00,735994,Stauber; Julia Megan,28,0,30,2
1731501001163,CHEM 229,A00,735995,Cohen; Seth M,15,0,20,5
1731501002190,CHEM 232A,A00,735996,Yuen Zhou; Joel,13,0,15,2
1731501003217,CHEM 254,A00,735997,Romero; Nathan A & Schmidt; Valerie A,27,0,30,3
1731501004246,CHEM 255,A00,735998,Theodorakis; Emmanuel,18,0,20,2
1731501005274,CHEM 269,A00,794455,Jinich; Adrian,8,0,25,17
1731501006304,CHEM 291,A00,735999,Debelouchina; Galia T,30,0,30,0
1731501007336,CHEM 294,A00,736000,Romero; Nathan A,48,0,50,2
1731501008365,CHIN 10BD,A01,736053,Liu; Mingming,16,0,16,0
1731501008365,CHIN 10BD,A02,736054,Liu; Mingming,16,0,16,0
1731501009396,CHIN 10BM,A01,736056,Chen; Pei-Chia,18,0,20,2
1731501009396,CHIN 10BM,A02,736057,Chen; Pei-Chia,14,0,15,1
1731501010432,CHIN 10BN,A01,736063,Xu; Li,13,0,13,0
1731501010432,CHIN 10BN,A02,736064,Xu; Li,11,0,13,2
1731501010432,CHIN 10BN,B01,736084,Xu; Li,10,0,13,3
1731501010432,CHIN 10BN,B02,736097,Xu; Li,12,0,13,1
1731501010432,CHIN 10BN,C01,736345,Xu; Li,9,0,13,4
1731501010432,CHIN 10BN,C02,736346,Xu; Li,0,0,0,0
1731501011459,CHIN 20BD,A01,795569,Liu; Mingming,14,0,14,0
1731501011459,CHIN 20BD,A02,795570,Liu; Mingming,14,0,14,0
1731501012489,CHIN 20BM,A01,736414,Wang; Xiao,15,0,16,1
1731501012489,CHIN 20BM,A02,736421,Wang; Xiao,16,0,16,0
1731501013523,CHIN 20BN,A01,736427,Anderson; Qin-Hong,13,0,14,1
1731501013523,CHIN 20BN,A02,736430,Anderson; Qin-Hong,13,0,14,1
1731501013523,CHIN 20BN,B01,736434,Anderson; Qin-Hong,0,0,0,0
1731501013523,CHIN 20BN,B02,736440,Anderson; Qin-Hong,0,0,0,0
1731501014551,CHIN 100BM,A00,736443,Wang; Xiao,20,0,20,0
1731501015578,CHIN 100BN,A00,736444,Chen; Pei-Chia,20,0,21,1
1731501016607,CHIN 169A,A00,736447,Wang; Xiao,20,0,20,0
1731501017638,CHIN 182A,A00,736468,Liu; Mingming,19,0,20,1
1731501018685,CLAS 87,A00,736801,Herbst; Matthew,20,0,20,0
1731501019719,CLIN 227A,A01,799589,Gold; Jeffrey Joseph,20,0,20,0
1731501020750,CLIN 227B,A00,799590,Gold; Jeffrey Joseph,20,0,20,0
1731501021781,CLIN 228,A01,799594,Gold; Jeffrey Joseph,20,0,20,0
1731501022813,CLIN 294B,A00,799595,Thomas; Kelsey Rae,10,0,10,0
1731501023838,CLIN 296,001,799596,Brookman; Lauren Irene,100,0,100,0
1731501023838,CLIN 296,002,799597,Brookman; Lauren Irene,10,0,10,0
1731501024868,CLRE 236R,A00,736762,Mehta; Ravindra L.,9994,0,9999,5
1731501025896,CLRE 237,A00,736763,Morris; Sheldon,9994,0,9999,5
1731501026929,CLRE 250R,A01,736787,Graves; Jennifer Sharon Ol,9999,0,9999,0
1731501027957,CLRE 251R,A00,795042,Mehta; Ravindra L.,9999,0,9999,0
1731501028986,CLRE 253,A00,736792,Vaida; Florin,9998,0,9999,1
1731501030016,CLRE 259,A00,736793,Patel; Hemal,9996,0,9999,3
1731501031048,CLRE 260,A00,736795,Cuomo; Raphael Eduardo,9996,0,9999,3
1731501031048,CLRE 260,B00,800937,Cuomo; Raphael Eduardo,9999,0,9999,0
1731501032078,CLRE 267,A00,795044,Vaida; Florin,9995,0,9999,4
1731501033105,CLRE 295B,A00,736798,Cuomo; Raphael Eduardo,9999,0,9999,0
1731501034131,CLRE 297,001,736799,Cuomo; Raphael Eduardo,9999,0,9999,0
1731501035160,CMM 246,A00,796595,Gordts; Philip & Lewis; Amanda Lark & Godula; Kamil & Gagneux; Pascal & Esko; Jeffrey D. & Bode; Lars,10,0,10,0
1731501036247,COGR 200B,A00,738801,Cordoba Azcarate; Matilde,5,0,5,0
1731501037274,COGR 200C,A00,738803,Geiger; Richard Stuart,5,0,5,0
1731501038307,COGR 201J,A00,738804,Hallin; Daniel C,8,0,10,2
1731501039337,COGR 225C,A00,738805,McKenzie; Kerry V.,4,0,5,1
1731501040371,COGR 225D,A00,738806,Lampland; Martha,5,0,5,0
1731501041403,COGR 237,A00,738807,Anderson; Patrick W.,3,0,10,7
1731501042431,COGR 275,A00,738808,Dominguez Rubio; Fernando,10,0,10,0
1731501043465,COGS 1,A01,737008,Kiyonaga; Anastasia,55,0,62,7
1731501043465,COGS 1,A02,737010,Kiyonaga; Anastasia,62,0,65,3
1731501043465,COGS 1,A03,737011,Kiyonaga; Anastasia,65,0,66,1
1731501043465,COGS 1,A04,737014,Kiyonaga; Anastasia,56,0,56,0
1731501043465,COGS 1,A05,737015,Kiyonaga; Anastasia,56,0,56,0
1731501043465,COGS 1,A06,737016,Kiyonaga; Anastasia,50,0,56,6
1731501043465,COGS 1,A07,737018,Kiyonaga; Anastasia,55,0,56,1
1731501044495,COGS 9,A01,737025,Staff,55,0,56,1
1731501044495,COGS 9,A02,737028,Staff,54,0,56,2
1731501044495,COGS 9,A03,737029,Staff,55,0,56,1
1731501044495,COGS 9,A04,737030,Staff,53,0,56,3
1731501044495,COGS 9,A05,737031,Staff,54,0,56,2
1731501044495,COGS 9,A06,737033,Staff,45,0,48,3
1731501045528,COGS 10,A01,737044,Morgan; Eric,48,0,56,8
1731501045528,COGS 10,A02,737045,Morgan; Eric,51,0,58,7
1731501045528,COGS 10,A03,737047,Morgan; Eric,52,0,56,4
1731501045528,COGS 10,A04,737049,Morgan; Eric,53,0,56,3
1731501045528,COGS 10,A05,737050,Morgan; Eric,51,0,52,1
1731501045528,COGS 10,A06,737051,Morgan; Eric,48,0,50,2
1731501046557,COGS 11,A01,737077,Boyle; Mary E. T.,46,0,50,4
1731501046557,COGS 11,A02,737078,Boyle; Mary E. T.,50,0,50,0
1731501046557,COGS 11,A03,737135,Boyle; Mary E. T.,44,0,47,3
1731501047586,COGS 13,A01,737138,Staff,63,0,65,2
1731501047586,COGS 13,A02,737139,Staff,53,0,56,3
1731501047586,COGS 13,A03,737142,Staff,54,0,56,2
1731501047586,COGS 13,A04,737144,Staff,56,0,56,0
1731501047586,COGS 13,A05,737145,Staff,53,0,56,3
1731501047586,COGS 13,A06,737148,Staff,56,0,56,0
1731501047586,COGS 13,A07,737149,Staff,65,0,65,0
1731501048620,COGS 14A,A01,737151,Barrera; Steven James,57,0,60,3
1731501048620,COGS 14A,A02,737152,Barrera; Steven James,55,0,60,5
1731501048620,COGS 14A,A03,737153,Barrera; Steven James,59,0,60,1
1731501048620,COGS 14A,A04,737154,Barrera; Steven James,58,0,60,2
1731501048620,COGS 14A,A05,737155,Barrera; Steven James,59,0,60,1
1731501049648,COGS 14B,A01,737157,Hoffman; Drew Ellen,46,0,50,4
1731501049648,COGS 14B,A02,737158,Hoffman; Drew Ellen,48,0,50,2
1731501049648,COGS 14B,A03,737159,Hoffman; Drew Ellen,48,0,50,2
1731501049648,COGS 14B,A04,737160,Hoffman; Drew Ellen,49,0,50,1
1731501049648,COGS 14B,A05,737189,Hoffman; Drew Ellen,50,0,50,0
1731501050678,COGS 17,A01,737193,Johnson; Christine M.,56,0,60,4
1731501050678,COGS 17,A02,737200,Johnson; Christine M.,57,0,60,3
1731501050678,COGS 17,A03,737210,Johnson; Christine M.,57,0,60,3
1731501050678,COGS 17,A04,737211,Johnson; Christine M.,59,0,60,1
1731501050678,COGS 17,A05,737234,Johnson; Christine M.,57,0,60,3
1731501050678,COGS 17,A06,737237,Johnson; Christine M.,58,0,60,2
1731501051707,COGS 18,A01,737254,Morgan; Eric,32,0,35,3
1731501051707,COGS 18,A02,737255,Morgan; Eric,33,0,35,2
1731501051707,COGS 18,A03,737256,Morgan; Eric,31,0,35,4
1731501051707,COGS 18,A04,737257,Morgan; Eric,31,0,35,4
1731501051707,COGS 18,A05,737264,Morgan; Eric,28,0,35,7
1731501051707,COGS 18,A06,737265,Morgan; Eric,32,0,35,3
1731501051707,COGS 18,A07,737288,Morgan; Eric,32,0,35,3
1731501051707,COGS 18,A08,737333,Morgan; Eric,35,0,35,0
1731501051707,COGS 18,A09,737334,Morgan; Eric,33,0,35,2
1731501052737,COGS 87,A00,737335,Deak; Gedeon O.,19,0,20,1
1731501053770,COGS 100,A01,737386,Allen; Michael Gordon,49,0,56,7
1731501053770,COGS 100,A02,737387,Allen; Michael Gordon,56,0,56,0
1731501053770,COGS 100,A03,737390,Allen; Michael Gordon,55,0,56,1
1731501053770,COGS 100,A04,737392,Allen; Michael Gordon,55,0,56,1
1731501053770,COGS 100,A05,737393,Allen; Michael Gordon,58,0,61,3
1731501053770,COGS 100,A06,737394,Allen; Michael Gordon,65,0,65,0
1731501054806,COGS 101A,A01,737396,Barrera; Steven James,57,0,61,4
1731501054806,COGS 101A,A02,737399,Barrera; Steven James,61,0,65,4
1731501054806,COGS 101A,A03,737400,Barrera; Steven James,53,0,56,3
1731501054806,COGS 101A,A04,737401,Barrera; Steven James,53,0,56,3
1731501054806,COGS 101A,A05,737404,Barrera; Steven James,54,0,56,2
1731501054806,COGS 101A,A06,737405,Barrera; Steven James,56,0,56,0
1731501055838,COGS 101B,A01,737408,Allen; Michael Gordon,46,0,50,4
1731501055838,COGS 101B,A02,737412,Allen; Michael Gordon,49,0,50,1
1731501055838,COGS 101B,A03,737413,Allen; Michael Gordon,49,0,50,1
1731501055838,COGS 101B,A04,737414,Allen; Michael Gordon,50,0,50,0
1731501055838,COGS 101B,A05,737415,Allen; Michael Gordon,49,0,50,1
1731501055838,COGS 101B,A06,737417,Allen; Michael Gordon,50,0,50,0
1731501056869,COGS 107A,A01,737419,Boyle; Mary E. T.,51,0,56,5
1731501056869,COGS 107A,A02,737421,Boyle; Mary E. T.,44,0,56,12
1731501056869,COGS 107A,A03,737423,Boyle; Mary E. T.,43,0,56,13
1731501056869,COGS 107A,A04,737424,Boyle; Mary E. T.,49,0,56,7
1731501056869,COGS 107A,A05,737425,Boyle; Mary E. T.,50,0,56,6
1731501056869,COGS 107A,A06,737426,Boyle; Mary E. T.,56,0,65,9
1731501056869,COGS 107A,A07,737429,Boyle; Mary E. T.,51,0,65,14
1731501057898,COGS 107B,A01,737431,Mooshagian; Eric Frederick,49,0,50,1
1731501057898,COGS 107B,A02,737435,Mooshagian; Eric Frederick,49,0,50,1
1731501057898,COGS 107B,A03,737436,Mooshagian; Eric Frederick,55,0,65,10
1731501057898,COGS 107B,A04,737438,Mooshagian; Eric Frederick,61,0,63,2
1731501057898,COGS 107B,A05,737439,Mooshagian; Eric Frederick,47,0,50,3
1731501057898,COGS 107B,A06,737440,Mooshagian; Eric Frederick,50,0,50,0
1731501058935,COGS 108,A01,737442,Ellis; Shannon Elizabeth,46,0,56,10
1731501058935,COGS 108,A02,737447,Ellis; Shannon Elizabeth,52,0,56,4
1731501058935,COGS 108,A03,737450,Ellis; Shannon Elizabeth,54,0,56,2
1731501058935,COGS 108,A04,737451,Ellis; Shannon Elizabeth,52,0,56,4
1731501058935,COGS 108,A05,737452,Ellis; Shannon Elizabeth,52,0,56,4
1731501058935,COGS 108,A06,737454,Ellis; Shannon Elizabeth,59,0,65,6
1731501058935,COGS 108,A07,737455,Ellis; Shannon Elizabeth,61,0,65,4
1731501058935,COGS 108,B01,737457,Ellis; Shannon Elizabeth,47,0,56,9
1731501058935,COGS 108,B02,737459,Ellis; Shannon Elizabeth,48,0,56,8
1731501058935,COGS 108,B03,737460,Ellis; Shannon Elizabeth,47,0,56,9
1731501058935,COGS 108,B04,737461,Ellis; Shannon Elizabeth,41,0,56,15
1731501058935,COGS 108,B05,737462,Ellis; Shannon Elizabeth,35,0,56,21
1731501058935,COGS 108,B06,737471,Ellis; Shannon Elizabeth,62,0,65,3
1731501058935,COGS 108,B07,737472,Ellis; Shannon Elizabeth,64,0,65,1
1731501059966,COGS 109,A01,737475,Staff,34,0,35,1
1731501059966,COGS 109,A02,737476,Staff,33,0,35,2
1731501059966,COGS 109,A03,737477,Staff,35,0,35,0
1731501059966,COGS 109,A04,737478,Staff,31,0,35,4
1731501060997,COGS 111,A01,737480,Hoffman; Drew Ellen,49,0,50,1
1731501060997,COGS 111,A02,737482,Hoffman; Drew Ellen,49,0,50,1
1731501060997,COGS 111,A03,737483,Hoffman; Drew Ellen,49,0,50,1
1731501060997,COGS 111,A04,737485,Hoffman; Drew Ellen,45,0,50,5
1731501062029,COGS 115,A01,737487,Deak; Gedeon O.,52,0,60,8
1731501063058,COGS 116,A01,737490,Greene; Deanna Jacquelyn,42,0,49,7
1731501063058,COGS 116,A02,737491,Greene; Deanna Jacquelyn,45,0,49,4
1731501064086,COGS 118C,A01,737493,Mukamel; Eran A,47,0,75,28
1731501065118,COGS 120,A01,737503,Xia; Haijun,44,0,50,6
1731501065118,COGS 120,A02,737763,Xia; Haijun,40,0,50,10
1731501065118,COGS 120,A03,737765,Xia; Haijun,50,0,50,0
1731501065118,COGS 120,A04,737766,Xia; Haijun,44,0,50,6
1731501065118,COGS 120,A05,737775,Xia; Haijun,50,0,50,0
1731501065118,COGS 120,A06,737781,Xia; Haijun,37,0,50,13
1731501066147,COGS 122,A01,737787,Dow; Steven P,0,0,0,5
1731501067176,COGS 126,A01,737795,Hollan; James D.,47,0,50,3
1731501068208,COGS 127,A01,737801,Guo; Philip J,46,0,50,4
1731501068208,COGS 127,A02,737805,Guo; Philip J,41,0,50,9
1731501068208,COGS 127,A03,737806,Guo; Philip J,44,0,50,6
1731501068208,COGS 127,A04,737811,Guo; Philip J,40,0,50,10
1731501068208,COGS 127,A05,737818,Guo; Philip J,3,0,50,47
1731501069236,COGS 144,A01,737824,Rossano; Federico,48,0,50,2
1731501082685,COGS 153,A00,737829,Staff,139,0,149,10
1731501083717,COGS 155,A01,737836,Cooperrider; Kensy A,48,0,50,2
1731501084748,COGS 156,A01,737841,Creel; Sarah,69,0,75,6
1731501085777,COGS 160,A00,737849,Kirsh; David Joel,25,0,25,0
1731501085777,COGS 160,B00,796034,Beatty-Martinez; Anne,74,0,75,1
1731501085777,COGS 160,C00,796035,Staff,149,0,149,0
1731501086809,COGS 164,A01,737961,Chiba; Andrea,40,0,45,5
1731501086809,COGS 164,A02,796040,Chiba; Andrea,28,0,45,17
1731501087839,COGS 177,A00,737964,Staff,110,0,120,10
1731501088867,COGS 181,A01,796038,Tu; Zhuowen,37,0,50,13
1731501088867,COGS 181,A02,796039,Tu; Zhuowen,31,0,50,19
1731501089900,COGS 187B,A01,737972,Kirsh; David Joel,48,0,50,2
1731501089900,COGS 187B,A02,738380,Kirsh; David Joel,17,0,50,33
1731501090932,COGS 188,A01,738029,Fleischer; Jason G,39,0,60,21
1731501090932,COGS 188,A02,738030,Fleischer; Jason G,56,0,60,4
1731501091958,COGS 189,A00,738031,De Sa; Virginia,165,0,200,35
1731501105562,COGS 190B,:00,796056,Staff,20,0,20,0
1731501105562,COGS 190B,A00,738176,Chiba; Andrea,9999,0,9999,0
1731501105562,COGS 190B,B00,738177,Fleischer; Jason G,20,0,20,0
1731501105562,COGS 190B,C00,738258,Hoffman; Drew Ellen,20,0,20,0
1731501105562,COGS 190B,D00,738259,Voytek; Bradley Thomas,20,0,20,0
1731501105562,COGS 190B,E00,738272,Kirsh; David Joel,20,0,20,0
1731501105562,COGS 190B,F00,738287,Kiyonaga; Anastasia,20,0,20,0
1731501105562,COGS 190B,G00,796051,Beatty-Martinez; Anne,20,0,20,0
1731501105562,COGS 190B,H00,796052,Nitz; Douglas A.,20,0,20,0
1731501105562,COGS 190B,I00,796053,De Sa; Virginia,20,0,20,0
1731501105562,COGS 190B,J00,796054,Rangel; Lara M,20,0,20,0
1731501105562,COGS 190B,K00,796055,Boyle; Mary E. T.,20,0,20,0
1731501105562,COGS 190B,L00,796058,Jernigan; Terry Lynne,20,0,20,0
1731501105562,COGS 190B,M00,796059,Deak; Gedeon O.,20,0,20,0
1731501105562,COGS 190B,N00,796060,Tu; Zhuowen,20,0,20,0
1731501105562,COGS 190B,O00,796061,Creel; Sarah,20,0,20,0
1731501106592,COGS 194,A00,738288,Hill; Seth J,9999,0,9999,0
1731501107620,COGS 198,001,738361,Voytek; Bradley Thomas,20,0,20,0
1731501108650,COGS 205,A00,738365,Chiba; Andrea,17,0,20,3
1731501109685,COGS 210B,001,736818,Nitz; Douglas A.,9998,0,9999,1
1731501109685,COGS 210B,002,736819,Xia; Haijun,9999,0,9999,0
1731501109685,COGS 210B,003,736820,Bergen; Benjamin,9998,0,9999,1
1731501109685,COGS 210B,004,736822,Kirsh; David Joel,9999,0,9999,0
1731501109685,COGS 210B,005,736824,Rangel; Lara M,9998,0,9999,1
1731501109685,COGS 210B,006,736825,Rossano; Federico,9999,0,9999,0
1731501109685,COGS 210B,007,736826,Guo; Philip J,9999,0,9999,0
1731501109685,COGS 210B,008,736829,De Sa; Virginia,9999,0,9999,0
1731501109685,COGS 210B,009,796069,Greene; Deanna Jacquelyn,9999,0,9999,0
1731501109685,COGS 210B,010,796070,Hollan; James D.,9999,0,9999,0
1731501109685,COGS 210B,011,796071,Kiyonaga; Anastasia,9999,0,9999,0
1731501109685,COGS 210B,012,796073,Coulson; Seana M,9999,0,9999,0
1731501109685,COGS 210B,013,796074,Dow; Steven P,9999,0,9999,0
1731501110715,COGS 211B,A00,736830,Coulson; Seana M,17,0,20,3
1731501111744,COGS 219,A01,736835,Zettersten; Martin,0,0,0,17
1731501112774,COGS 223,A00,736836,Dow; Steven P,18,0,25,7
1731501113806,COGS 229,A00,736842,Vaccaro; Kristen Marie,9,0,10,1
1731501114834,COGS 260,A00,736843,Kiyonaga; Anastasia,16,0,25,9
1731501118111,COMM 10,A01,738505,Armenta; John E,21,0,25,4
1731501118111,COMM 10,A02,738683,Armenta; John E,21,0,25,4
1731501118111,COMM 10,A03,738685,Armenta; John E,18,0,25,7
1731501118111,COMM 10,A04,738686,Armenta; John E,23,0,25,2
1731501118111,COMM 10,A05,738687,Armenta; John E,23,0,25,2
1731501118111,COMM 10,A06,738688,Armenta; John E,23,0,25,2
1731501118111,COMM 10,A07,738689,Armenta; John E,25,0,25,0
1731501118111,COMM 10,A08,738690,Armenta; John E,25,0,25,0
1731501118111,COMM 10,A09,738691,Armenta; John E,25,0,25,0
1731501118111,COMM 10,A10,738693,Armenta; John E,25,0,25,0
1731501118111,COMM 10,A11,738694,Armenta; John E,25,0,25,0
1731501118111,COMM 10,A12,738695,Armenta; John E,24,0,25,1
1731501119142,COMM 20,A01,738704,McKenna; Denise,73,0,75,2
1731501120174,COMM 30,A00,738705,Schmidt; Thomas Rainer,72,0,75,3
1731501121203,COMM 50,A00,738706,Armenta; John E,24,0,25,1
1731501122230,COMM 80,A01,738710,Campbell; Robert Harold,79,0,80,1
1731501123258,COMM 87,A00,795241,Serlin; David,20,0,20,0
1731501124290,COMM 100C,A01,738712,Dewaard; Andrew Michael,22,0,25,3
1731501124290,COMM 100C,A02,738713,Dewaard; Andrew Michael,25,0,25,0
1731501124290,COMM 100C,A03,738714,Dewaard; Andrew Michael,22,0,25,3
1731501124290,COMM 100C,A04,738715,Dewaard; Andrew Michael,21,0,25,4
1731501124290,COMM 100C,A05,738716,Dewaard; Andrew Michael,24,0,25,1
1731501124290,COMM 100C,A06,738718,Dewaard; Andrew Michael,23,0,25,2
1731501124290,COMM 100C,A07,738720,Dewaard; Andrew Michael,24,0,25,1
1731501124290,COMM 100C,A09,738724,Dewaard; Andrew Michael,24,0,25,1
1731501124290,COMM 100C,A11,738726,Dewaard; Andrew Michael,24,0,25,1
1731501124290,COMM 100C,A12,738727,Dewaard; Andrew Michael,24,0,25,1
1731501125319,COMM 101,A01,738730,Ahn; Patricia Jeehyun,14,0,15,1
1731501125319,COMM 101,A02,738731,Ahn; Patricia Jeehyun,15,0,15,0
1731501125319,COMM 101,A03,738732,Ahn; Patricia Jeehyun,12,0,15,3
1731501125319,COMM 101,A04,738733,Ahn; Patricia Jeehyun,13,0,15,2
1731501126345,COMM 101D,A00,738737,Martinico; Daniel J,16,0,16,0
1731501127372,COMM 101K,A00,738743,Ahn; Patricia Jeehyun,13,0,16,3
1731501128401,COMM 101N,A00,738746,Martinico; Daniel J,16,0,16,0
1731501129432,COMM 101T,A00,738749,Halm; Gavin Patrick,14,0,18,4
1731501129432,COMM 101T,B00,738752,Halm; Gavin Patrick,18,0,18,0
1731501129432,COMM 101T,C00,795163,Dewey; Matthew D,10,0,10,0
1731501130468,COMM 102B,A01,738754,Peacher; Amanda M,8,0,9,1
1731501130468,COMM 102B,A02,738755,Peacher; Amanda M,9,0,9,0
1731501131494,COMM 102C,A01,738757,Campion; Camille E,3,0,6,3
1731501131494,COMM 102C,A02,738758,Campion; Camille E,6,0,6,0
1731501131494,COMM 102C,A03,738759,Campion; Camille E,6,0,6,0
1731501132523,COMM 103D,A00,799575,Davis; Zeinabu I.,30,0,30,0
1731501133553,COMM 103E,A00,738763,Dewey; Matthew D,29,0,30,1
1731501134581,COMM 106,A00,738764,Kidman; Shawna F,138,0,140,2
1731501135613,COMM 106M,A00,738765,Whitworth-Smith; Andrew C,67,0,75,8
1731501136639,COMM 106N,A00,738766,Schmidt; Thomas Rainer,21,0,30,9
1731501137667,COMM 107,A00,738767,Serlin; David,30,0,30,0
1731501138694,COMM 111A,A00,738769,Pavon Aramburu; Maria Laur,29,0,30,1
1731501139722,COMM 111B,A00,738770,Zilberg; Elana,38,0,40,2
1731501140751,COMM 111P,A00,738771,Ruskiewicz; Eva Marie,29,0,30,1
1731501141783,COMM 113T,A00,738774,Abuelhiga; Soraya Jill,28,0,30,2
1731501141783,COMM 113T,B00,738775,Fields; Gary,30,0,30,0
1731501141783,COMM 113T,C00,738776,McKenna; Denise,29,0,30,1
1731501142817,COMM 114I,A00,738780,Leuning; Grant Maurstad,30,0,30,0
1731501143846,COMM 114T,A00,738781,Walkover; Lillian B,29,0,30,1
1731501144875,COMM 120M,A00,738783,Lazitski Torres; Olga,30,0,30,0
1731501145906,COMM 124A,A00,738784,Irani; Lilly C,73,0,75,2
1731501146936,COMM 134,A00,738785,Kidman; Shawna F,29,0,30,1
1731501149011,COMM 138,A00,738786,Boateng; Boatema,30,0,30,0
1731501150049,COMM 145,A00,738788,Rojo Solis; Juan Jose,29,0,30,1
1731501151076,COMM 146,A00,738789,Ybarra; Megan,28,0,30,2
1731501152107,COMM 156,A00,738791,Staff,30,0,30,0
1731501153139,COMM 159,A00,738792,Cordoba Azcarate; Matilde,23,0,30,7
1731501154170,COMM 164,A00,738793,Dominguez Rubio; Fernando,25,0,25,0
1731501155197,COMM 177,A00,795164,Rojo Solis; Juan Jose,25,0,25,0
1731501156227,COMM 190,A00,738795,Boateng; Boatema,23,0,23,0
1731501156227,COMM 190,B00,738797,Staff,19,0,23,4
1731501156227,COMM 190,C00,738798,Wiering; Liesbeth,21,0,23,2
1731501157257,COMM 194,A00,770727,Hill; Seth J,9999,0,9999,0
1731501158285,COMM 196B,A00,738800,Dewaard; Andrew Michael,10,0,10,0
1731501159317,CSE 8A,A50,738815,Alvarado; Christine J.,39,0,40,1
1731501159317,CSE 8A,A51,738819,Alvarado; Christine J.,40,0,40,0
1731501159317,CSE 8A,A52,738823,Alvarado; Christine J.,40,0,40,0
1731501159317,CSE 8A,A53,738825,Alvarado; Christine J.,35,0,40,5
1731501159317,CSE 8A,A54,738826,Alvarado; Christine J.,37,0,40,3
1731501159317,CSE 8A,A55,799488,Alvarado; Christine J.,0,0,0,0
1731501160342,CSE 8B,A01,788635,Ochoa; Benjamin Lawrence,59,0,70,11
1731501161377,CSE 11,A01,788660,Cao; Yingjun,161,0,175,14
1731501162408,CSE 12,A01,788668,Cao; Yingjun,25,0,50,25
1731501163437,CSE 20,A01,786527,Jones; Miles E,18,0,25,7
1731501163437,CSE 20,A02,786528,Jones; Miles E,19,0,25,6
1731501164468,CSE 21,A01,786539,Jones; Miles E,46,0,50,4
1731501164468,CSE 21,A02,786540,Jones; Miles E,49,0,50,1
1731501165505,CSE 29,A50,738835,Soosai Raj; Adalbert Geral,0,0,5,5
1731501165505,CSE 29,A51,738840,Soosai Raj; Adalbert Geral,4,0,5,1
1731501165505,CSE 29,A52,738842,Soosai Raj; Adalbert Geral,3,0,5,2
1731501165505,CSE 29,A53,738844,Soosai Raj; Adalbert Geral,4,0,4,0
1731501165505,CSE 29,B50,738846,Soosai Raj; Adalbert Geral,0,0,5,5
1731501165505,CSE 29,B51,738847,Soosai Raj; Adalbert Geral,0,0,5,5
1731501165505,CSE 29,B52,738848,Soosai Raj; Adalbert Geral,1,0,5,4
1731501165505,CSE 29,B53,738849,Soosai Raj; Adalbert Geral,3,0,4,1
1731501166537,CSE 30,A01,788669,Chin; Bryan W.,42,0,50,8
1731501167566,CSE 87,A00,738901,Moshiri; Niema,19,0,20,1
1731501167566,CSE 87,B00,739036,Cottrell; Garrison W,20,0,20,0
1731501168598,CSE 95,A00,739094,Minnes Kemp; Mor Mia,100,0,100,0
1731501169629,CSE 100,A01,788682,Moshiri; Niema,21,0,50,29
1731501170663,CSE 100R,A01,739414,Moshiri; Niema,25,0,50,25
1731501171692,CSE 101,A01,788685,Saha; Barna,0,0,20,20
1731501171692,CSE 101,B01,788713,Saha; Barna,0,0,20,20
1731501172721,CSE 105,A01,786574,Minnes Kemp; Mor Mia,113,0,150,37
1731501173752,CSE 107,A01,786529,Heninger; Nadia A,136,0,146,10
1731501174782,CSE 110,A50,739705,Griswold; William G.,58,0,75,17
1731501174782,CSE 110,A51,739706,Griswold; William G.,74,0,75,1
1731501174782,CSE 110,A52,739707,Griswold; William G.,70,0,75,5
1731501175810,CSE 120,A01,786531,Pasquale; Joseph,89,0,146,57
1731501176842,CSE 122,A01,739739,Pannuto; Patrick William,0,0,25,25
1731501177875,CSE 127,A01,788718,Munyaka; Imani N. S.,174,0,192,18
1731501178909,CSE 130,A01,788720,Jhala; Ranjit,172,0,192,20
1731501179935,CSE 132A,A01,788721,Vianu; Victor Dan,163,0,196,33
1731501180965,CSE 134B,A01,788723,Powell; Thomas Allan,172,0,192,20
1731501181993,CSE 140,A01,786577,Rosing; Tajana Simunic,274,0,300,26
1731501183022,CSE 140L,A01,739761,Eldon; John,148,0,196,48
1731501184055,CSE 142,A01,788724,Swanson; Steven James,179,0,196,17
1731501185082,CSE 147,A00,739766,Rosing; Tajana Simunic,0,0,60,60
1731501186113,CSE 148,A01,785688,Tullsen; Dean Michael,13,0,20,7
1731501187145,CSE 150A,A01,788727,Solares; Edwin A,182,0,196,14
1731501188172,CSE 151A,A01,788728,Shang; Jingbo,171,0,250,79
1731501189201,CSE 151B,A01,787804,Cottrell; Garrison W,163,0,192,29
1731501190230,CSE 152A,A01,788729,Chandraker; Manmohan Krishna,163,0,192,29
1731501191265,CSE 156,A01,786532,Qin; Lianhui,133,0,146,13
1731501192293,CSE 160,A01,788730,Kastner; Ryan Charles,195,0,250,55
1731501193323,CSE 167,A01,788731,Chern; Albert Ren-Haur,176,0,192,16
1731501194358,CSE 169,A01,785224,Rotenberg; Steven Paul,0,0,0,0
1731501195392,CSE 181,A01,770733,Pevzner; Pavel Arkadjevich,31,0,35,4
1731501196428,CSE 190,A00,739790,Bandeira; Nuno Filipe Cabrita,45,0,50,5
1731501196428,CSE 190,B00,739791,Shalev; Aaron D,43,0,50,7
1731501196428,CSE 190,C00,739821,Ousterhout; Amy,36,0,50,14
1731501196428,CSE 190,D00,739834,McAuley; Julian John,189,0,196,7
1731501197457,CSE 191,A00,739839,Minnes Kemp; Mor Mia,9999,0,9999,0
1731501198485,CSE 197,001,799832,Minnes Kemp; Mor Mia,9999,0,9999,0
1731501199519,CSE 202,A00,739848,Impagliazzo; Russell,0,0,0,0
1731501200550,CSE 203B,A01,788732,Cheng; Chung Kuan,0,0,0,0
1731501201578,CSE 207A,A00,739858,Bellare; Mihir,0,0,0,0
1731501202605,CSE 209A,A00,739859,Grier; Daniel T,0,0,0,0
1731501203637,CSE 210,A00,739873,Coblenz; Michael J,0,0,0,0
1731501204679,CSE 219,A00,739901,Vaccaro; Kristen Marie,0,0,0,0
1731501205707,CSE 220,A01,796042,Staff,0,0,0,0
1731501206734,CSE 222C,A01,739906,Pannuto; Patrick William,0,0,0,0
1731501207762,CSE 227,A00,739923,Kumar; Deepak,0,0,0,0
1731501208791,CSE 229A,A00,739925,Zhang; Yiying,0,0,0,0
1731501209820,CSE 230,A00,740210,Jhala; Ranjit,0,0,0,0
1731501210849,CSE 232B,A00,740214,Deutsch; Alin Bernard,0,0,0,0
1731501211886,CSE 234,A01,788733,Zhang; Hao,0,0,0,0
1731501212914,CSE 237A,A00,740218,Rosing; Tajana Simunic,0,0,0,0
1731501213942,CSE 239A,A00,740222,Deutsch; Alin Bernard,0,0,0,0
1731501214969,CSE 240A,A00,740228,Tullsen; Dean Michael,0,0,0,0
1731501215997,CSE 240B,A00,740234,Zhao; Jishen,0,0,0,0
1731501217025,CSE 244A,A00,740240,Orailoglu; Alex,0,0,0,0
1731501218053,CSE 251A,A01,788735,Berg-Kirkpatrick; Taylor D,0,0,0,0
1731501219081,CSE 251B,A01,787805,Cottrell; Garrison W,0,0,0,0
1731501220112,CSE 251C,A01,785687,Dasgupta; Sanjoy,0,0,0,0
1731501221197,CSE 252A,A00,740250,Ochoa; Benjamin Lawrence,0,0,0,0
1731501222223,CSE 257,A01,788739,Gao; Sicun,0,0,0,0
1731501223252,CSE 272,A00,740254,Li; Tzumao,0,0,0,0
1731501224285,CSE 280A,A00,740297,Bafna; Vineet,0,0,0,0
1731501225314,CSE 282,A00,740308,Pevzner; Pavel Arkadjevich,0,0,0,0
1731501226352,CSE 290,A00,740312,Chandraker; Manmohan Krishna,0,0,0,0
1731501226352,CSE 290,C00,740327,Christensen; Henrik I,0,0,0,0
1731501226352,CSE 290,D00,740402,Pevzner; Pavel Arkadjevich,0,0,0,0
1731501226352,CSE 290,E00,740403,Munyaka; Imani N. S.,0,0,0,0
1731501226352,CSE 290,G00,740411,Qin; Lianhui,0,0,0,0
1731501226352,CSE 290,H00,740413,Shalev; Aaron D,0,0,0,0
1731501226352,CSE 290,I00,796145,Lovett; Shachar,0,0,0,0
1731501226352,CSE 290,J00,796174,Yu; Qi,0,0,0,0
1731501226352,CSE 290,B00,740325,Orailoglu; Alex,0,0,0,0
1731501227382,CSE 291,A00,740416,Liu; Qipeng,0,0,0,0
1731501227382,CSE 291,B00,740420,Pasquale; Joseph,0,0,0,0
1731501227382,CSE 291,C00,740421,Savage; Stefan & Voelker; Geoffrey M.,0,0,0,0
1731501227382,CSE 291,D00,740441,Ding; Yufei,0,0,0,0
1731501227382,CSE 291,E00,740442,Vaccaro; Kristen Marie,0,0,0,0
1731501227382,CSE 291,F00,740443,Fernandes; Earlence T,0,0,0,0
1731501227382,CSE 291,G00,740447,Paturi; Ramamohan,0,0,0,0
1731501227382,CSE 291,H00,740448,Prithviraj; Ammanabrolu,0,0,0,0
1731501227382,CSE 291,I00,740468,Zhang; Yiying,0,0,0,0
1731501227382,CSE 291,J00,740469,McAuley; Julian John,0,0,0,0
1731501228420,CSE 293,001,796628,Bafna; Vineet,9999,0,9999,0
1731501228420,CSE 293,002,796638,Bellare; Mihir,9999,0,9999,0
1731501228420,CSE 293,003,796645,Berg-Kirkpatrick; Taylor D,9999,0,9999,0
1731501228420,CSE 293,004,796646,Chandraker; Manmohan Krishna,9999,0,9999,0
1731501228420,CSE 293,005,796647,Cheng; Chung Kuan,9999,0,9999,0
1731501228420,CSE 293,006,796648,Christensen; Henrik I,9998,0,9999,1
1731501228420,CSE 293,007,796649,Coblenz; Michael J,9999,0,9999,0
1731501228420,CSE 293,008,796650,Cottrell; Garrison W,9999,0,9999,0
1731501228420,CSE 293,009,796651,Deutsch; Alin Bernard,9999,0,9999,0
1731501228420,CSE 293,010,796652,Esmaeilzadeh; Hadi,9999,0,9999,0
1731501228420,CSE 293,011,796653,Freund; Yoav,9999,0,9999,0
1731501228420,CSE 293,012,796654,Griswold; William G.,9999,0,9999,0
1731501228420,CSE 293,013,796655,Gymrek; Melissa Ann,9999,0,9999,0
1731501228420,CSE 293,014,796656,Heninger; Nadia A,9999,0,9999,0
1731501228420,CSE 293,015,796657,Impagliazzo; Russell,9999,0,9999,0
1731501228420,CSE 293,016,796658,Jhala; Ranjit,9999,0,9999,0
1731501228420,CSE 293,017,796659,Kahng; Andrew Byun,9999,0,9999,0
1731501228420,CSE 293,018,796660,Kane; Daniel Mertz,9999,0,9999,0
1731501228420,CSE 293,019,796661,Kriegman; David J,9999,0,9999,0
1731501228420,CSE 293,020,796662,Kumar; Arun Kumar,9999,0,9999,0
1731501228420,CSE 293,021,796663,Lerner; Sorin,9999,0,9999,0
1731501228420,CSE 293,022,796664,Lovett; Shachar,9999,0,9999,0
1731501228420,CSE 293,023,796665,McAuley; Julian John,9998,0,9999,1
1731501228420,CSE 293,024,796666,Micciancio; Daniele,9999,0,9999,0
1731501228420,CSE 293,025,796667,Orailoglu; Alex,9999,0,9999,0
1731501228420,CSE 293,026,796668,Pannuto; Patrick William,9999,0,9999,0
1731501228420,CSE 293,027,796669,Paturi; Ramamohan,9999,0,9999,0
1731501228420,CSE 293,028,796670,Polikarpova; Nadezhda,9999,0,9999,0
1731501228420,CSE 293,029,796671,Politz; Joseph Gibbs,9999,0,9999,0
1731501228420,CSE 293,030,796672,Porter; George M,9998,0,9999,1
1731501228420,CSE 293,031,796673,Porter; Leonard Emerson,9999,0,9999,0
1731501228420,CSE 293,032,796674,Ramamoorthi; Ravi,9999,0,9999,0
1731501228420,CSE 293,033,796675,Riek; Laurel D,9999,0,9999,0
1731501228420,CSE 293,034,796676,Sahoo; Debashis,9999,0,9999,0
1731501228420,CSE 293,035,796677,Saul; Lawrence,9999,0,9999,0
1731501228420,CSE 293,036,796678,Savage; Stefan,9999,0,9999,0
1731501228420,CSE 293,037,796679,Schulze; Jurgen P.,9999,0,9999,0
1731501228420,CSE 293,038,796680,Snoeren; Alex C.,9999,0,9999,0
1731501228420,CSE 293,039,796681,Shang; Jingbo,9997,0,9999,2
1731501228420,CSE 293,040,796682,Stefan; Deian,9999,0,9999,0
1731501228420,CSE 293,041,796683,Su; Hao,9999,0,9999,0
1731501228420,CSE 293,042,796684,Swanson; Steven James,9999,0,9999,0
1731501228420,CSE 293,043,796685,Tullsen; Dean Michael,9999,0,9999,0
1731501228420,CSE 293,044,796686,Vaccaro; Kristen Marie,9999,0,9999,0
1731501228420,CSE 293,045,796687,Voelker; Geoffrey M.,9999,0,9999,0
1731501228420,CSE 293,046,796688,Zhao; Jishen,9999,0,9999,0
1731501228420,CSE 293,047,796689,Zhou; Yuan-Yuan,9999,0,9999,0
1731501228420,CSE 293,048,796690,Gao; Sicun,9999,0,9999,0
1731501228420,CSE 293,049,796691,Weibel; Nadir,9998,0,9999,1
1731501228420,CSE 293,050,796692,Gupta; Rajesh K.,9999,0,9999,0
1731501228420,CSE 293,051,796693,Soosai Raj; Adalbert Geral,9999,0,9999,0
1731501228420,CSE 293,052,800753,Wang; Xiaolong,9999,0,9999,0
1731501229447,CSE 294,A00,740471,Snoeren; Alex C.,0,0,0,0
1731501230474,CSS 2,A01,785225,Mignozzetti; Umberto,42,0,45,3
1731501230474,CSS 2,A02,785226,Mignozzetti; Umberto,42,0,45,3
1731501231516,CSS 205,A00,738810,Ahlquist; John S.,4,0,24,20
1731501232546,CSS 209,A00,738811,Mignozzetti; Umberto,17,0,40,23
1731501233583,CSS 296,001,796149,Mignozzetti; Umberto,0,0,0,5
1731501233583,CSS 296,002,796150,Mignozzetti; Umberto,0,0,0,2
1731501233583,CSS 296,003,796157,Leas; Eric Craig,0,0,0,0
1731501233583,CSS 296,004,796158,Okonkwo; Holly,0,0,0,1
1731501233583,CSS 296,005,796159,Fleischer; Jason G,0,0,0,1
1731501233583,CSS 296,006,796162,Creel; Sarah,0,0,0,1
1731501233583,CSS 296,007,796165,Patel; Hemal,0,0,0,1
1731501233583,CSS 296,008,796168,Martin; Isaac,0,0,0,1
1731501233583,CSS 296,009,796169,Styler; William Francis,0,0,0,1
1731501233583,CSS 296,010,796171,Grigoryan; Aram,0,0,0,3
1731501233583,CSS 296,011,796172,Bonjour; Trevor,0,0,0,1
1731501233583,CSS 296,012,796173,Martin; Isaac,0,0,0,0
1731501234621,DDPM 204,A00,742646,Ma; Joseph David,30,0,35,5
1731501235652,DDPM 208,A00,742647,Ma; Joseph David,30,0,35,5
1731501236683,DDPM 213,A00,742648,Cuomo; Raphael Eduardo,30,0,35,5
1731501237713,DERM 296,001,791572,Hightower; George Kimet,9,0,10,1
1731501237713,DERM 296,002,791573,Eichenfield; Dawn Zhang,9,0,10,1
1731501237713,DERM 296,003,791575,Staff,10,0,10,0
1731501238787,DOC 2,A01,741984,Strom; Megan C.,0,0,0,0
1731501238787,DOC 2,A02,741987,Strom; Megan C.,0,0,0,0
1731501238787,DOC 2,A03,741989,Strom; Megan C.,0,0,0,0
1731501238787,DOC 2,A04,741990,Strom; Megan C.,0,0,0,0
1731501238787,DOC 2,A05,741993,Strom; Megan C.,0,0,0,0
1731501238787,DOC 2,A06,741994,Strom; Megan C.,0,0,0,0
1731501238787,DOC 2,A07,741995,Strom; Megan C.,0,0,0,0
1731501238787,DOC 2,A08,741996,Strom; Megan C.,0,0,0,0
1731501238787,DOC 2,A09,741999,Strom; Megan C.,0,0,0,0
1731501238787,DOC 2,A10,742000,Strom; Megan C.,0,0,0,0
1731501238787,DOC 2,A11,742002,Strom; Megan C.,0,0,0,0
1731501238787,DOC 2,A12,742005,Strom; Megan C.,0,0,0,0
1731501238787,DOC 2,A13,742007,Strom; Megan C.,0,0,0,0
1731501238787,DOC 2,A14,742009,Strom; Megan C.,0,0,0,0
1731501238787,DOC 2,A15,742010,Strom; Megan C.,0,0,0,0
1731501238787,DOC 2,A16,742153,Strom; Megan C.,0,0,0,0
1731501238787,DOC 2,B01,742170,Strom; Megan C.,0,0,0,0
1731501238787,DOC 2,B02,742175,Strom; Megan C.,0,0,0,0
1731501238787,DOC 2,B03,742192,Strom; Megan C.,0,0,0,0
1731501238787,DOC 2,B04,742193,Strom; Megan C.,0,0,0,0
1731501238787,DOC 2,B05,742197,Strom; Megan C.,0,0,0,0
1731501238787,DOC 2,B06,742198,Strom; Megan C.,0,0,0,0
1731501238787,DOC 2,B07,742201,Strom; Megan C.,0,0,0,0
1731501238787,DOC 2,B08,742204,Strom; Megan C.,0,0,0,0
1731501238787,DOC 2,B09,742206,Strom; Megan C.,0,0,0,0
1731501238787,DOC 2,B10,742211,Strom; Megan C.,0,0,0,0
1731501238787,DOC 2,B11,742214,Strom; Megan C.,0,0,0,0
1731501238787,DOC 2,B12,742215,Strom; Megan C.,0,0,0,0
1731501238787,DOC 2,B13,742224,Strom; Megan C.,0,0,0,0
1731501238787,DOC 2,B14,742230,Strom; Megan C.,0,0,0,0
1731501238787,DOC 2,B15,742290,Strom; Megan C.,0,0,0,0
1731501238787,DOC 2,B16,742292,Strom; Megan C.,0,0,0,0
1731501238787,DOC 2,C01,742295,Solomon; Amanda Lee Albaniel,0,0,0,0
1731501238787,DOC 2,C02,742296,Solomon; Amanda Lee Albaniel,0,0,0,0
1731501238787,DOC 2,C03,742297,Solomon; Amanda Lee Albaniel,0,0,0,0
1731501238787,DOC 2,C04,742303,Solomon; Amanda Lee Albaniel,0,0,0,0
1731501238787,DOC 2,C05,742304,Solomon; Amanda Lee Albaniel,0,0,0,0
1731501238787,DOC 2,C06,742306,Solomon; Amanda Lee Albaniel,0,0,0,0
1731501238787,DOC 2,C07,742309,Solomon; Amanda Lee Albaniel,0,0,0,0
1731501238787,DOC 2,C08,742310,Solomon; Amanda Lee Albaniel,0,0,0,0
1731501238787,DOC 2,C09,742352,Solomon; Amanda Lee Albaniel,0,0,0,0
1731501238787,DOC 2,C10,742363,Solomon; Amanda Lee Albaniel,0,0,0,0
1731501238787,DOC 2,C11,742372,Solomon; Amanda Lee Albaniel,0,0,0,0
1731501238787,DOC 2,C12,742381,Solomon; Amanda Lee Albaniel,0,0,0,0
1731501238787,DOC 2,C13,742382,Solomon; Amanda Lee Albaniel,0,0,0,0
1731501238787,DOC 2,C14,742383,Solomon; Amanda Lee Albaniel,0,0,0,0
1731501238787,DOC 2,C15,798384,Solomon; Amanda Lee Albaniel,0,0,0,0
1731501238787,DOC 2,C16,798386,Solomon; Amanda Lee Albaniel,0,0,0,0
1731501238787,DOC 2,D01,742489,Villegas; Karen Eliza,0,0,0,0
1731501238787,DOC 2,D02,742493,Villegas; Karen Eliza,0,0,0,0
1731501238787,DOC 2,D03,742551,Villegas; Karen Eliza,0,0,0,0
1731501238787,DOC 2,D04,742552,Villegas; Karen Eliza,0,0,0,0
1731501238787,DOC 2,D05,742553,Villegas; Karen Eliza,0,0,0,0
1731501238787,DOC 2,D06,742556,Villegas; Karen Eliza,0,0,0,0
1731501238787,DOC 2,D07,742559,Villegas; Karen Eliza,0,0,0,0
1731501238787,DOC 2,D08,742560,Villegas; Karen Eliza,0,0,0,0
1731501238787,DOC 2,D09,742608,Villegas; Karen Eliza,0,0,0,0
1731501238787,DOC 2,D10,742635,Villegas; Karen Eliza,0,0,0,0
1731501238787,DOC 2,D11,742636,Villegas; Karen Eliza,0,0,0,0
1731501238787,DOC 2,D12,742637,Villegas; Karen Eliza,0,0,0,0
1731501238787,DOC 2,D13,742638,Villegas; Karen Eliza,0,0,0,0
1731501238787,DOC 2,D14,742639,Villegas; Karen Eliza,0,0,0,0
1731501238787,DOC 2,D15,742640,Villegas; Karen Eliza,0,0,0,0
1731501238787,DOC 2,D16,742641,Villegas; Karen Eliza,0,0,0,0
1731501238787,DOC 2,D17,742642,Villegas; Karen Eliza,0,0,0,0
1731501239819,DOC 100D,A00,742643,Pass; Natalye,25,0,25,0
1731501239819,DOC 100D,B00,742644,Pass; Natalye,24,0,25,1
1731501240851,DSC 10,A01,741312,Tiefenbruck; Janine LoBue,136,0,145,9
1731501240851,DSC 10,B01,741322,Tiefenbruck; Janine LoBue,143,0,145,2
1731501241882,DSC 20,A01,741392,Langlois; Marina,192,0,192,0
1731501241882,DSC 20,B01,741530,Langlois; Marina,192,0,192,0
1731501242911,DSC 30,A01,741532,Liao; Soohyun Nam,70,0,70,0
1731501242911,DSC 30,B01,741538,Liao; Soohyun Nam,69,0,70,1
1731501243941,DSC 40A,A01,741544,Shannon; Kyle Michael,187,0,192,5
1731501244972,DSC 40B,A01,741549,Wang; Yusu,143,0,145,2
1731501246004,DSC 80,A01,741553,Watson-Parris; Duncan,149,0,149,0
1731501247032,DSC 95,A01,741617,Langlois; Marina,35,0,35,0
1731501248064,DSC 96,A00,741618,Quer; Giorgio,39,0,40,1
1731501249093,DSC 100,A01,741627,Salimi; Babak,141,0,145,4
1731501250123,DSC 106,A01,741636,Lau; Samuel Ethan,144,0,146,2
1731501250123,DSC 106,B01,741638,Lau; Samuel Ethan,144,0,146,2
1731501251150,DSC 140A,A01,741642,Eldridge; Justin Matthew,136,0,145,9
1731501251150,DSC 140A,B01,741646,Eldridge; Justin Matthew,143,0,145,2
1731501252178,DSC 140B,A01,741682,Huang; Biwei,137,0,145,8
1731501253208,DSC 148,A01,794521,Shang; Jingbo,122,0,125,3
1731501254238,DSC 170,A01,741684,Zaslavsky; Ilya,28,0,40,12
1731501255281,DSC 180B,A01,741686,Bellur; Umesh,8,0,8,0
1731501255281,DSC 180B,A02,741687,Bellur; Umesh,4,0,4,0
1731501255281,DSC 180B,A03,741688,Bellur; Umesh,8,0,8,0
1731501255281,DSC 180B,A04,741707,Bellur; Umesh,6,0,6,0
1731501255281,DSC 180B,A05,741708,Bellur; Umesh,6,0,6,0
1731501255281,DSC 180B,A06,741709,Bellur; Umesh,8,0,8,0
1731501255281,DSC 180B,A07,741710,Bellur; Umesh,6,0,6,0
1731501255281,DSC 180B,A08,741711,Bellur; Umesh,4,0,4,0
1731501255281,DSC 180B,A09,741712,Bellur; Umesh,10,0,10,0
1731501255281,DSC 180B,A10,741713,Bellur; Umesh,10,0,10,0
1731501255281,DSC 180B,A11,741714,Bellur; Umesh,6,0,6,0
1731501255281,DSC 180B,A12,741715,Bellur; Umesh,4,0,4,0
1731501255281,DSC 180B,A13,741716,Bellur; Umesh,6,0,6,0
1731501255281,DSC 180B,A14,741717,Bellur; Umesh,6,0,6,0
1731501255281,DSC 180B,A15,741718,Bellur; Umesh,8,0,8,0
1731501255281,DSC 180B,A16,741719,Bellur; Umesh,10,0,10,0
1731501255281,DSC 180B,A17,741720,Bellur; Umesh,4,0,4,0
1731501255281,DSC 180B,B01,741724,Bellur; Umesh,8,0,8,0
1731501255281,DSC 180B,B02,741725,Bellur; Umesh,10,0,10,0
1731501255281,DSC 180B,B03,741733,Bellur; Umesh,6,0,6,0
1731501255281,DSC 180B,B04,741734,Bellur; Umesh,6,0,6,0
1731501255281,DSC 180B,B05,741736,Bellur; Umesh,4,0,4,0
1731501255281,DSC 180B,B06,741778,Bellur; Umesh,6,0,6,0
1731501255281,DSC 180B,B07,741780,Bellur; Umesh,8,0,8,0
1731501255281,DSC 180B,B08,741782,Bellur; Umesh,6,0,6,0
1731501255281,DSC 180B,B09,741785,Bellur; Umesh,6,0,6,0
1731501255281,DSC 180B,B10,741786,Bellur; Umesh,6,0,6,0
1731501255281,DSC 180B,B11,741788,Bellur; Umesh,4,0,4,0
1731501255281,DSC 180B,B12,741789,Bellur; Umesh,10,0,10,0
1731501255281,DSC 180B,B13,741791,Bellur; Umesh,6,0,6,0
1731501255281,DSC 180B,B14,741793,Bellur; Umesh,8,0,8,0
1731501255281,DSC 180B,B15,741794,Bellur; Umesh,8,0,8,0
1731501255281,DSC 180B,B16,741797,Bellur; Umesh,8,0,8,0
1731501255281,DSC 180B,B17,741855,Bellur; Umesh,4,0,4,0
1731501255281,DSC 180B,B18,741857,Bellur; Umesh,4,0,4,0
1731501256313,DSC 190,A01,741874,Silberman; Jack,19,0,20,1
1731501256313,DSC 190,B01,741877,Smarr; Benjamin,36,0,40,4
1731501256313,DSC 190,C01,741879,Mishne; Gal,18,0,20,2
1731501257343,DSC 197,001,741880,Eldridge; Justin Matthew,9999,0,9999,0
1731501258375,DSC 202,A00,741881,Gupta; Amarnath,0,0,70,70
1731501259401,DSC 206,A00,741883,Mazumdar; Arya,16,0,100,84
1731501260428,DSC 207R,A01,741885,Staff,77,0,80,3
1731501261460,DSC 208R,A01,741887,Salimi; Babak,36,0,80,44
1731501262488,DSC 211,A00,741888,Wang; Jun-Kun,16,0,70,54
1731501263515,DSC 215R,A01,741890,Staff,77,0,80,3
1731501264541,DSC 240,A00,741892,Wang; Yuxiang,33,0,100,67
1731501265571,DSC 244,A00,741893,Schwartzman; Armin,76,0,90,14
1731501266605,DSC 250,A00,741894,Hu; Zhiting,0,0,90,90
1731501267636,DSC 255R,A01,741898,Dasgupta; Sanjoy,39,0,80,41
1731501268668,DSC 266R,A01,741900,Weibel; Nadir,39,0,60,21
1731501269694,DSC 288R,A01,741902,Bellur; Umesh,38,0,60,22
1731501270730,DSC 291,A00,741904,Smarr; Benjamin,0,0,30,30
1731501270730,DSC 291,B00,741905,Freund; Yoav,47,0,60,13
1731501270730,DSC 291,C00,741906,Belkin; Mikhail,59,0,80,21
1731501270730,DSC 291,D00,741907,Li; Aobo,31,0,40,9
1731501270730,DSC 291,E00,741908,Ma; Yian,39,0,60,21
1731501270730,DSC 291,F00,794449,Jin; Haojian,55,0,60,5
1731501270730,DSC 291,G00,797963,Mishne; Gal,0,0,20,20
1731501270730,DSC 291,H00,797964,Zhang; Hao,32,0,80,48
1731501271759,DSC 293,A00,741911,Ustun; Tevfik Berk,9990,0,9999,9
1731501272789,DSE 201,A00,741279,Deutsch; Alin Bernard,25,0,25,0
1731501273816,DSE 210,A00,741281,Staff,25,0,25,0
1731501274842,DSE 241,A00,741286,Staff,25,0,25,0
1731501275871,DSE 260A,A00,741290,Altintas De Callaf; Ilkay,25,0,25,0
1731501276899,DSGN 1,A01,737377,Meyer; Michael Wayne,47,0,50,3
1731501276899,DSGN 1,A02,737382,Meyer; Michael Wayne,35,0,50,15
1731501277935,DSGN 100,A01,736806,Rill; Bryan,24,0,25,1
1731501277935,DSGN 100,A02,736809,Rill; Bryan,24,0,25,1
1731501277935,DSGN 100,A03,736810,Rill; Bryan,23,0,25,2
1731501277935,DSGN 100,A04,736812,Rill; Bryan,18,0,25,7
1731501278963,DSGN 119,A00,736813,Vaccaro; Kristen Marie,85,0,100,15
1731501279994,DSGN 219,A00,736817,Vaccaro; Kristen Marie,14,0,15,1
1731501281029,ECE 5,A01,744925,Morris; Karcher William,22,0,26,4
1731501281029,ECE 5,A02,744926,Morris; Karcher William,23,0,26,3
1731501281029,ECE 5,A03,744927,Morris; Karcher William,26,0,26,0
1731501281029,ECE 5,A04,744929,Morris; Karcher William,26,0,26,0
1731501282058,ECE 15,A01,744931,Sahay; Rajeev,188,0,192,4
1731501283090,ECE 16,A01,744935,Khoshabeh; Ramsin,25,0,30,5
1731501284121,ECE 25,A50,744939,Morris; Karcher William,26,0,30,4
1731501284121,ECE 25,A51,744940,Morris; Karcher William,29,0,30,1
1731501284121,ECE 25,A52,744941,Morris; Karcher William,27,0,30,3
1731501284121,ECE 25,A53,744942,Morris; Karcher William,28,0,30,2
1731501284121,ECE 25,A54,744944,Morris; Karcher William,30,0,30,0
1731501285153,ECE 35,A50,744954,Schurgers; Curt,27,0,30,3
1731501285153,ECE 35,A51,744955,Schurgers; Curt,30,0,30,0
1731501285153,ECE 35,A52,745033,Schurgers; Curt,30,0,30,0
1731501285153,ECE 35,A53,745037,Schurgers; Curt,25,0,30,5
1731501285153,ECE 35,A54,745046,Schurgers; Curt,30,0,30,0
1731501285153,ECE 35,A55,745047,Schurgers; Curt,30,0,30,0
1731501286179,ECE 45,A01,745170,Heath Jr.; Robert Wendell,90,0,98,8
1731501286179,ECE 45,A02,745252,Heath Jr.; Robert Wendell,94,0,98,4
1731501287214,ECE 65,A50,745256,Baghdadchi; Saharnaz,28,0,30,2
1731501287214,ECE 65,A51,745257,Baghdadchi; Saharnaz,29,0,30,1
1731501287214,ECE 65,A52,745258,Baghdadchi; Saharnaz,26,0,30,4
1731501287214,ECE 65,A53,745259,Baghdadchi; Saharnaz,29,0,30,1
1731501287214,ECE 65,A54,745260,Baghdadchi; Saharnaz,29,0,30,1
1731501287214,ECE 65,A55,745261,Baghdadchi; Saharnaz,29,0,30,1
1731501288240,ECE 101,A01,745263,Gonzalez Prelcic; Nuria,83,0,90,7
1731501288240,ECE 101,A02,745264,Gonzalez Prelcic; Nuria,88,0,90,2
1731501289270,ECE 102,A00,745265,Le; Hanh-Phuc,91,0,100,9
1731501290301,ECE 103,A01,745273,Lo; Yu-Hwa,51,0,60,9
1731501291332,ECE 107,A01,745309,Fullerton; Eric E,93,0,100,7
1731501292362,ECE 109,A01,745315,Poveda Fonseca; Jorge,169,0,180,11
1731501293396,ECE 111,A01,745319,Eldon; John,202,0,220,18
1731501294428,ECE 115,A01,745321,Yip; Michael,22,0,28,6
1731501295457,ECE 121B,A50,745324,Esmaili; Gholamreza,11,0,12,1
1731501295457,ECE 121B,A51,745326,Esmaili; Gholamreza,12,0,12,0
1731501295457,ECE 121B,A52,745327,Esmaili; Gholamreza,9,0,12,3
1731501295457,ECE 121B,A53,745328,Esmaili; Gholamreza,12,0,12,0
1731501296483,ECE 125A,A50,745332,Le; Hanh-Phuc,9,0,12,3
1731501296483,ECE 125A,A51,745333,Le; Hanh-Phuc,11,0,12,1
1731501296483,ECE 125A,A52,745334,Le; Hanh-Phuc,9,0,12,3
1731501296483,ECE 125A,A53,745336,Le; Hanh-Phuc,11,0,12,1
1731501297511,ECE 128B,A00,745337,Esmaili; Gholamreza,70,0,75,5
1731501298546,ECE 135B,A00,745339,Dayeh; Shadi Ahmad,19,0,25,6
1731501299575,ECE 140A,A01,745345,Khoshabeh; Ramsin,0,0,0,0
1731501299575,ECE 140A,A02,745346,Khoshabeh; Ramsin,0,0,0,0
1731501299575,ECE 140A,A03,745347,Khoshabeh; Ramsin,0,0,0,0
1731501299575,ECE 140A,A04,745348,Khoshabeh; Ramsin,0,0,0,0
1731501300610,ECE 141A,A01,745351,Gessner; Richard K.,64,0,75,11
1731501301638,ECE 143,A00,745352,Unpingco; Jose H.,0,0,0,3
1731501302670,ECE 148,A01,745355,Silberman; Jack,22,0,24,2
1731501303704,ECE 158B,A01,745357,Zhang; Xinyu,19,0,25,6
1731501304739,ECE 161B,A00,745361,Nguyen; Truong Quang,62,0,65,3
1731501305775,ECE 172A,A01,745372,Parhi; Rahul,115,0,120,5
1731501306810,ECE 175A,A01,745378,Vasconcelos; Nuno,82,0,90,8
1731501307839,ECE 176,A00,745379,Wang; Xiaolong,158,0,196,38
1731501308866,ECE 181,A01,745381,Antipa; Nicholas A,18,0,25,7
1731501309894,ECE 184,A00,745382,Fainman; Yeshaiahu,10,0,15,5
1731501310926,ECE 191,A00,745387,Zhang; Xinyu,39,0,40,1
1731501311958,ECE 197,001,745394,Mercier; Patrick Philip,9999,0,9999,0
1731501312986,ECE 198,001,745395,Nguyen; Truong Quang,9999,0,9999,0
1731501312986,ECE 198,002,800722,Fullerton; Eric E,9999,0,9999,0
1731501314013,ECE 212BN,A00,745419,Ng; Tse Nga,0,0,0,0
1731501315044,ECE 222B,A00,745501,Lomakin; Vitaliy,0,0,0,0
1731501316075,ECE 226,A00,745504,Koushanfar; Farinaz,0,0,0,0
1731501317103,ECE 230B,A00,745505,Taur; Yuan,0,0,0,0
1731501318132,ECE 238A,A00,745507,Luo; Jian,0,0,0,0
1731501319163,ECE 240B,A00,745510,Rubin; Noah,0,0,0,0
1731501320196,ECE 247B,A00,745512,Wang; Joseph,0,0,0,0
1731501321227,ECE 250,A00,745515,Siegel; Paul H.,0,0,0,0
1731501322257,ECE 251A,A00,745518,Meyer; Florian,0,0,0,0
1731501323285,ECE 257B,A00,745519,Bharadia; Dinesh,0,0,0,0
1731501324314,ECE 258A,A00,745524,Milstein; Laurence B.,0,0,0,0
1731501325401,ECE 260B,A00,745525,Kang; Mingu,0,0,0,0
1731501326429,ECE 264A,A00,745526,Galton; Ian A,0,0,0,0
1731501327465,ECE 265A,A00,745530,Gudem; Prasad S.S.,0,0,0,0
1731501328494,ECE 265D,A00,745531,Gudem; Prasad S.S.,0,0,0,0
1731501329522,ECE 269,A01,745540,Pal; Piya,0,0,0,0
1731501330550,ECE 271B,A00,745541,Vasconcelos; Manuela,0,0,0,0
1731501331577,ECE 276A,A00,745543,Atanasov; Nikolay A.,0,0,0,0
1731501332605,ECE 277,A00,745544,An; Cheolhong,0,0,0,0
1731501333634,ECE 283,A00,745547,Hsueh; Tzu-Chien,0,0,0,0
1731501334680,ECE 285,A00,745548,Zheng; Yang,0,0,0,0
1731501335706,ECE 286,B00,795641,Poveda Fonseca; Jorge,0,0,0,0
1731501336743,ECON 1,A01,742650,Crane; Meredith Helen,143,0,150,7
1731501336743,ECON 1,B01,742652,Crane; Meredith Helen,149,0,150,1
1731501336743,ECON 1,C01,742655,Newhouse; Herbert S,71,0,75,4
1731501336743,ECON 1,C02,742656,Newhouse; Herbert S,75,0,75,0
1731501337774,ECON 2,A01,742660,Crane; Meredith Helen,78,0,78,0
1731501337774,ECON 2,A02,742661,Crane; Meredith Helen,80,0,80,0
1731501338811,ECON 3,A01,742663,Rondina; Giacomo,113,0,125,12
1731501338811,ECON 3,A02,742664,Rondina; Giacomo,125,0,125,0
1731501338811,ECON 3,B01,742667,Rondina; Giacomo,121,0,125,4
1731501338811,ECON 3,B02,742669,Rondina; Giacomo,125,0,125,0
1731501339843,ECON 4,A01,742672,Levkoff; Steven B.,73,0,75,2
1731501339843,ECON 4,A02,742673,Levkoff; Steven B.,71,0,75,4
1731501339843,ECON 4,A03,742674,Levkoff; Steven B.,73,0,75,2
1731501339843,ECON 4,B01,798340,Brooks; Marcus Raymond,2,0,3,1
1731501340875,ECON 5,A01,742676,Dai; Yinlin,51,0,54,3
1731501340875,ECON 5,A02,742677,Dai; Yinlin,53,0,54,1
1731501340875,ECON 5,A03,742678,Dai; Yinlin,51,0,54,3
1731501340875,ECON 5,A04,742679,Dai; Yinlin,54,0,54,0
1731501340875,ECON 5,A05,742680,Dai; Yinlin,54,0,54,0
1731501340875,ECON 5,B01,742682,Dai; Yinlin,53,0,54,1
1731501340875,ECON 5,B02,742684,Dai; Yinlin,52,0,54,2
1731501340875,ECON 5,B03,742686,Dai; Yinlin,53,0,54,1
1731501340875,ECON 5,B04,742687,Dai; Yinlin,50,0,54,4
1731501340875,ECON 5,B05,742723,Dai; Yinlin,51,0,54,3
1731501341906,ECON 86,A00,795622,Muendler; Marc,98,0,100,2
1731501342934,ECON 100A,A01,742728,Grigoryan; Aram,98,0,100,2
1731501342934,ECON 100A,A02,742730,Grigoryan; Aram,94,0,100,6
1731501342934,ECON 100A,A03,742733,Grigoryan; Aram,93,0,100,7
1731501342934,ECON 100A,A04,742735,Grigoryan; Aram,97,0,100,3
1731501343968,ECON 100B,A01,742738,Levkoff; Steven B.,90,0,96,6
1731501343968,ECON 100B,A02,742742,Levkoff; Steven B.,102,0,104,2
1731501343968,ECON 100B,A03,742744,Levkoff; Steven B.,99,0,100,1
1731501343968,ECON 100B,A04,742745,Levkoff; Steven B.,98,0,100,2
1731501344996,ECON 100C,A01,742757,Newhouse; Herbert S,100,0,100,0
1731501344996,ECON 100C,B01,742768,Newhouse; Herbert S,92,0,100,8
1731501346023,ECON 102,A01,742785,Muendler; Marc,110,0,120,10
1731501347051,ECON 105,A00,742834,Vespa; Emanuel Ignacio,97,0,100,3
1731501348080,ECON 109,A01,742838,Watson; Joel Christopher,107,0,120,13
1731501348080,ECON 109,A02,742841,Watson; Joel Christopher,118,0,120,2
1731501348080,ECON 109,A03,742843,Watson; Joel Christopher,0,0,0,0
1731501349110,ECON 109T,A00,742844,Watson; Joel Christopher,18,0,20,2
1731501350144,ECON 110A,A01,742847,Jaimovich; Nir,95,0,100,5
1731501350144,ECON 110A,B01,742852,Jaimovich; Nir,99,0,100,1
1731501351178,ECON 110B,A01,742854,Hamilton; James D.,93,0,98,5
1731501351178,ECON 110B,A02,742858,Hamilton; James D.,98,0,98,0
1731501351178,ECON 110B,B01,742861,Hamilton; James D.,90,0,98,8
1731501351178,ECON 110B,B02,742863,Hamilton; James D.,98,0,98,0
1731501352209,ECON 110BH,A00,742865,Hamilton; James D.,20,0,20,0
1731501353238,ECON 116,A00,742866,Lowes; Sara Rachel,69,0,70,1
1731501353238,ECON 116,B00,742868,Lowes; Sara Rachel,43,0,44,1
1731501354273,ECON 120A,A01,742871,Idoux; Clemence Marie,97,0,100,3
1731501354273,ECON 120A,B01,742873,Candido; Maria Teresa,91,0,95,4
1731501354273,ECON 120A,B02,742877,Candido; Maria Teresa,88,0,90,2
1731501354273,ECON 120A,C01,742879,Candido; Maria Teresa,109,0,115,6
1731501355303,ECON 120B,A01,742884,Berman; Eli,26,0,30,4
1731501355303,ECON 120B,B01,742889,Dahl; Gordon B.,18,0,30,12
1731501355303,ECON 120B,C01,742892,Dahl; Gordon B.,109,0,120,11
1731501355303,ECON 120B,C02,742893,Dahl; Gordon B.,116,0,120,4
1731501356329,ECON 120BH,A00,742895,Dahl; Gordon B.,20,0,20,0
1731501357362,ECON 120C,A01,742902,Candido; Maria Teresa,66,0,70,4
1731501357362,ECON 120C,A02,742905,Candido; Maria Teresa,69,0,70,1
1731501358395,ECON 138,A00,742908,Bharadwaj; Prashant,188,0,200,12
1731501359428,ECON 145,A00,742909,Squires; Dale E,144,0,150,6
1731501360456,ECON 149,A00,742910,Grigoryan; Aram,98,0,100,2
1731501361493,ECON 175,A00,742911,Wu; Pak Yeung,44,0,50,6
1731501361493,ECON 175,B00,742912,Wu; Pak Yeung,42,0,44,2
1731501362527,ECON 178,A01,742915,Zhu; Ying,48,0,60,12
1731501363555,ECON 181,A00,742916,Staff,99,0,100,1
1731501364582,ECON 185,A01,742919,Bharadwaj; Prashant,13,0,18,5
1731501365611,ECON 186,A00,742966,Ross; Stephen Geoffrey,93,0,100,7
1731501366639,ECON 190,A00,742967,Vespa; Emanuel Ignacio,47,0,50,3
1731501366639,ECON 190,B00,742968,Vespa; Emanuel Ignacio,50,0,50,0
1731501367665,ECON 200B,A00,742971,Watson; Joel Christopher,33,0,35,2
1731501368696,ECON 208,A00,742972,Vespa; Emanuel Ignacio & Watson; Joel Christopher,17,0,20,3
1731501369725,ECON 210B,A00,742979,Rondina; Giacomo,34,0,35,1
1731501370758,ECON 220B,A00,743008,Ma; Xinwei,32,0,35,3
1731501371787,ECON 220E,A00,743012,Ma; Xinwei,24,0,30,6
1731501372834,ECON 231,A00,743013,Cullen; Julie,8,0,12,4
1731501373861,ECON 237,A00,743015,Lowes; Sara Rachel & Bazzi; Samuel A,16,0,20,4
1731501374888,ECON 250B,A00,743043,Dahl; Gordon B.,24,0,25,1
1731501375919,ECON 267,A00,743122,Graff Zivin; Joshua,21,0,25,4
1731501376950,ECON 284,A00,743123,Niehaus; Paul,21,0,25,4
1731501378222,ECON 286,A00,743124,Wu; Pak Yeung,19,0,20,1
1731501379251,EDS 23,A01,743187,Staff,0,0,0,0
1731501379251,EDS 23,B01,743239,Staff,0,0,0,0
1731501380279,EDS 39,A01,743242,Heinzman; Erica M.,24,0,25,1
1731501381311,EDS 103,A01,743244,Halter; Christopher P.,33,0,35,2
1731501382336,EDS 111,A00,743245,Staff,58,0,60,2
1731501383364,EDS 112,A01,743247,Chapman; Thandeka K,22,0,30,8
1731501383364,EDS 112,A02,743248,Chapman; Thandeka K,30,0,30,0
1731501384392,EDS 114,A01,743280,Eguchi; Emi,17,0,18,1
1731501384392,EDS 114,A02,743307,Eguchi; Emi,17,0,17,0
1731501385421,EDS 115,A00,743316,Mamas; Christoforos,52,0,60,8
1731501386451,EDS 117,A01,743398,Jones; Gabrielle Anastasia,20,0,23,3
1731501386451,EDS 117,A02,743402,Jones; Gabrielle Anastasia,23,0,23,0
1731501386451,EDS 117,A03,743403,Jones; Gabrielle Anastasia,22,0,22,0
1731501386451,EDS 117,A04,743404,Jones; Gabrielle Anastasia,22,0,22,0
1731501386451,EDS 117,B01,743428,Aragon; Maria Jose,23,0,25,2
1731501386451,EDS 117,B02,743429,Aragon; Maria Jose,25,0,25,0
1731501387486,EDS 122,A00,743489,Brydges; Stacey,10,0,10,0
1731501388518,EDS 124AR,A00,743510,Simon; Elizabeth A,86,0,100,14
1731501388518,EDS 124AR,B00,743511,Simon; Elizabeth A,195,0,200,5
1731501388518,EDS 124AR,C00,794870,Simon; Elizabeth A,40,0,40,0
1731501389549,EDS 124BR,A00,743513,Eguchi; Emi,65,0,75,10
1731501389549,EDS 124BR,B00,795833,Eguchi; Emi,25,0,25,0
1731501390577,EDS 125,A00,743515,Jones; Gabrielle Anastasia,49,0,60,11
1731501391606,EDS 126,A01,743522,Jones; Makeba,30,0,33,3
1731501391606,EDS 126,A02,743617,Jones; Makeba,33,0,33,0
1731501391606,EDS 126,A03,743688,Jones; Makeba,34,0,34,0
1731501392638,EDS 128A,A01,743693,Fargason; Sharon Gayle,11,0,15,4
1731501392638,EDS 128A,A02,743694,Fargason; Sharon Gayle,14,0,15,1
1731501392638,EDS 128A,A03,743695,Fargason; Sharon Gayle,18,0,20,2
1731501393670,EDS 129B,A01,743702,Black; Alison Michelle,42,0,45,3
1731501394700,EDS 130,A01,743709,Choi; Bailey Miyeon,17,0,20,3
1731501394700,EDS 130,A02,743710,Choi; Bailey Miyeon,20,0,20,0
1731501394700,EDS 130,A03,743711,Choi; Bailey Miyeon,19,0,20,1
1731501395726,EDS 131,A01,743718,Cohen; Shana R,20,0,20,0
1731501395726,EDS 131,A02,743722,Cohen; Shana R,20,0,20,0
1731501396751,EDS 133,A01,743741,Bintliff; Amy S.V.,23,0,25,2
1731501396751,EDS 133,A02,743748,Bintliff; Amy S.V.,20,0,20,0
1731501397781,EDS 139,A00,743749,Fargason; Sharon Gayle,43,0,50,7
1731501397781,EDS 139,B00,743825,Black; Alison Michelle,41,0,45,4
1731501397781,EDS 139,C00,743847,Choi; Bailey Miyeon,56,0,60,4
1731501397781,EDS 139,D00,743848,Cohen; Shana R,40,0,40,0
1731501397781,EDS 139,E00,743849,Bintliff; Amy S.V.,43,0,45,2
1731501397781,EDS 139,F00,743851,Bintliff; Amy S.V.,19,0,20,1
1731501397781,EDS 139,G00,743853,Hemans; Patricia Ann Benitez,31,0,35,4
1731501397781,EDS 139,H00,743854,Hemans; Patricia Ann Benitez,20,0,20,0
1731501398811,EDS 140,A00,743898,Hemans; Patricia Ann Benitez,30,0,35,5
1731501399845,EDS 146,A01,743953,Hemans; Patricia Ann Benitez,24,0,25,1
1731501399845,EDS 146,A02,794684,Hemans; Patricia Ann Benitez,0,0,0,0
1731501400878,EDS 149,A00,799976,Millstone; Rachel Diana,20,0,20,0
1731501400878,EDS 149,B00,799977,Heinzman; Erica M.,20,0,20,0
1731501401908,EDS 162,A01,797962,Phuong; Andrew,19,0,20,1
1731501402936,EDS 205A,A00,743983,Halter; Christopher P.,33,0,40,7
1731501403967,EDS 205B,A00,744003,Halter; Christopher P.,32,0,45,13
1731501404996,EDS 232,A00,744009,Clarke; Sherice Nicole,14,0,15,1
1731501406024,EDS 256,A00,744012,Mamas; Christoforos,15,0,15,0
1731501407051,EDS 259A,A00,744013,Aragon; Maria Jose,14,0,15,1
1731501408078,EDS 259B,A00,744014,Aragon; Maria Jose,14,0,15,1
1731501409107,EDS 264,A00,744016,Clarke; Sherice Nicole,14,0,15,1
1731501410135,EDS 280,A00,744017,Datnow; Amanda Lee,11,0,18,7
1731501411163,EDS 287A,A00,744018,Daly; Alan J.,9,0,15,6
1731501412193,EDS 287C,A00,744019,Daly; Alan J.,15,0,15,0
1731501413220,EDS 288B,A00,744020,Fine; Sarah,15,0,15,0
1731501414246,EDS 289A,A01,744022,Hofstetter; Carolyn,15,0,15,0
1731501415272,EDS 291A,A01,744024,Daly; Alan J.,9,0,15,6
1731501416304,EDS 293A,A01,744026,Burrell; Sade Renee,15,0,15,0
1731501417329,EDS 294A,A00,744027,Meyerott; Theresa Ann,15,0,15,0
1731501418368,EDS 296,001,773835,Aragon; Maria Jose,10,0,10,0
1731501418368,EDS 296,002,773846,Bintliff; Amy S.V.,10,0,10,0
1731501418368,EDS 296,003,773906,Clarke; Sherice Nicole,10,0,10,0
1731501418368,EDS 296,004,773907,Chapman; Thandeka K,10,0,10,0
1731501418368,EDS 296,005,773910,Cohen; Shana R,10,0,10,0
1731501418368,EDS 296,006,773911,Datnow; Amanda Lee,10,0,10,0
1731501418368,EDS 296,007,773913,Halter; Christopher P.,10,0,10,0
1731501418368,EDS 296,008,773916,Hopkins; Megan Beth,9,0,10,1
1731501418368,EDS 296,009,773922,Jones; Makeba,10,0,10,0
1731501418368,EDS 296,010,773923,Jones; Gabrielle Anastasia,10,0,10,0
1731501418368,EDS 296,011,773924,Daly; Alan J.,10,0,10,0
1731501418368,EDS 296,012,773925,Simon; Elizabeth A,10,0,10,0
1731501418368,EDS 296,013,773933,Eguchi; Emi,10,0,10,0
1731501418368,EDS 296,014,773977,Hofstetter; Carolyn,10,0,10,0
1731501418368,EDS 296,015,800629,Wishard Guerra; Alison G.,10,0,10,0
1731501418368,EDS 296,016,800644,Mamas; Christoforos,10,0,10,0
1731501418368,EDS 296,017,800654,Fine; Sarah,10,0,10,0
1731501418368,EDS 296,018,800656,Pollock; Mica,10,0,10,0
1731501418368,EDS 296,019,800657,Cohen; Shana R,10,0,10,0
1731501419395,EMED 296,001,791584,Staff,10,0,10,0
1731501419395,EMED 296,002,791585,Staff,10,0,10,0
1731501419395,EMED 296,003,791586,Staff,10,0,10,0
1731501420423,ENG 10,A00,741913,Evdokimenko; Ekaterina,59,0,60,1
1731501421454,ENG 100D,A00,741921,Ngo; Anh-Thu T.,36,0,40,4
1731501421454,ENG 100D,B00,794892,Ngo; Anh-Thu T.,38,0,40,2
1731501422494,ENG 100L,A00,741969,Kleissl; Jan,6,0,6,0
1731501422494,ENG 100L,B00,741970,Bratton; Maryann,6,0,6,0
1731501422494,ENG 100L,C00,741972,Yu; Paul K L,8,0,8,0
1731501422494,ENG 100L,D00,741973,Bratton; Maryann,6,0,6,0
1731501422494,ENG 100L,E00,741974,de Oliveira; Mauricio,6,0,6,0
1731501422494,ENG 100L,F00,741975,Bratton; Maryann,6,0,6,0
1731501422494,ENG 100L,G00,741976,Boyle; Mary E. T.,19,0,20,1
1731501422494,ENG 100L,H00,795155,Boyle; Mary E. T.,14,0,15,1
1731501423528,ENVR 102,A00,744170,Staff,25,0,25,0
1731501423528,ENVR 102,C00,744214,Staff,24,0,25,1
1731501424558,ENVR 120,A00,744215,Uyeda; Kellie Ann,13,0,16,3
1731501425587,ENVR 141,A00,744320,Siapno; Jacqueline A,10,0,10,0
1731501425587,ENVR 141,B00,744328,Siapno; Jacqueline A,15,0,15,0
1731501426621,ENVR 144,A01,744490,Herbst; Matthew,10,0,10,0
1731501428674,ERC 20,A00,744169,Evans; Ivan T,39,0,40,1
1731501429703,ESYS 10,A01,799973,Staff,35,0,35,0
1731501429703,ESYS 10,A02,799974,Staff,35,0,35,0
1731501430733,ESYS 102,A01,744506,Haase; Jennifer Susan,29,0,30,1
1731501430733,ESYS 102,A02,744507,Haase; Jennifer Susan,28,0,30,2
1731501430733,ESYS 102,A03,744520,Haase; Jennifer Susan,27,0,30,3
1731501430733,ESYS 102,A04,744534,Haase; Jennifer Susan,29,0,30,1
1731501431761,ESYS 187B,A01,744536,Hetherington; Elizabeth Dorsey,42,0,45,3
1731501431761,ESYS 187B,B01,794869,Hetherington; Elizabeth Dorsey,41,0,45,4
1731501432848,ETHN 2R,A01,744558,Perreira; Christopher Michael,21,0,25,4
1731501432848,ETHN 2R,A02,744559,Perreira; Christopher Michael,24,0,25,1
1731501432848,ETHN 2R,A03,744560,Perreira; Christopher Michael,22,0,25,3
1731501432848,ETHN 2R,A04,744561,Perreira; Christopher Michael,25,0,25,0
1731501432848,ETHN 2R,A05,744562,Perreira; Christopher Michael,25,0,25,0
1731501432848,ETHN 2R,A06,744563,Perreira; Christopher Michael,24,0,25,1
1731501432848,ETHN 2R,A07,744639,Perreira; Christopher Michael,24,0,25,1
1731501432848,ETHN 2R,A08,744644,Perreira; Christopher Michael,21,0,25,4
1731501432848,ETHN 2R,A09,744646,Perreira; Christopher Michael,24,0,25,1
1731501432848,ETHN 2R,A10,744651,Perreira; Christopher Michael,25,0,25,0
1731501432848,ETHN 2R,A11,744657,Perreira; Christopher Michael,25,0,25,0
1731501432848,ETHN 2R,A12,744664,Perreira; Christopher Michael,25,0,25,0
1731501432848,ETHN 2R,A13,744665,Perreira; Christopher Michael,24,0,25,1
1731501432848,ETHN 2R,A14,744673,Perreira; Christopher Michael,24,0,25,1
1731501432848,ETHN 2R,A15,744749,Perreira; Christopher Michael,24,0,25,1
1731501432848,ETHN 2R,A16,744751,Perreira; Christopher Michael,23,0,25,2
1731501433880,ETHN 100B,A00,744761,Streeby; Shelley,29,0,32,3
1731501434913,ETHN 100H,A00,744765,Frank; Ross H.,0,0,0,0
1731501435945,ETHN 101TV,A01,744838,Marez; Curtis F.,21,0,23,2
1731501435945,ETHN 101TV,A02,744842,Marez; Curtis F.,23,0,23,0
1731501435945,ETHN 101TV,A03,796142,Marez; Curtis F.,23,0,23,0
1731501435945,ETHN 101TV,A04,796143,Marez; Curtis F.,22,0,23,1
1731501436976,ETHN 102,A00,744846,Okonkwo; Holly,38,0,40,2
1731501438005,ETHN 112B,A00,744847,Klann; Mary Cameron,22,0,30,8
1731501439031,ETHN 119,A00,744849,Fuste; Jose Ignacio,31,0,35,4
1731501440058,ETHN 122,A00,744853,Tran; Ly Thi Hai,32,0,35,3
1731501441084,ETHN 125R,A00,744875,Sasaki; Christen T,31,0,50,19
1731501442112,ETHN 133,A00,744880,Power; Jade Yukana,3,0,5,2
1731501443139,ETHN 134,A00,744905,Gosin; Monika N.,19,0,20,1
1731501444167,ETHN 137,A00,744906,Martin Sandino; Amanda Maria Yoland,19,0,20,1
1731501445194,ETHN 138,A00,744907,Gosin; Monika N.,35,0,35,0
1731501446223,ETHN 139,A00,744908,Ruiz; Ariana,20,0,20,0
1731501447251,ETHN 143,A00,744909,Marez; Curtis F.,29,0,30,1
1731501448280,ETHN 163F,A00,744911,Burelle; Julie Sara Veronique,15,0,15,0
1731501449309,ETHN 165,A00,744912,Browne; Errol Tsekani,11,0,15,4
1731501450335,ETHN 167A,A00,744913,Patel; Shaista,11,0,12,1
1731501451363,ETHN 174,A00,744915,Childs; Dennis R.,20,0,20,0
1731501452397,ETHN 179,A00,744916,Dresser; Mark Stuart,24,0,25,1
1731501453430,ETHN 187,A00,744917,Cuong; Marisol,15,0,15,0
1731501454459,ETHN 200B,A00,744918,Patel; Shaista,11,0,15,4
1731501455491,ETHN 230,A00,744919,Perreira; Christopher Michael,10,0,15,5
1731501456521,ETHN 268,A00,744920,Fuste; Jose Ignacio,4,0,10,6
1731501457548,ETIM 289,A00,744923,Sasaki; Christen T,11,0,15,4
1731501458579,EXPR 100,A00,794937,Staff,9999,0,9999,0
1731501459608,EXPR 105,A00,794941,Staff,9999,0,9999,0
1731501460635,EXPR 201,A00,794944,Staff,9999,0,9999,0
1731501461663,EXPR 205,A00,794948,Staff,9999,0,9999,0
1731501462699,FILM 87,A00,745666,Rahimi; Babak,20,0,20,0
1731501462699,FILM 87,B00,745671,Rahimi; Babak,19,0,20,1
1731501462699,FILM 87,C00,745673,Adler; Steven,20,0,20,0
1731501463729,FMPH 277,A00,745558,Gilmer; Todd,9,0,15,6
1731501464757,FMPH 291,A00,745561,Silverstein; Donna K & Wynn; Adriane Michelle,9,0,15,6
1731501465791,FPM 278,A00,745585,Strong; David R,10,0,15,5
1731501466823,FPM 286,A00,791598,Johnson; Michelle Lee,120,0,120,0
1731501467854,FPM 288,A00,799968,Hurst; Samantha,4,0,5,1
1731501468880,FPM 296,001,791599,Allison; Matthew,8,0,10,2
1731501468880,FPM 296,002,791600,Staff,10,0,10,0
1731501468880,FPM 296,003,791601,Staff,10,0,10,0
1731501469909,FPM 297,001,745665,Strong; David R,99,0,99,0
1731501470938,GLBH 20,A00,745680,Walkover; Lillian B,146,0,146,0
1731501471966,GLBH 100,A00,745702,Staff,40,0,40,0
1731501471966,GLBH 100,B00,745703,Schonberg; Jeffrey,40,0,40,0
1731501472995,GLBH 109,A00,745704,Olivas Hernandez; Olga Lid,47,0,48,1
1731501474027,GLBH 111,A01,745712,Burgos; Jose L.,0,0,0,0
1731501474027,GLBH 111,B01,745771,Burgos; Jose L.,0,0,0,0
1731501475059,GLBH 113,A00,745821,Wilson; Brenda K,63,0,70,7
1731501476091,GLBH 139,A00,745834,Csordas; Thomas J.,19,0,20,1
1731501477121,GLBH 141,A00,745835,Sanghvi; Reema I,6,0,11,5
1731501478149,GLBH 146,A00,745836,Kang; Byung Chu,68,0,70,2
1731501479180,GLBH 148,A00,745837,Schonberg; Jeffrey,90,0,100,10
1731501480210,GLBH 150,A00,745838,Sloane; Julia Kathryn,35,0,35,0
1731501481236,GLBH 150A,A00,745839,Kaiser; Bronwyn Nicole,0,0,0,0
1731501482270,GLBH 160,A00,745840,Mackey; Timothy Ken,61,0,68,7
1731501483297,GLBH 171R,A00,745841,Jenkins; Janis A.,17,0,25,8
1731501483297,GLBH 171R,B00,795776,Jenkins; Janis A.,15,0,15,0
1731501484323,GLBH 181,A00,745842,Burgos; Jose L.,213,0,216,3
1731501485351,GLBH 214,A00,745843,Bhavsar; Radhika,4,0,19,15
1731501486454,GLBH 241,A00,745877,Sanghvi; Reema I,7,0,21,14
1731501487486,GLBH 249,A00,745948,Villarino; Margarita,5,0,20,15
1731501488523,GPEC 244,A00,765594,Levy; Morgan,20,0,20,0
1731501489550,GSS 22,A00,746032,Kokinis; Troy Andreas,26,0,30,4
1731501490575,GSS 27,A00,746039,Siapno; Jacqueline A,27,0,30,3
1731501491606,HDS 60,A01,747848,Warstadt; Melissa Fawn,34,0,35,1
1731501491606,HDS 60,A02,747849,Warstadt; Melissa Fawn,34,0,35,1
1731501492633,HDS 95,A00,747852,Staff,31,0,35,4
1731501493662,HDS 110,A00,747853,Wilder; Linnea Lorene,93,0,100,7
1731501494693,HDS 133,A00,747854,Stewart; Alexander B,86,0,100,14
1731501495725,HDS 150,A00,747856,Warstadt; Melissa Fawn,20,0,20,0
1731501496753,HDS 175,A00,747859,Bjorklund; Peter,35,0,35,0
1731501497783,HDS 181,A01,747863,Delgado; Tania,30,0,30,0
1731501498811,HDS 191,A01,747865,Reese; Clarissa Jane,20,0,20,0
1731501498811,HDS 191,B01,747867,Reese; Clarissa Jane,20,0,20,0
1731501499840,HIAF 113,A00,747574,Prestholdt; Jeremy,74,0,75,1
1731501500869,HIAF 114,A00,747576,Gyamfi; Bright,55,0,56,1
1731501501901,HIEA 140R,A00,747577,Gerth; Karl G.,23,0,30,7
1731501502929,HIEA 150,A00,747578,Henry; Todd A.,54,0,56,2
1731501503960,HIEU 103,A00,747579,Watts; Edward J.,108,0,115,7
1731501504992,HIEU 116B,A00,795104,Gallant; Thomas W.,50,0,50,0
1731501506022,HIEU 123,A00,747580,Demetriou; Denise,47,0,50,3
1731501507050,HIEU 147,A00,747616,Biess; Frank Peter,96,0,100,4
1731501508083,HIEU 149,A00,747617,Devereux; Andrew W,49,0,50,1
1731501509111,HIGR 203,A00,747836,Edington; Claire Ellen,4,0,5,1
1731501510139,HIGR 215B,A00,747837,Muscolino; Micah S,10,0,10,0
1731501511172,HIGR 217B,A00,747838,Schneewind; Sarah,15,0,15,0
1731501512201,HIGR 240,A00,747842,McKenzie; Kerry V.,4,0,5,1
1731501513228,HIGR 241,A00,747843,Lampland; Martha,5,0,5,0
1731501514259,HILA 100,A00,747621,Murillo; Dana V.,50,0,50,0
1731501515288,HILA 102,A00,747623,Cowan; Benjamin A,55,0,56,1
1731501516313,HILA 121B,A00,747633,Cowan; Benjamin A,56,0,56,0
1731501517345,HILA 167,A00,794866,Murillo; Dana V.,0,0,0,0
1731501518373,HILA 267,A00,794867,Murillo; Dana V.,12,0,15,3
1731501519412,HILD 2B,A01,746966,Plant; Rebecca Jo,27,0,32,5
1731501519412,HILD 2B,A02,746988,Plant; Rebecca Jo,30,0,32,2
1731501519412,HILD 2B,A03,747023,Plant; Rebecca Jo,32,0,32,0
1731501519412,HILD 2B,A04,747029,Plant; Rebecca Jo,32,0,32,0
1731501519412,HILD 2B,A05,747030,Plant; Rebecca Jo,31,0,32,1
1731501519412,HILD 2B,A06,747031,Plant; Rebecca Jo,32,0,32,0
1731501520441,HILD 7A,A01,747252,Graham; Jessica Lynn,30,0,32,2
1731501520441,HILD 7A,A02,747337,Graham; Jessica Lynn,30,0,32,2
1731501520441,HILD 7A,A03,747338,Graham; Jessica Lynn,32,0,32,0
1731501520441,HILD 7A,A04,747352,Graham; Jessica Lynn,30,0,32,2
1731501520441,HILD 7A,A05,747375,Graham; Jessica Lynn,30,0,32,2
1731501520441,HILD 7A,A06,747385,Graham; Jessica Lynn,29,0,32,3
1731501520441,HILD 7A,A07,747442,Graham; Jessica Lynn,32,0,32,0
1731501520441,HILD 7A,A08,747444,Graham; Jessica Lynn,32,0,32,0
1731501520441,HILD 7A,A09,747447,Graham; Jessica Lynn,32,0,32,0
1731501520441,HILD 7A,A10,747449,Graham; Jessica Lynn,32,0,32,0
1731501520441,HILD 7A,A11,747450,Graham; Jessica Lynn,32,0,32,0
1731501520441,HILD 7A,A12,747487,Graham; Jessica Lynn,32,0,32,0
1731501521476,HILD 11,A01,747512,Lu; Weijing,30,0,32,2
1731501521476,HILD 11,A02,747513,Lu; Weijing,32,0,32,0
1731501521476,HILD 11,A03,747538,Lu; Weijing,32,0,32,0
1731501521476,HILD 11,A04,747546,Lu; Weijing,32,0,32,0
1731501521476,HILD 11,A05,747558,Lu; Weijing,32,0,32,0
1731501521476,HILD 11,A06,747559,Lu; Weijing,32,0,32,0
1731501522508,HILD 41,A01,747562,Devereux; Andrew W,32,0,32,0
1731501522508,HILD 41,A02,747563,Devereux; Andrew W,32,0,32,0
1731501523541,HINE 109,A00,799584,Staff,0,0,0,0
1731501524571,HINE 118,A00,799585,Staff,0,0,0,0
1731501525606,HINE 125,A00,747822,Balberg; Mira,48,0,50,2
1731501526634,HINE 186,A00,794522,Hertz; Deborah & Kayali; Hasan,15,0,15,0
1731501527661,HISA 144,A00,794454,De; Aniket,48,0,50,2
1731501528689,HISC 109,A00,747823,Edington; Claire Ellen,44,0,50,6
1731501529720,HISC 115,A00,747824,Gere; Catherina M.,118,0,120,2
1731501530753,HISC 180,A00,747825,Golan; Tal,15,0,15,0
1731501531781,HITO 87,A00,747567,Hanna; Mark G.,15,0,15,0
1731501531781,HITO 87,B00,747569,Patterson; Patrick H.,14,0,15,1
1731501531781,HITO 87,C00,747570,Patterson; Patrick H.,15,0,15,0
1731501531781,HITO 87,D00,747571,Edington; Claire Ellen,14,0,15,1
1731501531781,HITO 87,E00,747573,Schneewind; Sarah,15,0,15,0
1731501532808,HITO 100,B00,747827,Strasser; Ulrike,20,0,22,2
1731501533838,HITO 133,A00,747828,Hansen; Jan Eric,54,0,56,2
1731501534869,HITO 178,A00,747829,Hanna; Mark G.,19,0,20,1
1731501535895,HITO 193,A00,770732,Hill; Seth J,9999,0,9999,0
1731501536924,HIUS 108B,A00,794492,Daly; Heather Marie,34,0,40,6
1731501537951,HIUS 133,A00,747831,Hanna; Mark G.,136,0,146,10
1731501538982,HIUS 146,A00,747834,Alvarez; Luis A,48,0,50,2
1731501540015,HIUS 152B,A00,794678,Daly; Heather Marie,36,0,40,4
1731501541043,HIUS 180,A00,747835,Gosin; Monika N.,20,0,20,0
1731501542107,HUM 1,A01,767622,Demetriou; Denise,15,0,15,0
1731501542107,HUM 1,A02,767623,Demetriou; Denise,14,0,15,1
1731501542107,HUM 1,A03,767624,Demetriou; Denise,12,0,15,3
1731501542107,HUM 1,A04,767625,Demetriou; Denise,11,0,15,4
1731501542107,HUM 1,A05,767626,Demetriou; Denise,12,0,15,3
1731501542107,HUM 1,A06,767627,Demetriou; Denise,15,0,15,0
1731501542107,HUM 1,A07,767628,Demetriou; Denise,15,0,15,0
1731501542107,HUM 1,A08,767629,Demetriou; Denise,15,0,15,0
1731501542107,HUM 1,A09,767687,Demetriou; Denise,14,0,15,1
1731501542107,HUM 1,A10,767695,Demetriou; Denise,14,0,15,1
1731501542107,HUM 1,A11,767696,Demetriou; Denise,15,0,15,0
1731501542107,HUM 1,A12,767698,Demetriou; Denise,15,0,15,0
1731501542107,HUM 1,B01,767771,West; Geoffrey Scott,14,0,15,1
1731501542107,HUM 1,B02,767815,West; Geoffrey Scott,14,0,15,1
1731501542107,HUM 1,B03,767837,West; Geoffrey Scott,14,0,15,1
1731501542107,HUM 1,B04,767843,West; Geoffrey Scott,13,0,15,2
1731501542107,HUM 1,B05,767853,West; Geoffrey Scott,15,0,15,0
1731501542107,HUM 1,B06,767861,West; Geoffrey Scott,15,0,15,0
1731501542107,HUM 1,B07,767884,West; Geoffrey Scott,15,0,15,0
1731501542107,HUM 1,B08,767903,West; Geoffrey Scott,15,0,15,0
1731501542107,HUM 1,B09,767945,West; Geoffrey Scott,15,0,15,0
1731501542107,HUM 1,B10,767986,West; Geoffrey Scott,15,0,15,0
1731501542107,HUM 1,B11,768004,West; Geoffrey Scott,14,0,15,1
1731501542107,HUM 1,B12,768005,West; Geoffrey Scott,12,0,15,3
1731501542107,HUM 1,B13,768015,West; Geoffrey Scott,15,0,15,0
1731501542107,HUM 1,B14,768019,West; Geoffrey Scott,15,0,15,0
1731501542107,HUM 1,C01,768080,Rodriguez; Bretton Sigfred,0,0,0,0
1731501542107,HUM 1,C02,768081,Rodriguez; Bretton Sigfred,0,0,0,0
1731501542107,HUM 1,C03,768082,Rodriguez; Bretton Sigfred,13,0,15,2
1731501542107,HUM 1,C04,768083,Rodriguez; Bretton Sigfred,13,0,15,2
1731501542107,HUM 1,C05,768084,Rodriguez; Bretton Sigfred,14,0,15,1
1731501542107,HUM 1,C06,768085,Rodriguez; Bretton Sigfred,13,0,15,2
1731501542107,HUM 1,C07,768086,Rodriguez; Bretton Sigfred,15,0,15,0
1731501542107,HUM 1,C08,768087,Rodriguez; Bretton Sigfred,15,0,15,0
1731501542107,HUM 1,C09,768088,Rodriguez; Bretton Sigfred,15,0,15,0
1731501542107,HUM 1,C10,768089,Rodriguez; Bretton Sigfred,15,0,15,0
1731501542107,HUM 1,C11,768090,Rodriguez; Bretton Sigfred,13,0,15,2
1731501542107,HUM 1,C12,768091,Rodriguez; Bretton Sigfred,15,0,15,0
1731501542107,HUM 1,C13,768157,Rodriguez; Bretton Sigfred,14,0,15,1
1731501542107,HUM 1,C14,768158,Rodriguez; Bretton Sigfred,14,0,15,1
1731501543137,HUM 2,A01,768160,Lyon; Antony J.,13,0,15,2
1731501543137,HUM 2,A02,768165,Lyon; Antony J.,13,0,15,2
1731501543137,HUM 2,A03,768166,Lyon; Antony J.,0,0,0,0
1731501543137,HUM 2,A04,768167,Lyon; Antony J.,0,0,0,0
1731501543137,HUM 2,A05,768169,Lyon; Antony J.,14,0,15,1
1731501543137,HUM 2,A06,768193,Lyon; Antony J.,15,0,15,0
1731501543137,HUM 2,A07,768200,Lyon; Antony J.,14,0,15,1
1731501543137,HUM 2,A08,768260,Lyon; Antony J.,15,0,15,0
1731501543137,HUM 2,A09,768299,Lyon; Antony J.,13,0,15,2
1731501543137,HUM 2,A10,768323,Lyon; Antony J.,12,0,15,3
1731501543137,HUM 2,A11,768330,Lyon; Antony J.,15,0,15,0
1731501543137,HUM 2,A12,768338,Lyon; Antony J.,14,0,15,1
1731501543137,HUM 2,A13,768344,Lyon; Antony J.,0,0,0,0
1731501543137,HUM 2,A14,768388,Lyon; Antony J.,0,0,0,0
1731501544170,HUM 4,A01,768408,Watkins; Eric,27,0,28,1
1731501544170,HUM 4,A02,768409,Watkins; Eric,26,0,28,2
1731501544170,HUM 4,A03,768410,Watkins; Eric,27,0,28,1
1731501544170,HUM 4,A04,768411,Watkins; Eric,28,0,28,0
1731501544170,HUM 4,A05,768412,Watkins; Eric,27,0,28,1
1731501544170,HUM 4,A06,768413,Watkins; Eric,27,0,28,1
1731501544170,HUM 4,B01,768415,Caldwell; Michael Alan,20,0,28,8
1731501544170,HUM 4,B02,768416,Caldwell; Michael Alan,27,0,28,1
1731501544170,HUM 4,B03,768417,Caldwell; Michael Alan,21,0,28,7
1731501544170,HUM 4,B04,768418,Caldwell; Michael Alan,26,0,28,2
1731501544170,HUM 4,B05,768419,Caldwell; Michael Alan,28,0,28,0
1731501544170,HUM 4,B06,768420,Caldwell; Michael Alan,27,0,28,1
1731501544170,HUM 4,B07,768421,Caldwell; Michael Alan,28,0,28,0
1731501544170,HUM 4,B08,768422,Caldwell; Michael Alan,28,0,28,0
1731501544170,HUM 4,C01,768424,Markman; Kristina,27,0,28,1
1731501544170,HUM 4,C02,768425,Markman; Kristina,23,0,28,5
1731501544170,HUM 4,C03,768426,Markman; Kristina,24,0,28,4
1731501544170,HUM 4,C04,768427,Markman; Kristina,23,0,28,5
1731501544170,HUM 4,C05,768428,Markman; Kristina,24,0,28,4
1731501544170,HUM 4,C06,768429,Markman; Kristina,26,0,28,2
1731501544170,HUM 4,C07,768430,Markman; Kristina,25,0,28,3
1731501544170,HUM 4,C08,768431,Markman; Kristina,26,0,28,2
1731501545207,HUM 100,001,768432,Zavodny; Tatiana Sophia,18,0,18,0
1731501545207,HUM 100,002,768433,Zavodny; Tatiana Sophia,17,0,18,1
1731501545207,HUM 100,003,768434,Zavodny; Tatiana Sophia,17,0,18,1
1731501545207,HUM 100,004,768435,West; Geoffrey Scott,18,0,18,0
1731501545207,HUM 100,005,768436,Crum; Matthew Stephen,18,0,18,0
1731501545207,HUM 100,006,768437,Crum; Matthew Stephen,17,0,18,1
1731501545207,HUM 100,007,768438,Crum; Matthew Stephen,18,0,18,0
1731501545207,HUM 100,008,768439,Shenoy; Niyati,17,0,18,1
1731501545207,HUM 100,009,768440,Shenoy; Niyati,18,0,18,0
1731501545207,HUM 100,010,768441,Shenoy; Niyati,18,0,18,0
1731501546240,INTL 100,A01,747870,Feuer; Anna Stagg,23,0,25,2
1731501546240,INTL 100,A02,747872,Feuer; Anna Stagg,24,0,25,1
1731501546240,INTL 100,A03,747874,Feuer; Anna Stagg,22,0,25,3
1731501546240,INTL 100,A04,747881,Feuer; Anna Stagg,25,0,25,0
1731501546240,INTL 100,A05,747891,Feuer; Anna Stagg,22,0,25,3
1731501546240,INTL 100,A06,747893,Feuer; Anna Stagg,25,0,25,0
1731501547275,INTL 101,A01,747898,McIntosh; Justin Daniel,30,0,35,5
1731501547275,INTL 101,A02,747900,McIntosh; Justin Daniel,27,0,35,8
1731501548309,INTL 102,A01,747903,Broz; James Lawrence,28,0,35,7
1731501548309,INTL 102,A02,747909,Broz; James Lawrence,33,0,35,2
1731501549344,INTL 190,A00,747910,Appel; Benjamin Jay,0,0,0,0
1731501549344,INTL 190,B00,747912,Feeley; Maureen Catherine,0,0,0,2
1731501549344,INTL 190,C00,747914,Fortier; Jana,0,0,0,2
1731501549344,INTL 190,D00,747915,Lettieri; Michael Joseph,0,0,0,0
1731501550381,JAPN 10B,A01,747919,Maruyama; Rie,20,0,20,0
1731501550381,JAPN 10B,B01,747925,Sato; Kyoko,20,0,20,0
1731501550381,JAPN 10B,C01,747929,Ross; Kayoko F,17,0,20,3
1731501550381,JAPN 10B,D01,747932,McKee; Mayumi Mochizuki,22,0,25,3
1731501550381,JAPN 10B,E01,747936,Kamioka; Sachiko,21,0,25,4
1731501550381,JAPN 10B,F01,747941,Inada; Minori,23,0,25,2
1731501550381,JAPN 10B,G01,747944,Tipton; Yuko,25,0,25,0
1731501550381,JAPN 10B,H01,747951,Homma; Kunihiko,22,0,25,3
1731501550381,JAPN 10B,I01,747955,Maruyama; Rie,23,0,25,2
1731501550381,JAPN 10B,J01,747960,Tipton; Yuko,21,0,25,4
1731501550381,JAPN 10B,K01,747965,Sato; Kyoko,24,0,25,1
1731501550381,JAPN 10B,L01,747968,Ross; Kayoko F,25,0,25,0
1731501550381,JAPN 10B,M01,747971,Homma; Kunihiko,18,0,20,2
1731501551409,JAPN 10BR,A01,747974,Inada; Minori,20,0,20,0
1731501551409,JAPN 10BR,B01,747978,McKee; Mayumi Mochizuki,19,0,20,1
1731501551409,JAPN 10BR,C01,796045,Inada; Minori,4,0,4,0
1731501551409,JAPN 10BR,D01,796047,McKee; Mayumi Mochizuki,4,0,4,0
1731501552445,JAPN 20B,A01,747981,Takeda; Izumi,20,0,20,0
1731501552445,JAPN 20B,B01,747984,Homma; Kunihiko,16,0,20,4
1731501552445,JAPN 20B,C01,747988,Iwamoto; Naoki,18,0,20,2
1731501552445,JAPN 20B,D01,747991,Simpson; Junko Tokuda,20,0,20,0
1731501552445,JAPN 20B,E01,747993,Takeda; Izumi,20,0,20,0
1731501553476,JAPN 130B,A01,747998,Maruyama; Rie,19,0,20,1
1731501553476,JAPN 130B,B01,748001,Kamioka; Sachiko,19,0,20,1
1731501554503,JAPN 135B,A00,748002,Ross; Kayoko F,18,0,20,2
1731501554503,JAPN 135B,B00,748003,Iwamoto; Naoki,18,0,20,2
1731501555535,JAPN 137B,A00,748004,Simpson; Junko Tokuda,16,0,20,4
1731501556563,JAPN 140B,A00,748005,Takeda; Izumi,14,0,15,1
1731501557592,JAPN 150A,A00,748009,Sato; Kyoko,14,0,15,1
1731501558619,JAPN 190,A00,748010,Turner; Christena L.,19,0,20,1
1731501559652,JWSP 2,A01,748014,Shuster; Alana,14,0,15,1
1731501560680,LATI 10,A01,748018,Kennemore; Amy Michelle,27,0,30,3
1731501560680,LATI 10,A02,748020,Kennemore; Amy Michelle,30,0,30,0
1731501560680,LATI 10,A03,748021,Kennemore; Amy Michelle,28,0,30,2
1731501560680,LATI 10,A04,748023,Kennemore; Amy Michelle,28,0,30,2
1731501560680,LATI 10,A05,748025,Kennemore; Amy Michelle,30,0,30,0
1731501561711,LATI 50,A01,794604,Kokinis; Troy Andreas,28,0,30,2
1731501561711,LATI 50,A02,794839,Kokinis; Troy Andreas,29,0,30,1
1731501561711,LATI 50,A03,794840,Kokinis; Troy Andreas,30,0,30,0
1731501561711,LATI 50,A04,794841,Kokinis; Troy Andreas,27,0,30,3
1731501562741,LATI 140,A01,748028,Kokinis; Troy Andreas,30,0,30,0
1731501563773,LATI 170,A00,796289,Kennemore; Amy Michelle,28,0,30,2
1731501564802,LATI 180,B00,748041,Vasquez Cortes; Mateo,29,0,30,1
1731501565834,LATI 190,A00,748043,Carvajal Regidor; Jose,30,0,30,0
1731501566866,LAWS 101,A00,748047,Golan; Tal,48,0,60,12
1731501567901,LIAB 1B,A00,748070,Saab; Dima,12,0,14,2
1731501567901,LIAB 1B,B00,748075,Saab; Dima,11,0,14,3
1731501568937,LIAB 1BX,A00,748076,El Cheddadi; Youniss,24,0,28,4
1731501569965,LIAB 1E,A00,748082,El Cheddadi; Youniss,14,0,14,0
1731501570999,LIFR 1B,A00,748098,Van Moer; Vinciane G,12,0,14,2
1731501570999,LIFR 1B,B00,748099,Van Moer; Vinciane G,12,0,14,2
1731501570999,LIFR 1B,C00,748341,Van Moer; Vinciane G,12,0,14,2
1731501572027,LIFR 1BX,A00,748356,Van Moer; Vinciane G,21,0,21,0
1731501572027,LIFR 1BX,B00,748357,Van Moer; Vinciane G,15,0,21,6
1731501573056,LIFR 1C,A00,748361,Van Moer; Vinciane G,13,0,14,1
1731501573056,LIFR 1C,B00,748362,Van Moer; Vinciane G,10,0,14,4
1731501573056,LIFR 1C,C00,748363,Van Moer; Vinciane G,13,0,14,1
1731501574086,LIFR 1CX,A00,748366,Van Moer; Vinciane G,20,0,21,1
1731501574086,LIFR 1CX,B00,748367,Van Moer; Vinciane G,19,0,21,2
1731501575122,LIFR 11,A00,748368,Goodall; Grant Todd,9999,0,9999,0
1731501576154,LIGM 1B,A00,748371,Fischer-Grunski; Eva K,12,0,14,2
1731501576154,LIGM 1B,B00,748372,Fischer-Grunski; Eva K,12,0,14,2
1731501576154,LIGM 1B,C00,748374,Fischer-Grunski; Eva K,13,0,14,1
1731501577185,LIGM 1BX,A00,748376,Fischer-Grunski; Eva K,19,0,21,2
1731501577185,LIGM 1BX,B00,748378,Fischer-Grunski; Eva K,20,0,21,1
1731501578211,LIGM 11,A00,748379,Goodall; Grant Todd,9999,0,9999,0
1731501579239,LIGN 8,A00,748997,McIntosh; Justin Daniel,245,0,250,5
1731501580341,LIGN 17,A00,749008,Kehler; Andrew Scott,247,0,250,3
1731501581369,LIGN 101,A01,749010,Staff,27,0,29,2
1731501581369,LIGN 101,A02,749011,Staff,29,0,29,0
1731501581369,LIGN 101,A03,749149,Staff,27,0,29,2
1731501581369,LIGN 101,A04,749176,Staff,29,0,29,0
1731501581369,LIGN 101,A05,749186,Staff,29,0,30,1
1731501582397,LIGN 111,A01,749192,Bakovic; Eric John,29,0,30,1
1731501582397,LIGN 111,A02,749193,Bakovic; Eric John,27,0,30,3
1731501582397,LIGN 111,A03,749194,Bakovic; Eric John,24,0,30,6
1731501583428,LIGN 112,A00,749205,Garellek; Marc,69,0,70,1
1731501584474,LIGN 121,A01,749209,Rodriguez Aispuro; Alejandro,20,0,25,5
1731501584474,LIGN 121,A02,749211,Rodriguez Aispuro; Alejandro,24,0,25,1
1731501584474,LIGN 121,A03,749214,Rodriguez Aispuro; Alejandro,24,0,25,1
1731501585503,LIGN 148,A00,749215,Mayberry; Rachel,72,0,75,3
1731501586530,LIGN 150,A00,749218,Garellek; Marc,42,0,50,8
1731501587560,LIGN 172,A01,794611,Dudley; Rachel,30,0,30,0
1731501588587,LIGN 178,A00,749223,Munoz Sanchez; Alicia,69,0,70,1
1731501589618,LIGN 187,A00,749226,Staff,30,0,30,0
1731501589618,LIGN 187,B00,749227,Warstadt; Alexander Scott,30,0,30,0
1731501590649,LIGN 188R,A00,749228,Clem; Emily,40,0,40,0
1731501591682,LIGN 214,A00,749229,Styler; William Francis,29,0,30,1
1731501592712,LIGN 225,A00,749230,Clem; Emily,30,0,30,0
1731501593744,LIGN 251,A00,749287,Bergen; Leon,28,0,30,2
1731501594794,LIGN 296,001,774625,Ackerman; Farrell,10,0,10,0
1731501594794,LIGN 296,002,774626,Bakovic; Eric John,10,0,10,0
1731501594794,LIGN 296,003,774627,Bergen; Leon,10,0,10,0
1731501594794,LIGN 296,004,774638,Caballero; Gabriela Hernandez,10,0,10,0
1731501594794,LIGN 296,005,774639,Caponigro; Ivano,10,0,10,0
1731501594794,LIGN 296,006,774683,Clem; Emily,10,0,10,0
1731501594794,LIGN 296,007,774684,Dudley; Rachel,10,0,10,0
1731501594794,LIGN 296,008,774685,Garellek; Marc,10,0,10,0
1731501594794,LIGN 296,009,774691,Goodall; Grant Todd,10,0,10,0
1731501594794,LIGN 296,010,774692,Kehler; Andrew Scott,10,0,10,0
1731501594794,LIGN 296,011,774694,Kluender; Robert,10,0,10,0
1731501594794,LIGN 296,012,774697,Rose; Sharon,10,0,10,0
1731501594794,LIGN 296,013,774700,Styler; William Francis,10,0,10,0
1731501594794,LIGN 296,014,774820,Caponigro; Ivano,10,0,10,0
1731501595822,LIHL 112W,A00,748052,Pagkalinawan; Leticia Cant,27,0,28,1
1731501596850,LIHL 114W,A00,748054,Nguyen; Hoan Thi,25,0,28,3
1731501597882,LIHL 117W,A00,748057,Sadegholvad; Elham,28,0,28,0
1731501598912,LIHL 118,A00,748059,Chen; Areana Yen,28,0,28,0
1731501599939,LIHL 124W,A00,748061,Nguyen; Hoan Thi,26,0,28,2
1731501600968,LIHL 132W,A00,748062,Pagkalinawan; Leticia Cant,28,0,28,0
1731501601995,LIHL 134W,A00,748064,Nguyen; Hoan Thi,28,0,28,0
1731501603024,LIHL 138,A00,748068,Chen; Areana Yen,28,0,28,0
1731501604053,LIIT 1B,A00,748409,Carnelos; Chiara,13,0,14,1
1731501604053,LIIT 1B,B00,748418,Carnelos; Chiara,12,0,14,2
1731501604053,LIIT 1B,C00,748424,Carnelos; Chiara,12,0,14,2
1731501605085,LIIT 1BX,A00,748428,Carnelos; Chiara,21,0,21,0
1731501605085,LIIT 1BX,B00,748430,Carnelos; Chiara,17,0,21,4
1731501606119,LIPO 1B,A00,748436,Paladini; Denise,12,0,14,2
1731501606119,LIPO 1B,B00,748437,Paladini; Denise,0,0,0,0
1731501607146,LIPO 1BX,A00,748438,De Abreu; Cassia,27,0,28,1
1731501608173,LIPO 17,A00,798404,Paladini; Denise,0,0,0,0
1731501609201,LISL 1B,A00,748478,Lott; Margaret S.,14,0,14,0
1731501609201,LISL 1B,B00,748482,Lott; Margaret S.,14,0,14,0
1731501609201,LISL 1B,C00,748484,Lott; Margaret S.,13,0,14,1
1731501609201,LISL 1B,D00,748485,Lott; Margaret S.,12,0,14,2
1731501609201,LISL 1B,E00,748487,Lott; Margaret S.,14,0,14,0
1731501609201,LISL 1B,F00,748490,Lott; Margaret S.,12,0,14,2
1731501609201,LISL 1B,G00,748491,Lott; Margaret S.,13,0,14,1
1731501609201,LISL 1B,H00,748492,Lott; Margaret S.,14,0,14,0
1731501610229,LISL 1BX,A00,748594,Lott; Margaret S.,28,0,28,0
1731501610229,LISL 1BX,B00,748595,Lott; Margaret S.,27,0,28,1
1731501610229,LISL 1BX,C00,748596,Lott; Margaret S.,25,0,28,3
1731501610229,LISL 1BX,D00,748597,Lott; Margaret S.,27,0,28,1
1731501611257,LISL 1C,A00,748614,Lott; Margaret S.,11,0,14,3
1731501611257,LISL 1C,B00,748616,Lott; Margaret S.,13,0,14,1
1731501611257,LISL 1C,C00,748678,Lott; Margaret S.,11,0,14,3
1731501611257,LISL 1C,D00,748686,Lott; Margaret S.,14,0,14,0
1731501612287,LISL 1CX,A00,748698,Lott; Margaret S.,21,0,28,7
1731501612287,LISL 1CX,B00,748699,Lott; Margaret S.,25,0,28,3
1731501613317,LISL 1E,A00,748700,Lott; Margaret S.,11,0,14,3
1731501614349,LISP 1B,A00,748737,Munoz Sanchez; Alicia,12,0,14,2
1731501614349,LISP 1B,B00,748755,Munoz Sanchez; Alicia,14,0,14,0
1731501614349,LISP 1B,C00,748761,Munoz Sanchez; Alicia,14,0,14,0
1731501614349,LISP 1B,D00,748763,Munoz Sanchez; Alicia,12,0,14,2
1731501614349,LISP 1B,E00,748764,Munoz Sanchez; Alicia,14,0,14,0
1731501614349,LISP 1B,F00,748790,Munoz Sanchez; Alicia,11,0,14,3
1731501614349,LISP 1B,G00,748791,Munoz Sanchez; Alicia,14,0,14,0
1731501614349,LISP 1B,H00,748792,Munoz Sanchez; Alicia,9,0,14,5
1731501614349,LISP 1B,I00,748793,Munoz Sanchez; Alicia,12,0,14,2
1731501614349,LISP 1B,J00,748794,Munoz Sanchez; Alicia,11,0,14,3
1731501615400,LISP 1BX,A00,748795,Munoz Sanchez; Alicia,26,0,28,2
1731501615400,LISP 1BX,B00,748796,Munoz Sanchez; Alicia,25,0,28,3
1731501615400,LISP 1BX,C00,748797,Munoz Sanchez; Alicia,26,0,28,2
1731501615400,LISP 1BX,D00,748798,Munoz Sanchez; Alicia,25,0,28,3
1731501615400,LISP 1BX,E00,748799,Munoz Sanchez; Alicia,24,0,28,4
1731501616435,LISP 1C,001,748834,Munoz Sanchez; Alicia,13,0,14,1
1731501616435,LISP 1C,002,748835,Munoz Sanchez; Alicia,14,0,14,0
1731501616435,LISP 1C,003,748847,Munoz Sanchez; Alicia,13,0,14,1
1731501616435,LISP 1C,004,748848,Munoz Sanchez; Alicia,13,0,14,1
1731501616435,LISP 1C,005,748863,Munoz Sanchez; Alicia,13,0,14,1
1731501616435,LISP 1C,006,748866,Munoz Sanchez; Alicia,13,0,14,1
1731501616435,LISP 1C,007,748867,Munoz Sanchez; Alicia,12,0,14,2
1731501616435,LISP 1C,008,748868,Munoz Sanchez; Alicia,14,0,14,0
1731501616435,LISP 1C,009,748869,Munoz Sanchez; Alicia,14,0,14,0
1731501616435,LISP 1C,010,748870,Munoz Sanchez; Alicia,13,0,14,1
1731501616435,LISP 1C,011,748871,Munoz Sanchez; Alicia,12,0,14,2
1731501616435,LISP 1C,012,748872,Munoz Sanchez; Alicia,12,0,14,2
1731501616435,LISP 1C,013,748873,Munoz Sanchez; Alicia,12,0,14,2
1731501616435,LISP 1C,014,748879,Munoz Sanchez; Alicia,13,0,14,1
1731501616435,LISP 1C,015,748895,Munoz Sanchez; Alicia,12,0,14,2
1731501616435,LISP 1C,016,748896,Munoz Sanchez; Alicia,14,0,14,0
1731501616435,LISP 1C,017,748901,Munoz Sanchez; Alicia,14,0,14,0
1731501616435,LISP 1C,018,748902,Munoz Sanchez; Alicia,13,0,14,1
1731501616435,LISP 1C,020,748904,Munoz Sanchez; Alicia,14,0,14,0
1731501617464,LISP 1CX,B00,748913,Munoz Sanchez; Alicia,27,0,30,3
1731501617464,LISP 1CX,C00,748914,Munoz Sanchez; Alicia,26,0,30,4
1731501617464,LISP 1CX,D00,748926,Munoz Sanchez; Alicia,27,0,30,3
1731501617464,LISP 1CX,E00,748937,Munoz Sanchez; Alicia,30,0,30,0
1731501617464,LISP 1CX,F00,748938,Munoz Sanchez; Alicia,27,0,30,3
1731501617464,LISP 1CX,G00,748950,Munoz Sanchez; Alicia,28,0,30,2
1731501617464,LISP 1CX,H00,748951,Munoz Sanchez; Alicia,28,0,30,2
1731501617464,LISP 1CX,I00,748956,Munoz Sanchez; Alicia,30,0,30,0
1731501617464,LISP 1CX,J00,748957,Munoz Sanchez; Alicia,29,0,30,1
1731501618492,LISP 16,A00,748994,Munoz Sanchez; Alicia,20,0,22,2
1731501618492,LISP 16,B00,748995,Munoz Sanchez; Alicia,21,0,22,1
1731501619522,LISP 18,A00,748996,Munoz Sanchez; Alicia,21,0,22,1
1731501620551,LTAM 105,A00,749877,Ruiz; Ariana,35,0,40,5
1731501621580,LTAM 110,A00,749882,Chacon; Gloria Elizabeth,40,0,40,0
1731501622608,LTAM 120,A00,749915,Martin-Cabrera; Luis,39,0,40,1
1731501623635,LTCO 281,A00,750740,Mukherjee; Silpa,15,0,15,0
1731501624679,LTCO 282,A00,750741,Cohen; Alain J. J.,12,0,15,3
1731501625705,LTCS 11,A00,749294,Lampert-Weissig; Lisa,39,0,40,1
1731501626735,LTCS 87,A00,795238,Nguyen; Hoang Tan,19,0,20,1
1731501626735,LTCS 87,B00,795239,Nguyen; Hoang Tan,20,0,20,0
1731501627767,LTCS 108,A00,749916,Lu; Lillian,19,0,20,1
1731501628793,LTCS 111,A00,749940,Vitkus; Daniel J.,25,0,25,0
1731501629821,LTCS 131,A00,749942,Sanchez Cruz; Jorge,39,0,40,1
1731501630850,LTEA 100A,A00,749944,Liao; Ping H,39,0,40,1
1731501631878,LTEA 132,A00,749945,Mendoza; Andrea,55,0,60,5
1731501632905,LTEA 138,A00,749946,Miyao; Daisuke,347,0,360,13
1731501633933,LTEN 23,A01,749297,Vijay; Ameeth Varma,28,0,28,0
1731501633933,LTEN 23,A02,749321,Vijay; Ameeth Varma,27,0,28,1
1731501633933,LTEN 23,A03,749322,Vijay; Ameeth Varma,28,0,28,0
1731501633933,LTEN 23,A04,749324,Vijay; Ameeth Varma,27,0,28,1
1731501634966,LTEN 26,A01,749326,Wesling; Megan E.,27,0,28,1
1731501634966,LTEN 26,A02,749327,Wesling; Megan E.,26,0,28,2
1731501634966,LTEN 26,A03,749328,Wesling; Megan E.,25,0,28,3
1731501634966,LTEN 26,A04,749329,Wesling; Megan E.,25,0,28,3
1731501635996,LTEN 27,A01,749339,Childs; Dennis R.,27,0,28,1
1731501635996,LTEN 27,A02,749348,Childs; Dennis R.,27,0,28,1
1731501635996,LTEN 27,A03,749360,Childs; Dennis R.,26,0,28,2
1731501635996,LTEN 27,A04,749362,Childs; Dennis R.,27,0,28,1
1731501637027,LTEN 112,A00,749947,Vitkus; Daniel J.,38,0,40,2
1731501638059,LTEN 140,A00,749948,Lu; Lillian,23,0,25,2
1731501639084,LTEN 142,A00,749949,Garofalo; Devin,38,0,40,2
1731501640116,LTEN 180,A00,749950,Ruiz; Ariana,17,0,20,3
1731501641145,LTEN 181,A00,749951,Kim; Joo Ok,36,0,40,4
1731501642173,LTEN 185,A00,749961,Childs; Dennis R.,17,0,20,3
1731501643204,LTEN 189,A00,749962,Vijay; Ameeth Varma,24,0,25,1
1731501644239,LTEN 252,A00,750742,Wesling; Megan E.,12,0,15,3
1731501645282,LTEN 272,A00,750744,Lampert-Weissig; Lisa,11,0,15,4
1731501646309,LTEU 105,A00,749963,De Marchi Gherini; Adriana,28,0,35,7
1731501647336,LTEU 141,A00,749977,Cohen; Alain J. J.,40,0,40,0
1731501648363,LTEU 150C,B00,750299,Morse; Ainsley,30,0,30,0
1731501649395,LTFR 2B,A01,749381,Ploye; Catherine,28,0,28,0
1731501650426,LTFR 2C,A00,749383,Ploye; Catherine,25,0,25,0
1731501651453,LTFR 104,A00,750301,Zhiri; Oumelbanine,25,0,25,0
1731501652481,LTFR 115,A00,750302,Zhiri; Oumelbanine,25,0,25,0
1731501653510,LTGK 2,A00,749384,Murray; Kourtney Kristine,30,0,31,1
1731501654536,LTGK 104,A00,795231,Murray; Kourtney Kristine,25,0,25,0
1731501655562,LTGM 2B,A01,749413,Fischer-Grunski; Eva K,25,0,25,0
1731501656594,LTIT 2B,A01,749459,De Marchi Gherini; Adriana,24,0,25,1
1731501657625,LTIT 115,A00,750314,De Marchi Gherini; Adriana,5,0,5,0
1731501658656,LTKO 1B,A01,749486,Cho; Hye Jin,26,0,28,2
1731501658656,LTKO 1B,B01,749543,Cho; Hye Jin,26,0,28,2
1731501658656,LTKO 1B,C01,749573,Tark; Eun Sun,26,0,28,2
1731501658656,LTKO 1B,D01,749575,Tark; Eun Sun,27,0,28,1
1731501658656,LTKO 1B,E01,749590,Yim; Nancy,28,0,28,0
1731501658656,LTKO 1B,F01,749632,Yim; Nancy,28,0,28,0
1731501659690,LTKO 2B,A01,749700,Lee; Jeyseon,23,0,28,5
1731501660718,LTKO 130W,A00,750479,Lee; Jeyseon,25,0,25,0
1731501661752,LTLA 2,A00,749738,Murray; Kourtney Kristine,44,0,45,1
1731501662780,LTLA 105,A00,750480,Kelting; Edward William,24,0,25,1
1731501663815,LTRU 1B,A01,749758,Wells; Patricia Rebecca,26,0,28,2
1731501664847,LTRU 2B,A01,749788,Wells; Patricia Rebecca,25,0,25,0
1731501665877,LTRU 104C,A01,750482,Wells; Patricia Rebecca,20,0,20,0
1731501666908,LTRU 110C,B00,750484,Morse; Ainsley,10,0,10,0
1731501667937,LTSP 2A,A01,749790,Lampell; Toni,23,0,28,5
1731501668969,LTSP 2B,A01,749855,Mastromartino; Alexandra L,26,0,28,2
1731501668969,LTSP 2B,B01,749857,Mastromartino; Alexandra L,26,0,28,2
1731501670000,LTSP 2C,A01,749859,Lampell; Toni,25,0,28,3
1731501671028,LTSP 2F,A00,749860,Mastromartino; Alexandra L,25,0,25,0
1731501672056,LTSP 3F,A00,749861,Dominguez; Noelia,25,0,25,0
1731501672056,LTSP 3F,B00,749862,Dominguez; Noelia,23,0,25,2
1731501673093,LTSP 100F,A00,750494,Arcos Herrera; Carol,25,0,25,0
1731501673093,LTSP 100F,B00,750495,Dominguez; Noelia,24,0,25,1
1731501673093,LTSP 100F,C00,750547,Villafuerte Vazquez; Nadia,25,0,25,0
1731501674121,LTSP 116,A00,750557,Arcos Herrera; Carol,40,0,40,0
1731501675150,LTSP 135B,A00,750560,Sanchez Cruz; Jorge,39,0,40,1
1731501676178,LTSP 145,A00,750561,Martin-Cabrera; Luis,24,0,25,1
1731501677210,LTSP 155,A00,798249,Blanco; John D,40,0,40,0
1731501678235,LTSP 166,A00,750562,Carvajal Regidor; Jose,39,0,40,1
1731501679263,LTSP 172,A00,750563,Chacon; Gloria Elizabeth,40,0,40,0
1731501680289,LTTH 210B,A00,750769,Blanco; John D,15,0,15,0
1731501681322,LTWL 11,A00,749863,Dhar; Amrita,40,0,40,0
1731501682349,LTWL 19B,A00,749864,Myerston Santana; Jacobo,38,0,40,2
1731501683380,LTWL 102,A00,750565,Myerston Santana; Jacobo,23,0,25,2
1731501684408,LTWL 120,A00,750578,Mendoza; Andrea,38,0,40,2
1731501685436,LTWL 124,A00,750579,Garofalo; Devin,39,0,40,1
1731501686466,LTWL 165,A00,750587,Kim; Joo Ok,40,0,40,0
1731501687494,LTWL 180,A00,750613,Nguyen; Hoang Tan,39,0,40,1
1731501688521,LTWL 184,A00,750625,Mukherjee; Silpa,38,0,40,2
1731501689555,LTWR 8A,A01,749866,Hoang; Lily Kim,26,0,28,2
1731501689555,LTWR 8A,A02,749867,Hoang; Lily Kim,28,0,28,0
1731501689555,LTWR 8A,A03,749868,Hoang; Lily Kim,25,0,28,3
1731501689555,LTWR 8A,A04,749869,Hoang; Lily Kim,24,0,28,4
1731501690586,LTWR 8B,A01,749872,Som; Brandon D,28,0,28,0
1731501690586,LTWR 8B,A02,749873,Som; Brandon D,27,0,28,1
1731501690586,LTWR 8B,A03,749874,Som; Brandon D,27,0,28,1
1731501690586,LTWR 8B,A04,749875,Som; Brandon D,28,0,28,0
1731501691614,LTWR 101C,A00,750638,Villafuerte Vazquez; Nadia,30,0,30,0
1731501692642,LTWR 109C,A00,795232,Terry; Christopher,24,0,30,6
1731501693671,LTWR 110C,A00,795236,Terry; Christopher,25,0,30,5
1731501694703,LTWR 113C,A00,750640,Carroll; Amy Sara,29,0,30,1
1731501695730,LTWR 114W,A00,750675,Springer; Anna Joy,14,0,15,1
1731501696762,LTWR 115C,A00,750677,Lopez; Casandra,28,0,30,2
1731501697793,LTWR 120C,A00,750678,Wilkinson; Marco,29,0,30,1
1731501698821,LTWR 121C,A00,795237,Terry; Christopher,26,0,30,4
1731501699853,LTWR 126W,A00,750739,Lopez; Casandra,13,0,15,2
1731501700878,LTWR 144,A00,795207,Hoang; Lily Kim,23,0,25,2
1731501701909,LTWR 215,A00,750771,Wilkinson; Marco,14,0,20,6
1731501702941,LTWR 220,A00,750778,Som; Brandon D,9,0,15,6
1731501703972,MAE 8,A01,754809,Arefiev; Alexey,136,0,140,4
1731501705000,MAE 20,A00,754810,Evdokimenko; Ekaterina,57,0,60,3
1731501706033,MAE 30A,A00,754811,Qi; Huihui,100,0,100,0
1731501706033,MAE 30A,B00,754812,Qi; Huihui,78,0,100,22
1731501707061,MAE 30B,A00,754813,Delson; Nathan Joseph,63,0,65,2
1731501708087,MAE 40,A00,754814,Cortes; Jorge,90,0,104,14
1731501709119,MAE 101A,A00,754815,Nomura; Keiko K.,140,0,150,10
1731501710151,MAE 101B,A00,754816,Pham; Hieu Tan,110,0,120,10
1731501711190,MAE 114,A00,754817,Krasheninnikov; Sergei,49,0,50,1
1731501712223,MAE 118,A00,754818,Marinoni; Alessandro,40,0,45,5
1731501713257,MAE 120,A00,754819,Krasheninnikov; Sergei,53,0,60,7
1731501714285,MAE 125,A00,754820,Kleissl; Jan,56,0,75,19
1731501715319,MAE 130,A00,754821,Frazier; Michael,59,0,60,1
1731501716348,MAE 131B,A00,754822,Scholtes Acevedo; Claire,99,0,100,1
1731501717376,MAE 142,A00,754823,Anderson; Mark Ronald,31,0,60,29
1731501718412,MAE 143A,A00,754824,Diagne; Mamadou Lamine,58,0,75,17
1731501718412,MAE 143A,B00,754825,Kramer; Boris,66,0,75,9
1731501719439,MAE 143B,A00,754826,Morimoto; Tania,83,0,100,17
1731501720474,MAE 148,A01,754828,Silberman; Jack,21,0,24,3
1731501721501,MAE 155A,A01,754830,Anderson; Mark Ronald,14,0,50,36
1731501721501,MAE 155A,B01,754832,Hwang; John T,35,0,50,15
1731501722535,MAE 156A,A01,754834,Gravish; Nicholas G & Tustaniwskyj; Jerry I & Mullin; Jennifer S & Lubarda; Marko & Delson; Nathan Joseph,0,0,12,12
1731501722535,MAE 156A,A02,754835,Gravish; Nicholas G & Tustaniwskyj; Jerry I & Delson; Nathan Joseph & Mullin; Jennifer S & Lubarda; Marko,7,0,12,5
1731501722535,MAE 156A,A03,754874,Gravish; Nicholas G & Tustaniwskyj; Jerry I & Mullin; Jennifer S & Lubarda; Marko & Delson; Nathan Joseph,0,0,12,12
1731501722535,MAE 156A,A04,754891,Gravish; Nicholas G & Tustaniwskyj; Jerry I & Mullin; Jennifer S & Lubarda; Marko & Delson; Nathan Joseph,12,0,12,0
1731501722535,MAE 156A,A05,754898,Gravish; Nicholas G & Tustaniwskyj; Jerry I & Mullin; Jennifer S & Lubarda; Marko & Delson; Nathan Joseph,0,0,12,12
1731501722535,MAE 156A,A06,754899,Gravish; Nicholas G & Tustaniwskyj; Jerry I & Delson; Nathan Joseph & Mullin; Jennifer S & Lubarda; Marko,10,0,12,2
1731501722535,MAE 156A,A07,754900,Gravish; Nicholas G & Tustaniwskyj; Jerry I & Mullin; Jennifer S & Lubarda; Marko & Delson; Nathan Joseph,8,0,12,4
1731501722535,MAE 156A,A08,754933,Gravish; Nicholas G & Tustaniwskyj; Jerry I & Mullin; Jennifer S & Lubarda; Marko & Delson; Nathan Joseph,10,0,12,2
1731501722535,MAE 156A,A09,754937,Gravish; Nicholas G & Tustaniwskyj; Jerry I & Mullin; Jennifer S & Lubarda; Marko & Delson; Nathan Joseph,8,0,14,6
1731501722535,MAE 156A,A10,754970,Gravish; Nicholas G & Tustaniwskyj; Jerry I & Delson; Nathan Joseph & Mullin; Jennifer S & Lubarda; Marko,1,0,8,7
1731501722535,MAE 156A,A11,754971,Gravish; Nicholas G & Tustaniwskyj; Jerry I & Mullin; Jennifer S & Lubarda; Marko & Delson; Nathan Joseph,3,0,8,5
1731501722535,MAE 156A,A12,754972,Gravish; Nicholas G & Tustaniwskyj; Jerry I & Mullin; Jennifer S & Lubarda; Marko & Delson; Nathan Joseph,4,0,8,4
1731501722535,MAE 156A,A13,754973,Gravish; Nicholas G & Tustaniwskyj; Jerry I & Mullin; Jennifer S & Lubarda; Marko & Delson; Nathan Joseph,5,0,8,3
1731501722535,MAE 156A,A14,754974,Gravish; Nicholas G & Tustaniwskyj; Jerry I & Delson; Nathan Joseph & Mullin; Jennifer S & Lubarda; Marko,6,0,8,2
1731501722535,MAE 156A,A15,754975,Gravish; Nicholas G & Tustaniwskyj; Jerry I & Mullin; Jennifer S & Lubarda; Marko & Delson; Nathan Joseph,4,0,8,4
1731501722535,MAE 156A,A16,754976,Gravish; Nicholas G & Tustaniwskyj; Jerry I & Mullin; Jennifer S & Lubarda; Marko & Delson; Nathan Joseph,6,0,8,2
1731501722535,MAE 156A,A17,754977,Gravish; Nicholas G & Tustaniwskyj; Jerry I & Mullin; Jennifer S & Lubarda; Marko & Delson; Nathan Joseph,7,0,8,1
1731501722535,MAE 156A,A18,754978,Gravish; Nicholas G & Tustaniwskyj; Jerry I & Delson; Nathan Joseph & Mullin; Jennifer S & Lubarda; Marko,6,0,6,0
1731501723565,MAE 156B,A01,754980,Staff,30,0,36,6
1731501723565,MAE 156B,B01,754982,Tustaniwskyj; Jerry I,25,0,36,11
1731501724597,MAE 160,A00,754983,Evdokimenko; Ekaterina,151,0,165,14
1731501725629,MAE 171A,A01,754985,Kleissl; Jan,24,0,32,8
1731501725629,MAE 171A,A02,754986,Kleissl; Jan,23,0,32,9
1731501725629,MAE 171A,A03,754987,Kleissl; Jan,2,0,32,30
1731501725629,MAE 171A,A04,754988,Kleissl; Jan,0,0,32,32
1731501725629,MAE 171A,A05,754989,Kleissl; Jan,30,0,32,2
1731501725629,MAE 171A,A06,754990,Kleissl; Jan,20,0,32,12
1731501725629,MAE 171A,A07,754991,Kleissl; Jan,25,0,32,7
1731501725629,MAE 171A,A08,754992,Kleissl; Jan,15,0,32,17
1731501725629,MAE 171A,A09,754993,Kleissl; Jan,20,0,24,4
1731501726665,MAE 175A,A01,754995,de Callafon; Raymond A,13,0,16,3
1731501726665,MAE 175A,A02,754996,de Callafon; Raymond A,5,0,16,11
1731501726665,MAE 175A,A03,754997,de Callafon; Raymond A,16,0,16,0
1731501726665,MAE 175A,A04,754998,de Callafon; Raymond A,13,0,16,3
1731501726665,MAE 175A,A05,754999,de Callafon; Raymond A,7,0,16,9
1731501726665,MAE 175A,A06,755052,de Callafon; Raymond A,14,0,15,1
1731501727692,MAE 180,A00,755116,Rosengren; Aaron,53,0,60,7
1731501728723,MAE 200,A00,755117,Diagne; Mamadou Lamine,0,0,50,50
1731501729755,MAE 204,A00,755186,Tolley; Michael Thomas,21,0,100,79
1731501730790,MAE 205,A00,755187,Diagne; Mamadou Lamine & Tynan; George Robert & Scholtes Acevedo; Claire & Qi; Huihui & Hao; Xuanting & Garay; Javier,9990,0,9999,9
1731501731816,MAE 206,A00,755188,Tynan; George Robert,23,0,80,57
1731501732842,MAE 207,A00,755193,Poulikakos; Lisa Voula,17,0,30,13
1731501732842,MAE 207,B00,755199,Staff,51,0,60,9
1731501733870,MAE 208,A00,755212,Saintillan; David,6,0,30,24
1731501734899,MAE 210B,A00,755213,Sanchez; Antonio Luis,13,0,30,17
1731501735928,MAE 210C,A00,755214,Becker; Janet Maria,11,0,15,4
1731501736955,MAE 212,A00,755215,Sanchez; Antonio Luis,18,0,40,22
1731501737982,MAE 217B,A00,755216,Arefiev; Alexey,6,0,10,4
1731501739010,MAE 221B,A00,755217,Coimbra; Carlos F.,7,0,15,8
1731501740037,MAE 221C,A00,755218,Saha; Abhishek,3,0,10,7
1731501741065,MAE 231C,A00,755220,Jandaghi Semnani; Shabnam,4,0,5,1
1731501742098,MAE 232B,A00,755221,Chen; Jiun-Shyan,0,0,10,10
1731501743127,MAE 248,A00,755222,Herbert; Sylvia Lee,15,0,15,0
1731501744159,MAE 261,A00,755223,Lindsey; Stephanie,10,0,10,0
1731501745189,MAE 270,A00,755224,Hwang; John T,0,0,15,15
1731501746222,MAE 271A,A00,755226,Luo; Jian,2,0,5,3
1731501747248,MAE 274,A00,755299,Kramer; Boris,0,0,0,0
1731501748275,MAE 276,A00,755300,Cai; Shengqiang,0,0,20,20
1731501749305,MAE 281A,A00,755301,Krstic; Miroslav,19,0,42,23
1731501750335,MAE 289B,A00,755302,Martinez; Sonia,10,0,10,0
1731501751366,MAE 290B,A00,755303,Sarkar; Sutanu,20,0,40,20
1731501752395,MAE 294B,A00,755304,Llewellyn Smith; Stefan G.,7,0,10,3
1731501753425,MATH 2,A01,751732,Cheng; Hsiao-Bing,193,0,200,7
1731501753425,MATH 2,B01,751734,Cheng; Hsiao-Bing,196,0,200,4
1731501754466,MATH 3B,A01,751736,Hammock; Frances H,33,0,33,0
1731501754466,MATH 3B,A02,751737,Hammock; Frances H,24,0,33,9
1731501754466,MATH 3B,A03,751738,Hammock; Frances H,33,0,33,0
1731501754466,MATH 3B,A04,751739,Hammock; Frances H,30,0,33,3
1731501754466,MATH 3B,A05,751740,Hammock; Frances H,30,0,31,1
1731501754466,MATH 3B,A06,751741,Hammock; Frances H,31,0,33,2
1731501754466,MATH 3B,B01,751743,Staff,27,0,32,5
1731501754466,MATH 3B,B02,751744,Staff,32,0,32,0
1731501754466,MATH 3B,B03,751745,Staff,29,0,32,3
1731501754466,MATH 3B,B04,751746,Staff,31,0,32,1
1731501754466,MATH 3B,B05,751765,Staff,32,0,32,0
1731501754466,MATH 3B,B06,751766,Staff,32,0,32,0
1731501755508,MATH 3C,A01,751774,Hammock; Frances H,29,0,30,1
1731501755508,MATH 3C,A02,751775,Hammock; Frances H,26,0,30,4
1731501755508,MATH 3C,A03,751776,Hammock; Frances H,30,0,30,0
1731501755508,MATH 3C,A04,751781,Hammock; Frances H,25,0,30,5
1731501755508,MATH 3C,A05,751782,Hammock; Frances H,20,0,30,10
1731501755508,MATH 3C,A06,751952,Hammock; Frances H,30,0,30,0
1731501755508,MATH 3C,B01,752043,Staff,32,0,35,3
1731501755508,MATH 3C,B02,752094,Staff,35,0,35,0
1731501755508,MATH 3C,B03,752188,Staff,35,0,35,0
1731501755508,MATH 3C,B04,752210,Staff,33,0,35,2
1731501755508,MATH 3C,C01,752281,Yin; Wei,31,0,32,1
1731501755508,MATH 3C,C02,752282,Yin; Wei,31,0,32,1
1731501755508,MATH 3C,C03,752283,Yin; Wei,32,0,32,0
1731501755508,MATH 3C,C04,752284,Yin; Wei,32,0,32,0
1731501756542,MATH 4C,A01,752286,Aliabadi Sr.; Mohsen,31,0,35,4
1731501756542,MATH 4C,A02,752287,Aliabadi Sr.; Mohsen,35,0,35,0
1731501756542,MATH 4C,A03,752290,Aliabadi Sr.; Mohsen,35,0,35,0
1731501756542,MATH 4C,A04,752291,Aliabadi Sr.; Mohsen,35,0,35,0
1731501757574,MATH 10A,A01,752293,Hiatt; Patrick John,20,0,32,12
1731501757574,MATH 10A,A02,752294,Hiatt; Patrick John,28,0,32,4
1731501757574,MATH 10A,A03,752296,Hiatt; Patrick John,31,0,32,1
1731501757574,MATH 10A,A04,752297,Hiatt; Patrick John,30,0,32,2
1731501757574,MATH 10A,B01,752306,Hiatt; Patrick John,23,0,32,9
1731501757574,MATH 10A,B02,752362,Hiatt; Patrick John,31,0,32,1
1731501757574,MATH 10A,B03,752366,Hiatt; Patrick John,32,0,32,0
1731501757574,MATH 10A,B04,752372,Hiatt; Patrick John,30,0,32,2
1731501757574,MATH 10A,B05,752415,Hiatt; Patrick John,32,0,32,0
1731501757574,MATH 10A,B06,752463,Hiatt; Patrick John,32,0,32,0
1731501757574,MATH 10A,C01,752582,Hardiman; Liam,53,0,58,5
1731501757574,MATH 10A,C02,752589,Hardiman; Liam,57,0,60,3
1731501757574,MATH 10A,C03,752591,Hardiman; Liam,31,0,32,1
1731501757574,MATH 10A,C04,752592,Hardiman; Liam,32,0,32,0
1731501757574,MATH 10A,C05,796290,Hardiman; Liam,59,0,60,1
1731501757574,MATH 10A,C06,796293,Hardiman; Liam,60,0,60,0
1731501757574,MATH 10A,D01,752596,Briones; Jor-el Thomas Caparas,84,0,100,16
1731501757574,MATH 10A,D02,752597,Briones; Jor-el Thomas Caparas,99,0,100,1
1731501758608,MATH 10B,A01,752608,Zhao; Yizhen,0,0,0,0
1731501758608,MATH 10B,A02,752609,Zhao; Yizhen,0,0,0,0
1731501758608,MATH 10B,A03,752620,Zhao; Yizhen,0,0,0,0
1731501758608,MATH 10B,A04,752621,Zhao; Yizhen,0,0,0,0
1731501758608,MATH 10B,A05,752622,Zhao; Yizhen,0,0,0,0
1731501758608,MATH 10B,A06,752626,Zhao; Yizhen,0,0,0,0
1731501758608,MATH 10B,B01,752730,Zhao; Yizhen,0,0,0,0
1731501758608,MATH 10B,B02,752731,Zhao; Yizhen,0,0,0,0
1731501758608,MATH 10B,B03,752733,Zhao; Yizhen,0,0,0,0
1731501758608,MATH 10B,B04,752736,Zhao; Yizhen,0,0,0,0
1731501758608,MATH 10B,B05,796263,Zhao; Yizhen,0,0,0,0
1731501758608,MATH 10B,B06,796264,Zhao; Yizhen,0,0,0,0
1731501758608,MATH 10B,C01,752739,Goffer; Gil,0,0,0,0
1731501758608,MATH 10B,C02,752740,Goffer; Gil,0,0,0,0
1731501758608,MATH 10B,C03,752771,Goffer; Gil,0,0,0,0
1731501758608,MATH 10B,C04,752779,Goffer; Gil,0,0,0,0
1731501758608,MATH 10B,D01,752787,Buzaglo; Lucas,0,0,0,0
1731501758608,MATH 10B,D02,752793,Buzaglo; Lucas,0,0,0,0
1731501758608,MATH 10B,D03,752794,Buzaglo; Lucas,0,0,0,0
1731501758608,MATH 10B,D04,752800,Buzaglo; Lucas,0,0,0,0
1731501758608,MATH 10B,E01,752805,Bach; Quang Tran,0,0,0,0
1731501758608,MATH 10B,E02,752810,Bach; Quang Tran,0,0,0,0
1731501759635,MATH 10C,A01,752869,Nag; Panchali,32,0,32,0
1731501759635,MATH 10C,A02,752899,Nag; Panchali,29,0,32,3
1731501759635,MATH 10C,A03,752901,Nag; Panchali,32,0,32,0
1731501759635,MATH 10C,A04,752902,Nag; Panchali,32,0,32,0
1731501759635,MATH 10C,A05,752903,Nag; Panchali,32,0,32,0
1731501759635,MATH 10C,A06,752904,Nag; Panchali,31,0,32,1
1731501759635,MATH 10C,B01,752908,Nag; Panchali,11,0,27,16
1731501759635,MATH 10C,B02,752913,Nag; Panchali,28,0,30,2
1731501759635,MATH 10C,B03,752914,Nag; Panchali,28,0,30,2
1731501759635,MATH 10C,B04,752916,Nag; Panchali,28,0,30,2
1731501760664,MATH 11,A01,752921,Rava; Denise,35,0,36,1
1731501760664,MATH 11,A02,752922,Rava; Denise,29,0,36,7
1731501760664,MATH 11,A03,752924,Rava; Denise,34,0,36,2
1731501760664,MATH 11,A04,752932,Rava; Denise,36,0,36,0
1731501760664,MATH 11,A05,752936,Rava; Denise,35,0,36,1
1731501760664,MATH 11,A06,752984,Rava; Denise,35,0,36,1
1731501760664,MATH 11,B01,752988,Staff,29,0,35,6
1731501760664,MATH 11,B02,752991,Staff,33,0,35,2
1731501760664,MATH 11,B03,752994,Staff,54,0,56,2
1731501760664,MATH 11,B04,752998,Staff,60,0,60,0
1731501761694,MATH 18,A01,753003,Anzaldo; Leesa B,27,0,60,33
1731501761694,MATH 18,A02,753004,Anzaldo; Leesa B,53,0,60,7
1731501761694,MATH 18,A03,753005,Anzaldo; Leesa B,58,0,60,2
1731501761694,MATH 18,A04,753006,Anzaldo; Leesa B,59,0,60,1
1731501761694,MATH 18,A05,753009,Anzaldo; Leesa B,59,0,60,1
1731501761694,MATH 18,A06,753010,Anzaldo; Leesa B,60,0,60,0
1731501761694,MATH 18,A07,753011,Anzaldo; Leesa B,28,0,32,4
1731501761694,MATH 18,A08,753013,Anzaldo; Leesa B,20,0,22,2
1731501761694,MATH 18,A09,753014,Anzaldo; Leesa B,30,0,32,2
1731501761694,MATH 18,A10,753041,Anzaldo; Leesa B,32,0,32,0
1731501761694,MATH 18,A11,753066,Anzaldo; Leesa B,32,0,32,0
1731501761694,MATH 18,A12,753067,Anzaldo; Leesa B,30,0,32,2
1731501761694,MATH 18,B01,753070,Ganesan; Priyanga,96,0,100,4
1731501761694,MATH 18,B02,753071,Ganesan; Priyanga,99,0,100,1
1731501761694,MATH 18,C01,753074,Ganesan; Priyanga,39,0,45,6
1731501761694,MATH 18,C02,753075,Ganesan; Priyanga,44,0,45,1
1731501761694,MATH 18,C03,753076,Ganesan; Priyanga,44,0,45,1
1731501761694,MATH 18,C04,753077,Ganesan; Priyanga,45,0,45,0
1731501762723,MATH 20A,A01,753159,Ho; Ching Wei,29,0,30,1
1731501762723,MATH 20A,A02,753160,Ho; Ching Wei,10,0,26,16
1731501762723,MATH 20A,A03,753161,Ho; Ching Wei,27,0,30,3
1731501762723,MATH 20A,A04,753162,Ho; Ching Wei,29,0,30,1
1731501762723,MATH 20A,B01,753169,Ho; Ching Wei,55,0,60,5
1731501762723,MATH 20A,B02,753170,Ho; Ching Wei,56,0,60,4
1731501762723,MATH 20A,B03,753171,Ho; Ching Wei,34,0,35,1
1731501762723,MATH 20A,B04,753172,Ho; Ching Wei,35,0,35,0
1731501763773,MATH 20B,A01,753174,Habib; Yousaf,34,0,34,0
1731501763773,MATH 20B,A02,753175,Habib; Yousaf,33,0,34,1
1731501763773,MATH 20B,A03,753176,Habib; Yousaf,34,0,34,0
1731501763773,MATH 20B,A04,753177,Habib; Yousaf,34,0,34,0
1731501763773,MATH 20B,B01,753179,Habib; Yousaf,31,0,33,2
1731501763773,MATH 20B,B02,753180,Habib; Yousaf,33,0,33,0
1731501763773,MATH 20B,B03,753181,Habib; Yousaf,33,0,33,0
1731501763773,MATH 20B,B04,753188,Habib; Yousaf,33,0,33,0
1731501763773,MATH 20B,B05,753194,Habib; Yousaf,33,0,33,0
1731501763773,MATH 20B,B06,753195,Habib; Yousaf,33,0,33,0
1731501763773,MATH 20B,C01,753260,Upadrashta; Pranav Kumar,69,0,75,6
1731501763773,MATH 20B,C02,753261,Upadrashta; Pranav Kumar,75,0,75,0
1731501763773,MATH 20B,D01,753352,Upadrashta; Pranav Kumar,65,0,65,0
1731501763773,MATH 20B,D02,753356,Upadrashta; Pranav Kumar,65,0,65,0
1731501763773,MATH 20B,D03,753357,Upadrashta; Pranav Kumar,25,0,32,7
1731501763773,MATH 20B,D04,753361,Upadrashta; Pranav Kumar,31,0,32,1
1731501763773,MATH 20B,E01,753380,Xu; Fengmin,20,0,26,6
1731501763773,MATH 20B,E02,753384,Xu; Fengmin,30,0,32,2
1731501763773,MATH 20B,E03,753385,Xu; Fengmin,32,0,32,0
1731501763773,MATH 20B,E04,753388,Xu; Fengmin,31,0,32,1
1731501763773,MATH 20B,E05,753392,Xu; Fengmin,32,0,32,0
1731501763773,MATH 20B,E06,753393,Xu; Fengmin,32,0,32,0
1731501764804,MATH 20C,A01,753398,Ohm; Ko Woon,77,0,94,17
1731501764804,MATH 20C,A02,753402,Ohm; Ko Woon,98,0,100,2
1731501764804,MATH 20C,A03,753409,Ohm; Ko Woon,98,0,100,2
1731501764804,MATH 20C,A04,753412,Ohm; Ko Woon,100,0,100,0
1731501764804,MATH 20C,A05,753503,Ohm; Ko Woon,25,0,40,15
1731501764804,MATH 20C,A06,753504,Ohm; Ko Woon,35,0,40,5
1731501764804,MATH 20C,A07,753509,Ohm; Ko Woon,39,0,40,1
1731501764804,MATH 20C,A08,753510,Ohm; Ko Woon,40,0,40,0
1731501764804,MATH 20C,B01,753513,Staff,58,0,60,2
1731501764804,MATH 20C,B02,753514,Staff,60,0,60,0
1731501764804,MATH 20C,B03,753516,Staff,60,0,60,0
1731501764804,MATH 20C,C01,753518,Yin; Wei,59,0,60,1
1731501764804,MATH 20C,C02,753519,Yin; Wei,32,0,32,0
1731501764804,MATH 20C,C03,753520,Yin; Wei,24,0,32,8
1731501764804,MATH 20C,C04,753521,Yin; Wei,32,0,32,0
1731501764804,MATH 20C,C05,753524,Yin; Wei,32,0,32,0
1731501765844,MATH 20D,A01,753531,Staff,28,0,35,7
1731501765844,MATH 20D,A02,753532,Staff,28,0,29,1
1731501765844,MATH 20D,A03,753533,Staff,35,0,35,0
1731501765844,MATH 20D,A04,753535,Staff,35,0,35,0
1731501765844,MATH 20D,B01,753549,Hardiman; Liam,31,0,35,4
1731501765844,MATH 20D,B02,753592,Hardiman; Liam,35,0,35,0
1731501765844,MATH 20D,B03,753594,Hardiman; Liam,35,0,35,0
1731501765844,MATH 20D,B04,753595,Hardiman; Liam,34,0,35,1
1731501765844,MATH 20D,C01,753600,Gartland; Christopher John,96,0,100,4
1731501765844,MATH 20D,C02,753622,Gartland; Christopher John,98,0,100,2
1731501765844,MATH 20D,D01,753628,Gartland; Christopher John,35,0,35,0
1731501765844,MATH 20D,D02,753635,Gartland; Christopher John,35,0,35,0
1731501765844,MATH 20D,D03,753636,Gartland; Christopher John,60,0,60,0
1731501765844,MATH 20D,D04,753643,Gartland; Christopher John,60,0,60,0
1731501766874,MATH 20E,A01,753646,Bach; Quang Tran,24,0,32,8
1731501766874,MATH 20E,A02,753668,Bach; Quang Tran,33,0,35,2
1731501766874,MATH 20E,A03,753669,Bach; Quang Tran,35,0,35,0
1731501766874,MATH 20E,A04,753670,Bach; Quang Tran,35,0,35,0
1731501766874,MATH 20E,A05,753671,Bach; Quang Tran,30,0,30,0
1731501766874,MATH 20E,A06,753672,Bach; Quang Tran,30,0,30,0
1731501766874,MATH 20E,A07,796295,Bach; Quang Tran,60,0,60,0
1731501766874,MATH 20E,A08,796317,Bach; Quang Tran,60,0,60,0
1731501766874,MATH 20E,B01,753699,Sanchez; Anthony,30,0,35,5
1731501766874,MATH 20E,B02,753700,Sanchez; Anthony,35,0,35,0
1731501766874,MATH 20E,B03,753701,Sanchez; Anthony,64,0,65,1
1731501766874,MATH 20E,B04,753702,Sanchez; Anthony,65,0,65,0
1731501767902,MATH 31BH,A01,753704,De Vleming; Kristin Elizab,35,0,35,0
1731501767902,MATH 31BH,A02,753705,De Vleming; Kristin Elizab,35,0,35,0
1731501768930,MATH 87,A00,795962,Rabin; Jeffrey Mark,18,0,20,2
1731501769959,MATH 95,A00,753706,Stevens; Laura Jeanne,31,0,35,4
1731501770986,MATH 100A,A01,753708,Aycock; Jon Merrill,31,0,35,4
1731501770986,MATH 100A,A02,753709,Aycock; Jon Merrill,35,0,35,0
1731501772014,MATH 100B,A01,753711,Rogalski; Daniel,23,0,35,12
1731501772014,MATH 100B,A02,753712,Rogalski; Daniel,32,0,35,3
1731501773045,MATH 102,A01,753714,Harel; Guershon,34,0,35,1
1731501773045,MATH 102,A02,753740,Harel; Guershon,35,0,35,0
1731501773045,MATH 102,B01,753742,Ophir; Amit,32,0,35,3
1731501773045,MATH 102,B02,753743,Ophir; Amit,35,0,35,0
1731501774081,MATH 103A,A01,753745,Buzaglo; Lucas,26,0,30,4
1731501774081,MATH 103A,A02,753746,Buzaglo; Lucas,29,0,30,1
1731501774081,MATH 103A,B01,753748,Goffer; Gil,35,0,35,0
1731501774081,MATH 103A,B02,753749,Goffer; Gil,35,0,35,0
1731501774081,MATH 103A,C01,753751,Wenzl; Hans G,35,0,35,0
1731501774081,MATH 103A,C02,753798,Wenzl; Hans G,34,0,35,1
1731501775122,MATH 103B,A01,753805,Klevdal; Christian Sleek,29,0,30,1
1731501775122,MATH 103B,A02,753806,Klevdal; Christian Sleek,29,0,30,1
1731501775122,MATH 103B,A03,796050,Klevdal; Christian Sleek,26,0,30,4
1731501775122,MATH 103B,B01,753841,Wesley; William J,27,0,35,8
1731501775122,MATH 103B,B02,753842,Wesley; William J,34,0,35,1
1731501775122,MATH 103B,C01,753872,Chou; Raymond Oliver,20,0,35,15
1731501775122,MATH 103B,C02,753873,Chou; Raymond Oliver,31,0,35,4
1731501776149,MATH 104B,A01,753875,Kane; Daniel Mertz,35,0,35,0
1731501777181,MATH 109,A01,753883,Ganapathy; Karthik,7,0,10,3
1731501777181,MATH 109,A02,753884,Ganapathy; Karthik,9,0,10,1
1731501777181,MATH 109,B01,753886,Ganapathy; Karthik,9,0,10,1
1731501777181,MATH 109,B02,753887,Ganapathy; Karthik,10,0,10,0
1731501777181,MATH 109,C01,753901,Lu; Yunze,4,0,10,6
1731501777181,MATH 109,C02,753902,Lu; Yunze,10,0,10,0
1731501777181,MATH 109,D01,753912,Nandi; Achinta Kumar,10,0,10,0
1731501777181,MATH 109,D02,753928,Nandi; Achinta Kumar,9,0,10,1
1731501777181,MATH 109,E01,753935,Xiao; Ming,7,0,10,3
1731501777181,MATH 109,E02,753958,Xiao; Ming,0,0,10,10
1731501778207,MATH 111B,A01,753960,Meyer; David A.,28,0,35,7
1731501779241,MATH 112A,A01,754063,Komarova; Natalia,24,0,27,3
1731501780268,MATH 120A,A01,754070,Treuer; John N,30,0,35,5
1731501780268,MATH 120A,A02,754116,Treuer; John N,35,0,35,0
1731501781296,MATH 121A,A01,754119,Stevens; Laura Jeanne,32,0,35,3
1731501782323,MATH 140A,A01,754121,Sanchez; Anthony,30,0,35,5
1731501782323,MATH 140A,A02,754122,Sanchez; Anthony,32,0,35,3
1731501783350,MATH 140B,A01,754126,Zlatos; Andrej,34,0,35,1
1731501783350,MATH 140B,A02,754127,Zlatos; Andrej,35,0,35,0
1731501783350,MATH 140B,B01,754130,Lu; Yunze,33,0,35,2
1731501783350,MATH 140B,B02,754132,Lu; Yunze,33,0,35,2
1731501784384,MATH 142A,A01,754205,Parise; Davide,31,0,35,4
1731501784384,MATH 142A,A02,754206,Parise; Davide,33,0,35,2
1731501784384,MATH 142A,B01,754232,Kunnawalkam Elayavalli; Sr,33,0,35,2
1731501784384,MATH 142A,B02,754233,Kunnawalkam Elayavalli; Sr,35,0,35,0
1731501784384,MATH 142A,C01,754236,Nandi; Achinta Kumar,32,0,35,3
1731501784384,MATH 142A,C02,754238,Nandi; Achinta Kumar,33,0,35,2
1731501785421,MATH 142B,A01,754240,Bejenaru; Ioan,20,0,35,15
1731501785421,MATH 142B,A02,754241,Bejenaru; Ioan,30,0,35,5
1731501785421,MATH 142B,B01,754243,Sarkar; Pratyush,33,0,35,2
1731501785421,MATH 142B,B02,754244,Sarkar; Pratyush,34,0,35,1
1731501785421,MATH 142B,C01,754246,Sarkar; Pratyush,34,0,35,1
1731501785421,MATH 142B,C02,754247,Sarkar; Pratyush,35,0,35,0
1731501786451,MATH 150A,A01,754249,Rabin; Jeffrey Mark,27,0,35,8
1731501787482,MATH 154,A01,754252,Grier; Daniel T,32,0,35,3
1731501787482,MATH 154,A02,754254,Grier; Daniel T,34,0,35,1
1731501787482,MATH 154,A03,754255,Grier; Daniel T,35,0,35,0
1731501787482,MATH 154,A04,754256,Grier; Daniel T,35,0,35,0
1731501787482,MATH 154,B01,754258,Tesler; Glenn,30,0,35,5
1731501787482,MATH 154,B02,754259,Tesler; Glenn,35,0,35,0
1731501787482,MATH 154,B03,754261,Tesler; Glenn,33,0,35,2
1731501787482,MATH 154,B04,754262,Tesler; Glenn,35,0,35,0
1731501788510,MATH 170A,A01,754266,Dumitriu; Ioana,26,0,35,9
1731501788510,MATH 170A,A02,754267,Dumitriu; Ioana,33,0,35,2
1731501788510,MATH 170A,A03,754268,Dumitriu; Ioana,34,0,35,1
1731501788510,MATH 170A,A04,754269,Dumitriu; Ioana,35,0,35,0
1731501788510,MATH 170A,B01,754271,Dumitriu; Ioana,35,0,35,0
1731501788510,MATH 170A,B02,754273,Dumitriu; Ioana,34,0,35,1
1731501788510,MATH 170A,B03,754275,Dumitriu; Ioana,32,0,35,3
1731501788510,MATH 170A,B04,754276,Dumitriu; Ioana,34,0,35,1
1731501789544,MATH 170B,A01,754278,Dixit; Rishabh,25,0,35,10
1731501789544,MATH 170B,A02,754336,Dixit; Rishabh,34,0,35,1
1731501789544,MATH 170B,A03,754337,Dixit; Rishabh,34,0,35,1
1731501789544,MATH 170B,A04,754339,Dixit; Rishabh,35,0,35,0
1731501790580,MATH 171A,A01,754341,Huang; Lei,21,0,35,14
1731501790580,MATH 171A,A02,754342,Huang; Lei,27,0,35,8
1731501790580,MATH 171A,A03,754343,Huang; Lei,33,0,35,2
1731501790580,MATH 171A,A04,754345,Huang; Lei,32,0,35,3
1731501791608,MATH 173B,A01,754350,Saab; Rayan,24,0,35,11
1731501791608,MATH 173B,A02,754351,Saab; Rayan,22,0,35,13
1731501791608,MATH 173B,A03,754352,Saab; Rayan,34,0,35,1
1731501791608,MATH 173B,A04,754354,Saab; Rayan,34,0,35,1
1731501792643,MATH 175,A01,754357,Briones; Jor-el Thomas Caparas,23,0,25,2
1731501793689,MATH 180A,A01,754360,Peca-Medlin; John Michael,27,0,30,3
1731501793689,MATH 180A,A02,754362,Peca-Medlin; John Michael,30,0,30,0
1731501793689,MATH 180A,A03,754363,Peca-Medlin; John Michael,35,0,35,0
1731501793689,MATH 180A,A04,754367,Peca-Medlin; John Michael,35,0,35,0
1731501793689,MATH 180A,B01,754372,Schweinsberg; Jason,29,0,30,1
1731501793689,MATH 180A,B02,754374,Schweinsberg; Jason,30,0,30,0
1731501793689,MATH 180A,B03,754376,Schweinsberg; Jason,28,0,30,2
1731501793689,MATH 180A,B04,754377,Schweinsberg; Jason,28,0,30,2
1731501793689,MATH 180A,B05,754380,Schweinsberg; Jason,29,0,30,1
1731501793689,MATH 180A,B06,754421,Schweinsberg; Jason,30,0,30,0
1731501794718,MATH 180B,A01,754423,Zheng; Tianyi,27,0,30,3
1731501794718,MATH 180B,A02,754424,Zheng; Tianyi,29,0,30,1
1731501794718,MATH 180B,A03,754425,Zheng; Tianyi,29,0,30,1
1731501794718,MATH 180B,A04,754426,Zheng; Tianyi,30,0,30,0
1731501794718,MATH 180B,B01,754428,Zheng; Tianyi,32,0,35,3
1731501794718,MATH 180B,B02,754429,Zheng; Tianyi,35,0,35,0
1731501794718,MATH 180B,B03,754438,Zheng; Tianyi,35,0,35,0
1731501794718,MATH 180B,B04,754452,Zheng; Tianyi,34,0,35,1
1731501795748,MATH 181A,A01,754454,Quarfoot; David James,27,0,30,3
1731501795748,MATH 181A,A02,754455,Quarfoot; David James,30,0,30,0
1731501795748,MATH 181A,A03,754456,Quarfoot; David James,28,0,30,2
1731501795748,MATH 181A,A04,754457,Quarfoot; David James,29,0,30,1
1731501795748,MATH 181A,B01,754459,Quarfoot; David James,23,0,30,7
1731501795748,MATH 181A,B02,754460,Quarfoot; David James,29,0,30,1
1731501795748,MATH 181A,B03,754461,Quarfoot; David James,26,0,30,4
1731501795748,MATH 181A,B04,754462,Quarfoot; David James,30,0,30,0
1731501796776,MATH 181E,A01,754465,Politis; Dimitris,23,0,35,12
1731501796776,MATH 181E,A02,754466,Politis; Dimitris,32,0,35,3
1731501797803,MATH 183,A01,754468,Vishwanath; Siddharth,9,0,10,1
1731501797803,MATH 183,A02,754469,Vishwanath; Siddharth,3,0,10,7
1731501797803,MATH 183,A03,754470,Vishwanath; Siddharth,0,0,10,10
1731501797803,MATH 183,A04,754473,Vishwanath; Siddharth,8,0,10,2
1731501798836,MATH 184,A01,754527,Chou; Raymond Oliver,28,0,35,7
1731501798836,MATH 184,A02,754529,Chou; Raymond Oliver,33,0,35,2
1731501798836,MATH 184,A03,754532,Chou; Raymond Oliver,35,0,35,0
1731501798836,MATH 184,A04,754534,Chou; Raymond Oliver,35,0,35,0
1731501799865,MATH 185,A01,754537,Rava; Denise,29,0,35,6
1731501799865,MATH 185,A02,754559,Rava; Denise,29,0,35,6
1731501800896,MATH 186,A01,754624,Tesler; Glenn,21,0,33,12
1731501800896,MATH 186,A02,754625,Tesler; Glenn,26,0,33,7
1731501800896,MATH 186,A03,754626,Tesler; Glenn,18,0,33,15
1731501801926,MATH 187A,A01,754628,Bucur; Alina Ioana,11,0,30,19
1731501801926,MATH 187A,A02,754641,Bucur; Alina Ioana,29,0,30,1
1731501801926,MATH 187A,A03,754650,Bucur; Alina Ioana,25,0,30,5
1731501801926,MATH 187A,A04,754654,Bucur; Alina Ioana,28,0,30,2
1731501801926,MATH 187A,A05,754658,Bucur; Alina Ioana,26,0,30,4
1731501801926,MATH 187A,A06,754664,Bucur; Alina Ioana,29,0,30,1
1731501802957,MATH 189,A01,754672,Vishwanath; Siddharth,0,0,10,10
1731501802957,MATH 189,A02,754679,Vishwanath; Siddharth,0,0,10,10
1731501802957,MATH 189,A03,754681,Vishwanath; Siddharth,0,0,10,10
1731501802957,MATH 189,A04,754690,Vishwanath; Siddharth,0,0,10,10
1731501802957,MATH 189,A05,754694,Vishwanath; Siddharth,0,0,10,10
1731501802957,MATH 189,A06,754696,Vishwanath; Siddharth,0,0,10,10
1731501803985,MATH 190A,A01,754709,McKernan; James,25,0,35,10
1731501805011,MATH 196,A00,795968,Sorensen; Claus M,34,0,40,6
1731501806043,MATH 200B,A00,754711,Salehi Golsefidy; Alireza,18,0,20,2
1731501807075,MATH 202B,A00,754712,Novak; Jonathan I,16,0,20,4
1731501808106,MATH 203B,A00,754713,Oprea; Dragos N.,20,0,20,0
1731501809138,MATH 204B,A00,754715,Kedlaya; Kiran S.,20,0,20,0
1731501810165,MATH 207A,A00,754716,Mohammadi; Amir,17,0,20,3
1731501811194,MATH 208,A00,754718,Oprea; Dragos N.,10,0,10,0
1731501812221,MATH 209,A00,754719,Bucur; Alina Ioana,10,0,10,0
1731501813249,MATH 211A,A00,754720,Salehi Golsefidy; Alireza,9,0,10,1
1731501814276,MATH 211B,A00,754722,Sanchez; Anthony,10,0,10,0
1731501815305,MATH 212A,A01,754725,Komarova; Natalia,0,0,5,5
1731501816332,MATH 216B,A00,754727,Saab; Rayan,14,0,20,6
1731501817361,MATH 218,A00,754729,Komarova; Natalia,10,0,10,0
1731501818392,MATH 220B,A00,754730,Xiao; Ming,16,0,20,4
1731501819417,MATH 231B,A00,754731,Zlatos; Andrej,20,0,20,0
1731501820445,MATH 240B,A00,754733,Spolaor; Luca,18,0,20,2
1731501821472,MATH 243,A00,754734,Kunnawalkam Elayavalli; Sr,10,0,10,0
1731501822502,MATH 247A,A00,754736,Frisch; Joshua R,25,0,25,0
1731501823529,MATH 248,A00,754738,Bejenaru; Ioan,10,0,10,0
1731501824562,MATH 250B,A00,754740,Ni; Lei,17,0,20,3
1731501825590,MATH 257A,A00,754741,Spolaor; Luca,18,0,20,2
1731501825590,MATH 257A,B00,754742,Roberts; Justin Deritter,18,0,20,2
1731501826618,MATH 258,A00,754743,Ni; Lei,10,0,10,0
1731501827644,MATH 264B,A00,754745,Rhoades; Brendon Patrick,19,0,20,1
1731501828671,MATH 269,A00,754749,Warnke; Lutz Peter,10,0,10,0
1731501829703,MATH 270B,A00,754750,Leok; Melvin,13,0,20,7
1731501830737,MATH 271B,A00,754752,Nie; Jiawang,15,0,20,5
1731501831764,MATH 272B,A00,754754,Miller; Pearson,19,0,20,1
1731501832791,MATH 275,A01,754757,Briones; Jor-el Thomas Caparas,8,0,10,2
1731501833825,MATH 277A,A00,754763,Ding; Lijun,24,0,25,1
1731501833825,MATH 277A,B00,795972,Patil; Vishal Prakash,16,0,20,4
1731501834852,MATH 278A,A00,754765,Cheng; Li-Tien,10,0,10,0
1731501835881,MATH 278B,A00,754768,Cloninger; Alexander,9,0,10,1
1731501836909,MATH 278C,A00,754770,Nie; Jiawang,10,0,10,0
1731501837940,MATH 280B,A00,754780,Kemp; Todd Aahron,15,0,20,5
1731501838972,MATH 281B,A00,754788,Bradic; Jelena,1,0,20,19
1731501840000,MATH 282B,A00,754796,Arias-Castro; Ery,6,0,20,14
1731501841028,MATH 288,A00,754800,Ang; Jie Jun,10,0,10,0
1731501842054,MATH 290B,A00,754801,Sorensen; Claus M,19,0,20,1
1731501843084,MATH 292,A00,754802,Lu; Yunze,9,0,10,1
1731501844114,MATH 295,A00,754804,Bejenaru; Ioan,15,0,15,0
1731501845140,MATH 297,001,754807,Gamst; Anthony Collins,0,0,0,0
1731501846169,MATS 200,A00,751610,Graeve; Olivia A,9976,0,9999,23
1731501847200,MATS 201A,A00,751611,Luo; Jian,19,0,55,36
1731501848227,MATS 231,A00,751612,Cai; Shengqiang,14,0,25,11
1731501849255,MATS 255,A00,751613,Meyers; Marc,3,0,20,17
1731501850286,MATS 261A,A00,751614,Qiao; Yu,17,0,25,8
1731501851316,MATS 295,A00,751660,Graeve; Olivia A,9999,0,9999,0
1731501852343,MATS 296,A00,751661,Kim; Hyonny,9999,0,9999,0
1731501852343,MATS 296,B00,751665,Bandaru; Prabhakar,9999,0,9999,0
1731501853368,MBC 259,A00,799573,Murray; Samantha J.,2,0,26,24
1731501854398,MCWP 40,001,755308,Wastal; Carrie King,15,0,15,0
1731501854398,MCWP 40,002,755309,Wastal; Carrie King,15,0,15,0
1731501854398,MCWP 40,003,755310,Montejo; Carolina,20,0,20,0
1731501854398,MCWP 40,006,755313,Duru; Nur,15,0,20,5
1731501854398,MCWP 40,007,755316,Duru; Nur,19,0,20,1
1731501854398,MCWP 40,008,755317,Duru; Nur,20,0,20,0
1731501854398,MCWP 40,012,755322,Wastal; Carrie King,15,0,15,0
1731501854398,MCWP 40,013,755323,Wastal; Carrie King,14,0,15,1
1731501854398,MCWP 40,017,755327,Bartulis; Jason Michael,11,0,20,9
1731501854398,MCWP 40,018,755328,Bartulis; Jason Michael,15,0,20,5
1731501854398,MCWP 40,019,755329,Bartulis; Jason Michael,15,0,20,5
1731501855454,MCWP 50,001,755330,Wastal; Carrie King,10,0,15,5
1731501855454,MCWP 50,002,755331,Redela; Pamela Morgan,20,0,20,0
1731501855454,MCWP 50,003,755332,Redela; Pamela Morgan,18,0,20,2
1731501855454,MCWP 50,004,755333,Redela; Pamela Morgan,18,0,20,2
1731501855454,MCWP 50,005,755334,Compas; Sean Matthew,14,0,20,6
1731501855454,MCWP 50,006,755335,Compas; Sean Matthew,17,0,20,3
1731501855454,MCWP 50,007,755336,Compas; Sean Matthew,17,0,20,3
1731501855454,MCWP 50,008,755337,Carter; Andrea L,19,0,20,1
1731501855454,MCWP 50,009,755338,Carter; Andrea L,20,0,20,0
1731501855454,MCWP 50,010,755339,Carter; Andrea L,20,0,20,0
1731501855454,MCWP 50,011,755340,Smith; Haydee Marie,16,0,20,4
1731501855454,MCWP 50,012,755341,Smith; Haydee Marie,17,0,20,3
1731501855454,MCWP 50,013,755342,Smith; Haydee Marie,20,0,20,0
1731501855454,MCWP 50,014,755344,Pham; Vincent Minhduc,20,0,20,0
1731501855454,MCWP 50,015,755345,Pham; Vincent Minhduc,20,0,20,0
1731501855454,MCWP 50,016,755346,Pham; Vincent Minhduc,20,0,20,0
1731501855454,MCWP 50,017,755347,Morshed; Michael James,13,0,20,7
1731501855454,MCWP 50,018,755382,Silva; Kelly B,20,0,20,0
1731501855454,MCWP 50,019,755685,Silva; Kelly B,20,0,20,0
1731501855454,MCWP 50,020,755686,Carter; Jennifer A,19,0,20,1
1731501855454,MCWP 50,021,755687,Carter; Jennifer A,20,0,20,0
1731501855454,MCWP 50,022,755688,Carter; Jennifer A,18,0,20,2
1731501855454,MCWP 50,024,755694,Nies; Laurie Elizabeth,16,0,20,4
1731501855454,MCWP 50,025,755695,Nies; Laurie Elizabeth,15,0,20,5
1731501855454,MCWP 50,026,755704,Krone; Jarret,17,0,20,3
1731501855454,MCWP 50,027,755711,Krone; Jarret,19,0,20,1
1731501855454,MCWP 50,028,755739,Krone; Jarret,18,0,20,2
1731501855454,MCWP 50,031,755747,Morshed; Michael James,17,0,20,3
1731501855454,MCWP 50,032,755748,Morshed; Michael James,8,0,20,12
1731501856485,MCWP 125,A00,755868,Guillen; Melinda,15,0,20,5
1731501856485,MCWP 125,B00,755870,Guillen; Melinda,8,0,20,12
1731501857513,MCWP 125R,A00,755873,Miller; Elizabeth Deen,13,0,20,7
1731501857513,MCWP 125R,B00,755874,Miller; Elizabeth Deen,18,0,20,2
1731501857513,MCWP 125R,C00,795037,Miller; Elizabeth Deen,19,0,20,1
1731501858546,MED 238,A00,755306,Chen; Ju & Sun; Wei & Shyy; Yeun-Jund & Sheikh; Farah & Ross; Robert Scott & King; Kevin R & Evans; Sylvia M & Cho; Yoshitake,5,0,10,5
1731501859577,MED 246,A00,796576,Gordts; Philip & Lewis; Amanda Lark & Godula; Kamil & Gagneux; Pascal & Esko; Jeffrey D. & Bode; Lars,10,0,10,0
1731501860605,MED 262,A00,796570,Koola; Jejo David,24,0,30,6
1731501861633,MED 263,A00,796550,Curtius; Kathleen Mary & D'Antonio; Matteo,1,0,18,17
1731501862664,MED 278,A00,796573,Carter; Hannah Kathryn,10,0,15,5
1731501863696,MED 283,A00,755307,Ideker; Trey,0,0,0,0
1731501864734,MED 296,001,791666,Malinak; David James,9,0,10,1
1731501864734,MED 296,002,791667,Von Drygalski; Annette,9,0,10,1
1731501864734,MED 296,003,791668,Chi; Neil C.,8,0,10,2
1731501864734,MED 296,004,791670,Castellanos; Luis R.,9,0,10,1
1731501865762,MGT 3,A00,766229,Wagner; Timothy Ryan,95,0,98,3
1731501866791,MGT 4,A01,766234,Levkoff; Steven B.,4,0,8,4
1731501866791,MGT 4,A02,766235,Levkoff; Steven B.,6,0,8,2
1731501866791,MGT 4,A03,766273,Levkoff; Steven B.,8,0,9,1
1731501866791,MGT 4,B01,798342,Brooks; Marcus Raymond,31,0,32,1
1731501867823,MGT 5,A00,766275,Molloie Jr.; William H,181,0,186,5
1731501868850,MGT 12,A00,766277,Pecore; Joseph P.,72,0,100,28
1731501869882,MGT 16,A00,766279,Buchanan; Harold G,97,0,100,3
1731501869882,MGT 16,B00,766282,Buchanan; Harold G,96,0,100,4
1731501869882,MGT 16,C00,766285,Campbell; Robert Harold,117,0,120,3
1731501869882,MGT 16,D00,766288,Campbell; Robert Harold,119,0,120,1
1731501869882,MGT 16,E00,766290,Demill; Burritt,98,0,98,0
1731501869882,MGT 16,F00,766291,Lindenberger; Wade Douglas,85,0,100,15
1731501870923,MGT 18,A00,766299,McKay; Michael J,97,0,98,1
1731501870923,MGT 18,B00,766308,McKay; Michael J,93,0,98,5
1731501870923,MGT 18,C00,766310,McKay; Michael J,96,0,98,2
1731501870923,MGT 18,D00,766311,Chamberlain; Travis Dean,97,0,98,1
1731501871950,MGT 45,A00,766315,Pecore; Joseph P.,141,0,150,9
1731501871950,MGT 45,B00,766322,Pecore; Joseph P.,148,0,150,2
1731501872980,MGT 52,A00,766324,Deal; Jennifer Jean,89,0,98,9
1731501874008,MGT 71R,A00,766325,Phiroz; Zal Navroze,66,0,98,32
1731501875053,MGT 100,A00,766328,Yavorsky; Daniel Ryan,107,0,120,13
1731501875053,MGT 100,B00,796601,Yavorsky; Daniel Ryan,111,0,120,9
1731501876089,MGT 103,A00,766334,Bates; Kenneth Walter,91,0,98,7
1731501876089,MGT 103,C00,766338,Eberhard; Craig A,98,0,98,0
1731501876089,MGT 103,D00,766341,Eberhard; Craig A,96,0,98,2
1731501876089,MGT 103,E00,766343,Ehrich; Kristine R,92,0,98,6
1731501876089,MGT 103,F00,766344,Ehrich; Kristine R,93,0,98,5
1731501876089,MGT 103,G00,766604,Ehrich; Kristine R,97,0,98,1
1731501877115,MGT 105,A00,796605,Bates; Kenneth Walter,91,0,98,7
1731501878142,MGT 106,A00,766605,Eberhard; Craig A,96,0,98,2
1731501879175,MGT 107,A00,766688,Jaroszewicz; Ania,97,0,98,1
1731501879175,MGT 107,B00,766721,Jaroszewicz; Ania,80,0,98,18
1731501879175,MGT 107,C00,796609,Jaroszewicz; Ania,93,0,98,5
1731501880205,MGT 109,A00,766779,Staff,88,0,98,10
1731501881240,MGT 112,A00,766780,Somasundaram; Tyagarajan,52,0,60,8
1731501881240,MGT 112,B00,766781,Somasundaram; Tyagarajan,54,0,70,16
1731501882273,MGT 119,A00,766782,Etingue Kum; Menes,96,0,98,2
1731501883302,MGT 121A,A00,766783,Klaas; Jeffrey David,92,0,98,6
1731501884334,MGT 123,A00,796610,Felke; Magnus Roland,97,0,98,1
1731501885365,MGT 127R,A00,766784,Zhu; Kevin Xiaoguo,68,0,80,12
1731501886393,MGT 131A,A00,766802,Houskeeper; Robert,148,0,150,2
1731501887421,MGT 131B,A00,766833,Houskeeper; Robert,96,0,98,2
1731501888450,MGT 135,A00,766882,Anderson; John Charles,74,0,75,1
1731501889479,MGT 136,A00,766883,Lindenberger; Wade Douglas,90,0,98,8
1731501890507,MGT 137,A00,766893,Perez Cavazos; Gerardo,81,0,98,17
1731501891540,MGT 151R,A00,766954,Phiroz; Zal Navroze,92,0,98,6
1731501891540,MGT 151R,B00,766998,Phiroz; Zal Navroze,97,0,98,1
1731501892626,MGT 153,A00,766999,Perols; Johan Lars,57,0,90,33
1731501893654,MGT 160,A00,767000,Samek; Anya,87,0,90,3
1731501893654,MGT 160,B00,767001,Samek; Anya,74,0,90,16
1731501893654,MGT 160,C00,767038,Samek; Anya,86,0,90,4
1731501894692,MGT 162,A00,767085,Demill; Burritt,96,0,98,2
1731501894692,MGT 162,B00,767086,Demill; Burritt,92,0,98,6
1731501895719,MGT 162R,A00,767087,Gneezy; Uri,180,0,199,19
1731501896747,MGT 164,A00,767088,McKay; Mary A,97,0,98,1
1731501896747,MGT 164,B00,767089,McKay; Mary A,98,0,98,0
1731501896747,MGT 164,C00,767095,McKay; Mary A,96,0,98,2
1731501896747,MGT 164,D00,767097,Meyer; Alison Bloomfield,95,0,98,3
1731501896747,MGT 164,E00,767104,Smith; Pamela Karen,84,0,98,14
1731501897781,MGT 166,A00,767106,Moran; Cathleen L.,57,0,60,3
1731501897781,MGT 166,B00,767107,Moran; Cathleen L.,96,0,98,2
1731501897781,MGT 166,C00,767110,Moran; Cathleen L.,97,0,98,1
1731501898811,MGT 167,A00,767114,Jacob; Jo Dee C,97,0,98,1
1731501899842,MGT 172,A00,767115,Hedges; Kathleen & Royal; Rebecca,118,0,120,2
1731501899842,MGT 172,B00,767118,Hedges; Kathleen,94,0,98,4
1731501899842,MGT 172,C00,767121,Zimmermann; Carsten,98,0,98,0
1731501899842,MGT 172,D00,767124,Zimmermann; Carsten,97,0,98,1
1731501900870,MGT 173,A00,767130,Hayes; Sherry Lorine,91,0,98,7
1731501900870,MGT 173,B00,767135,Hayes; Sherry Lorine,97,0,98,1
1731501901903,MGT 175,A00,767137,Gopal; Christopher S.,97,0,98,1
1731501902932,MGT 176,A00,767139,Gopal; Christopher S.,89,0,98,9
1731501903965,MGT 180R,A00,767140,Engelberg; Joseph Edward,287,0,300,13
1731501904998,MGT 181,A00,767145,Bliss; Barbara Ann,83,0,98,15
1731501904998,MGT 181,B00,767155,Buchanan; Harold G,109,0,120,11
1731501906030,MGT 187,A00,767157,Dunn; Louis Jean,93,0,98,5
1731501906030,MGT 187,B00,767194,Dunn; Louis Jean,92,0,98,6
1731501907080,MGT 189,A00,767242,Dunn; Louis Jean,91,0,98,7
1731501907080,MGT 189,B00,767281,Reher; Michael Christopher,84,0,98,14
1731501908109,MGT 241,A00,770734,Staff,0,0,0,0
1731501909145,MGT 249,A00,767282,August; Terrence & Shin; Hyo Duk & Erat; Sanjiv,19,0,20,1
1731501910173,MGT 256,A00,767296,Liu; Wei,0,0,0,3
1731501911200,MGT 259,A00,767311,Smith; Pamela Karen,17,0,20,3
1731501912245,MGT 296,001,795366,Gneezy; Ayelet,3,0,3,0
1731501912245,MGT 296,002,795367,Amir; On,3,0,3,0
1731501912245,MGT 296,003,795368,Amir; On & Karmarkar; Uma R,2,0,3,1
1731501912245,MGT 296,004,795373,Liu; Jun,3,0,3,0
1731501912245,MGT 296,005,795374,Hansen; Karsten T.,2,0,3,1
1731501912245,MGT 296,006,795376,Erat; Sanjiv,2,0,3,1
1731501912245,MGT 296,007,795377,Timmermann; Allan,1,0,3,2
1731501912245,MGT 296,008,795378,Smith; Pamela Karen,3,0,3,0
1731501912245,MGT 296,009,795380,Zhang; Zhe,3,0,3,0
1731501912245,MGT 296,010,795381,Oveis; Christopher S,3,0,3,0
1731501912245,MGT 296,011,795384,Amir; On & Gneezy; Ayelet,3,0,3,0
1731501912245,MGT 296,012,795385,Luo; Danqi,3,0,3,0
1731501913304,MMW 12,A01,750828,Chang; Edmond Yi-Teh,16,0,16,0
1731501913304,MMW 12,A02,750829,Chang; Edmond Yi-Teh,16,0,16,0
1731501913304,MMW 12,A03,750830,Chang; Edmond Yi-Teh,15,0,16,1
1731501913304,MMW 12,A04,750863,Chang; Edmond Yi-Teh,15,0,16,1
1731501913304,MMW 12,A05,750864,Chang; Edmond Yi-Teh,16,0,16,0
1731501913304,MMW 12,A06,750870,Chang; Edmond Yi-Teh,16,0,16,0
1731501913304,MMW 12,A07,750874,Chang; Edmond Yi-Teh,16,0,16,0
1731501913304,MMW 12,A08,750877,Chang; Edmond Yi-Teh,16,0,16,0
1731501913304,MMW 12,A09,750882,Chang; Edmond Yi-Teh,16,0,16,0
1731501913304,MMW 12,A10,750884,Chang; Edmond Yi-Teh,16,0,16,0
1731501913304,MMW 12,A11,750890,Chang; Edmond Yi-Teh,16,0,16,0
1731501913304,MMW 12,A12,750891,Chang; Edmond Yi-Teh,16,0,16,0
1731501913304,MMW 12,A13,750892,Chang; Edmond Yi-Teh,16,0,16,0
1731501913304,MMW 12,A14,750940,Chang; Edmond Yi-Teh,16,0,16,0
1731501913304,MMW 12,A15,750951,Chang; Edmond Yi-Teh,0,0,0,0
1731501913304,MMW 12,A16,750957,Chang; Edmond Yi-Teh,0,0,0,0
1731501913304,MMW 12,A17,750967,Chang; Edmond Yi-Teh,16,0,16,0
1731501913304,MMW 12,A18,750976,Chang; Edmond Yi-Teh,16,0,16,0
1731501913304,MMW 12,A19,750977,Chang; Edmond Yi-Teh,16,0,16,0
1731501913304,MMW 12,A20,750980,Chang; Edmond Yi-Teh,16,0,16,0
1731501913304,MMW 12,A21,750981,Chang; Edmond Yi-Teh,16,0,16,0
1731501913304,MMW 12,A22,751031,Chang; Edmond Yi-Teh,16,0,16,0
1731501913304,MMW 12,A23,751032,Chang; Edmond Yi-Teh,0,0,0,0
1731501913304,MMW 12,B01,751035,Adamiak; Patrick John,15,0,16,1
1731501913304,MMW 12,B02,751065,Adamiak; Patrick John,14,0,16,2
1731501913304,MMW 12,B03,751066,Adamiak; Patrick John,16,0,16,0
1731501913304,MMW 12,B04,751067,Adamiak; Patrick John,16,0,16,0
1731501913304,MMW 12,B05,751068,Adamiak; Patrick John,16,0,16,0
1731501913304,MMW 12,B06,751069,Adamiak; Patrick John,16,0,16,0
1731501913304,MMW 12,B07,751070,Adamiak; Patrick John,16,0,16,0
1731501913304,MMW 12,B08,751071,Adamiak; Patrick John,16,0,16,0
1731501913304,MMW 12,B09,751072,Adamiak; Patrick John,15,0,16,1
1731501913304,MMW 12,B10,751073,Adamiak; Patrick John,16,0,16,0
1731501913304,MMW 12,B11,751074,Adamiak; Patrick John,16,0,16,0
1731501913304,MMW 12,B12,751075,Adamiak; Patrick John,16,0,16,0
1731501913304,MMW 12,B13,751076,Adamiak; Patrick John,16,0,16,0
1731501913304,MMW 12,B14,751077,Adamiak; Patrick John,16,0,16,0
1731501913304,MMW 12,B15,751078,Adamiak; Patrick John,0,0,0,0
1731501913304,MMW 12,B16,751079,Adamiak; Patrick John,0,0,0,0
1731501913304,MMW 12,B17,751080,Adamiak; Patrick John,15,0,16,1
1731501913304,MMW 12,B18,751081,Adamiak; Patrick John,16,0,16,0
1731501913304,MMW 12,B19,751082,Adamiak; Patrick John,16,0,16,0
1731501913304,MMW 12,B20,751083,Adamiak; Patrick John,16,0,16,0
1731501913304,MMW 12,B21,751084,Adamiak; Patrick John,15,0,16,1
1731501913304,MMW 12,B22,751085,Adamiak; Patrick John,15,0,16,1
1731501913304,MMW 12,C01,751087,Herbst; Matthew,16,0,16,0
1731501913304,MMW 12,C02,751088,Herbst; Matthew,16,0,16,0
1731501913304,MMW 12,C03,751090,Herbst; Matthew,16,0,16,0
1731501913304,MMW 12,C04,751091,Herbst; Matthew,16,0,16,0
1731501913304,MMW 12,C05,751092,Herbst; Matthew,14,0,16,2
1731501913304,MMW 12,C06,751093,Herbst; Matthew,16,0,16,0
1731501913304,MMW 12,C07,751094,Herbst; Matthew,15,0,16,1
1731501913304,MMW 12,C08,751096,Herbst; Matthew,16,0,16,0
1731501913304,MMW 12,C09,751097,Herbst; Matthew,16,0,16,0
1731501913304,MMW 12,C10,751098,Herbst; Matthew,15,0,16,1
1731501913304,MMW 12,C11,751099,Herbst; Matthew,16,0,16,0
1731501913304,MMW 12,C12,751100,Herbst; Matthew,16,0,16,0
1731501913304,MMW 12,C13,751101,Herbst; Matthew,15,0,16,1
1731501913304,MMW 12,C14,751102,Herbst; Matthew,16,0,16,0
1731501913304,MMW 12,C15,751103,Herbst; Matthew,0,0,0,0
1731501913304,MMW 12,C16,751105,Herbst; Matthew,0,0,0,0
1731501913304,MMW 12,C17,751106,Herbst; Matthew,16,0,16,0
1731501913304,MMW 12,C18,751107,Herbst; Matthew,16,0,16,0
1731501913304,MMW 12,C19,751108,Herbst; Matthew,16,0,16,0
1731501913304,MMW 12,C20,751110,Herbst; Matthew,16,0,16,0
1731501913304,MMW 12,C21,751112,Herbst; Matthew,0,0,0,0
1731501913304,MMW 12,C22,751113,Herbst; Matthew,0,0,0,0
1731501914354,MMW 14,A01,751190,Chang; Edmond Yi-Teh,25,0,28,3
1731501914354,MMW 14,A02,751227,Chang; Edmond Yi-Teh,27,0,28,1
1731501914354,MMW 14,A03,751235,Chang; Edmond Yi-Teh,0,0,0,0
1731501914354,MMW 14,A04,751248,Chang; Edmond Yi-Teh,0,0,0,0
1731501914354,MMW 14,A05,751249,Chang; Edmond Yi-Teh,27,0,28,1
1731501914354,MMW 14,A06,751253,Chang; Edmond Yi-Teh,25,0,28,3
1731501914354,MMW 14,B01,751265,Hertz; Deborah,24,0,28,4
1731501914354,MMW 14,B02,751266,Hertz; Deborah,22,0,28,6
1731501914354,MMW 14,B03,751267,Hertz; Deborah,0,0,0,0
1731501914354,MMW 14,B04,751270,Hertz; Deborah,24,0,28,4
1731501914354,MMW 14,B05,751273,Hertz; Deborah,28,0,28,0
1731501914354,MMW 14,C01,751386,Herbst; Matthew,0,0,0,0
1731501915394,MMW 122,A01,751389,Peterson; Johanna L,23,0,27,4
1731501915394,MMW 122,A02,751424,Peterson; Johanna L,25,0,27,2
1731501915394,MMW 122,A03,751435,Peterson; Johanna L,27,0,27,0
1731501915394,MMW 122,A04,751437,Peterson; Johanna L,27,0,27,0
1731501915394,MMW 122,A05,751438,Peterson; Johanna L,27,0,27,0
1731501915394,MMW 122,A06,751440,Peterson; Johanna L,27,0,27,0
1731501915394,MMW 122,A07,751441,Peterson; Johanna L,0,0,0,0
1731501915394,MMW 122,A08,751442,Peterson; Johanna L,0,0,0,0
1731501915394,MMW 122,A09,751443,Peterson; Johanna L,27,0,27,0
1731501915394,MMW 122,A10,751444,Peterson; Johanna L,26,0,27,1
1731501915394,MMW 122,A11,751448,Peterson; Johanna L,0,0,0,0
1731501915394,MMW 122,A12,751493,Peterson; Johanna L,0,0,0,0
1731501915394,MMW 122,B01,751497,Rahimi; Babak,26,0,27,1
1731501915394,MMW 122,B02,751501,Rahimi; Babak,25,0,27,2
1731501915394,MMW 122,B03,751504,Rahimi; Babak,26,0,27,1
1731501915394,MMW 122,B04,751505,Rahimi; Babak,27,0,27,0
1731501915394,MMW 122,B05,751526,Rahimi; Babak,22,0,27,5
1731501915394,MMW 122,B06,751528,Rahimi; Babak,27,0,27,0
1731501915394,MMW 122,B07,751531,Rahimi; Babak,26,0,27,1
1731501915394,MMW 122,B08,751533,Rahimi; Babak,26,0,27,1
1731501915394,MMW 122,B09,751534,Rahimi; Babak,0,0,0,0
1731501915394,MMW 122,B10,751535,Rahimi; Babak,0,0,0,0
1731501915394,MMW 122,C01,751538,Herbst; Matthew,0,0,0,0
1731501916421,MSED 295,A00,751699,Staff,5,0,5,0
1731501917451,MUS 1B,A01,755885,Staff,20,0,25,5
1731501917451,MUS 1B,A02,755889,Staff,21,0,25,4
1731501917451,MUS 1B,A03,755890,Staff,23,0,25,2
1731501917451,MUS 1B,A04,755891,Staff,25,0,25,0
1731501918480,MUS 2B,A01,755895,Carlson; Erik,30,0,30,0
1731501919512,MUS 2BK,A00,755896,Ohnishi; Takae,12,0,15,3
1731501919512,MUS 2BK,B00,755897,Ohnishi; Takae,15,0,15,0
1731501920557,MUS 4,A01,755899,Day; Kevin Alexander,24,0,25,1
1731501920557,MUS 4,A02,755900,Day; Kevin Alexander,25,0,25,0
1731501920557,MUS 4,A03,755901,Day; Kevin Alexander,25,0,25,0
1731501920557,MUS 4,A04,755902,Day; Kevin Alexander,25,0,25,0
1731501920557,MUS 4,A05,755903,Day; Kevin Alexander,25,0,25,0
1731501920557,MUS 4,A06,755904,Day; Kevin Alexander,25,0,25,0
1731501920557,MUS 4,A07,755926,Day; Kevin Alexander,25,0,25,0
1731501920557,MUS 4,A08,755927,Day; Kevin Alexander,24,0,25,1
1731501920557,MUS 4,A09,755951,Day; Kevin Alexander,25,0,25,0
1731501920557,MUS 4,A10,755952,Day; Kevin Alexander,25,0,25,0
1731501921588,MUS 6,A01,755954,Freitas Caetano; Marcelo,25,0,25,0
1731501921588,MUS 6,A02,755955,Freitas Caetano; Marcelo,22,0,25,3
1731501921588,MUS 6,A03,755982,Freitas Caetano; Marcelo,22,0,25,3
1731501921588,MUS 6,A04,755983,Freitas Caetano; Marcelo,25,0,25,0
1731501922617,MUS 9,A01,756195,Staff,19,0,20,1
1731501922617,MUS 9,A02,756197,Staff,20,0,20,0
1731501922617,MUS 9,A03,756198,Staff,20,0,20,0
1731501922617,MUS 9,A04,756199,Staff,20,0,20,0
1731501922617,MUS 9,A05,756201,Staff,20,0,20,0
1731501922617,MUS 9,A06,756209,Staff,20,0,20,0
1731501923649,MUS 12,A01,756214,Davis; Anthony Curtis,25,0,25,0
1731501923649,MUS 12,A02,756219,Davis; Anthony Curtis,24,0,25,1
1731501923649,MUS 12,A03,756221,Davis; Anthony Curtis,25,0,25,0
1731501923649,MUS 12,A04,756223,Davis; Anthony Curtis,25,0,25,0
1731501924691,MUS 13,A01,756228,Leslie Santana; Myrta,22,0,25,3
1731501924691,MUS 13,A02,756233,Leslie Santana; Myrta,21,0,25,4
1731501924691,MUS 13,A03,756234,Leslie Santana; Myrta,25,0,25,0
1731501924691,MUS 13,A04,756237,Leslie Santana; Myrta,25,0,25,0
1731501925724,MUS 15,A01,756244,Narucki; Susan M,23,0,25,2
1731501925724,MUS 15,A02,756250,Narucki; Susan M,23,0,25,2
1731501925724,MUS 15,A03,756256,Narucki; Susan M,23,0,25,2
1731501925724,MUS 15,A04,756259,Narucki; Susan M,25,0,25,0
1731501925724,MUS 15,A05,756262,Narucki; Susan M,24,0,25,1
1731501925724,MUS 15,A06,756269,Narucki; Susan M,22,0,25,3
1731501925724,MUS 15,A07,756273,Narucki; Susan M,25,0,25,0
1731501925724,MUS 15,A08,756280,Narucki; Susan M,23,0,25,2
1731501925724,MUS 15,A09,756281,Narucki; Susan M,25,0,25,0
1731501925724,MUS 15,A10,756282,Narucki; Susan M,23,0,25,2
1731501926749,MUS 17,A01,756669,Staff,23,0,25,2
1731501926749,MUS 17,A02,756673,Staff,23,0,25,2
1731501926749,MUS 17,A03,756674,Staff,17,0,25,8
1731501926749,MUS 17,A04,756675,Staff,24,0,25,1
1731501926749,MUS 17,A05,756679,Staff,25,0,25,0
1731501926749,MUS 17,A06,756683,Staff,21,0,25,4
1731501926749,MUS 17,A07,756689,Staff,25,0,25,0
1731501926749,MUS 17,A08,756693,Staff,24,0,25,1
1731501926749,MUS 17,A09,756695,Staff,24,0,25,1
1731501926749,MUS 17,A10,756697,Staff,24,0,25,1
1731501926749,MUS 17,A11,756701,Staff,23,0,25,2
1731501926749,MUS 17,A12,756703,Staff,24,0,25,1
1731501927780,MUS 20R,A01,797703,Borgo; David Garcia,7,0,25,18
1731501927780,MUS 20R,A02,797705,Borgo; David Garcia,24,0,25,1
1731501927780,MUS 20R,A03,797779,Borgo; David Garcia,23,0,25,2
1731501927780,MUS 20R,A04,797780,Borgo; David Garcia,25,0,25,0
1731501927780,MUS 20R,A05,797816,Borgo; David Garcia,23,0,25,2
1731501927780,MUS 20R,A06,797825,Borgo; David Garcia,25,0,25,0
1731501927780,MUS 20R,A07,797826,Borgo; David Garcia,24,0,25,1
1731501927780,MUS 20R,A08,797831,Borgo; David Garcia,21,0,25,4
1731501927780,MUS 20R,B01,798362,Borgo; David Garcia,3,0,3,0
1731501927780,MUS 20R,B02,798369,Borgo; David Garcia,3,0,3,0
1731501927780,MUS 20R,B03,798370,Borgo; David Garcia,3,0,3,0
1731501927780,MUS 20R,B04,798372,Borgo; David Garcia,3,0,3,0
1731501927780,MUS 20R,B05,798375,Borgo; David Garcia,3,0,3,0
1731501927780,MUS 20R,B06,798377,Borgo; David Garcia,3,0,3,0
1731501927780,MUS 20R,B07,798378,Borgo; David Garcia,3,0,3,0
1731501927780,MUS 20R,B08,798379,Borgo; David Garcia,3,0,3,0
1731501928817,MUS 32,001,735915,Dresser; Mark Stuart,10,0,10,0
1731501928817,MUS 32,002,735917,Curtis; Charles Rector,10,0,10,0
1731501928817,MUS 32,003,735920,Terrazas Perez; Wilfrido D,10,0,10,0
1731501928817,MUS 32,004,735921,Ohnishi; Takae,10,0,10,0
1731501928817,MUS 32,005,735923,Carlson; Erik,10,0,10,0
1731501928817,MUS 32,006,735924,Staff,10,0,10,0
1731501928817,MUS 32,007,735926,Staff,10,0,10,0
1731501929852,MUS 32V,A00,756706,Staff,10,0,10,0
1731501929852,MUS 32V,B00,756709,Staff,10,0,10,0
1731501930877,MUS 32VM,A00,756713,Staff,15,0,15,0
1731501931905,MUS 43,A00,756714,Yadegari; Shahrokh D,90,0,96,6
1731501932931,MUS 95C,A00,756725,Staff,38,0,40,2
1731501933956,MUS 95D,A00,756726,Yadegari; Shahrokh D,30,0,30,0
1731501934984,MUS 95E,A00,756730,Staff,40,0,40,0
1731501936011,MUS 95F,A00,756732,Staff,40,0,40,0
1731501937041,MUS 95G,A00,756742,Anderson; Kenneth,386,0,395,9
1731501937041,MUS 95G,B00,756743,Anderson; Kenneth,389,0,395,6
1731501938072,MUS 95JC,A00,756745,Kenyatta; Kamau,25,0,25,0
1731501939098,MUS 95L,A00,756749,Staff,65,0,65,0
1731501940131,MUS 95P,A00,756975,Nourai; Keyavash,20,0,20,0
1731501941158,MUS 95W,A00,756976,Seshadri; Kartik,28,0,30,2
1731501941158,MUS 95W,B00,756977,Seshadri; Kartik,30,0,30,0
1731501942187,MUS 101B,A01,757168,Day; Kevin Alexander,35,0,35,0
1731501943214,MUS 103B,A00,757172,Steiger; Rand,15,0,15,0
1731501944243,MUS 103E,A00,757173,Staff,10,0,10,0
1731501945270,MUS 107,A00,757174,Roberts; Matana,15,0,15,0
1731501946298,MUS 111,A00,757176,Guy; Nancy,117,0,120,3
1731501947328,MUS 113,A00,757178,Curtis; Charles Rector,30,0,30,0
1731501948358,MUS 114,A00,757179,Terrazas Perez; Wilfrido D,135,0,140,5
1731501949388,MUS 120B,A01,757182,Leslie Santana; Myrta,25,0,25,0
1731501950415,MUS 127,A00,757183,Dresser; Mark Stuart,94,0,100,6
1731501951442,MUS 130,A00,757185,Ohnishi; Takae,35,0,35,0
1731501952478,MUS 132,001,736011,Dresser; Mark Stuart,10,0,10,0
1731501952478,MUS 132,002,736012,Curtis; Charles Rector,10,0,10,0
1731501952478,MUS 132,003,736013,Terrazas Perez; Wilfrido D,10,0,10,0
1731501952478,MUS 132,004,736014,Ohnishi; Takae,10,0,10,0
1731501952478,MUS 132,005,736015,Carlson; Erik,10,0,10,0
1731501952478,MUS 132,006,736016,Staff,10,0,10,0
1731501952478,MUS 132,007,736017,Nourai; Keyavash,10,0,10,0
1731501952478,MUS 132,008,736018,Schick; Steven,10,0,10,0
1731501953505,MUS 132R,A00,757187,Narucki; Susan M,2,0,2,0
1731501954532,MUS 132V,A00,757189,Narucki; Susan M,15,0,15,0
1731501954532,MUS 132V,B00,757190,Staff,15,0,15,0
1731501955559,MUS 134,A00,757192,Yadegari; Shahrokh D,30,0,30,0
1731501956586,MUS 137B,A00,757193,Kenyatta; Kamau,34,0,35,1
1731501957611,MUS 143,A00,757194,Yadegari; Shahrokh D,27,0,31,4
1731501958638,MUS 160A,A00,757195,Dubnov; Shlomo,14,0,15,1
1731501958638,MUS 160A,B00,757198,Smythe; Cory Benjamin,15,0,15,0
1731501959672,MUS 171,A01,757200,Smyth; Tamara R.,47,0,65,18
1731501960698,MUS 173B,A01,757203,Britt; King James,25,0,25,0
1731501961724,MUS 174B,A00,757204,Britt; King James,18,0,25,7
1731501962750,MUS 176,A00,757205,Lou; Michelle Siulai,20,0,20,0
1731501963777,MUS 201A,A00,757207,Dresser; Mark Stuart,15,0,15,0
1731501964805,MUS 201B,A00,757208,Yadegari; Shahrokh D,13,0,15,2
1731501964805,MUS 201B,B00,757210,Roberts; Matana,13,0,15,2
1731501965833,MUS 201C,A00,757211,Schick; Steven,15,0,15,0
1731501966862,MUS 202,A00,795573,Schick; Steven,14,0,15,1
1731501967890,MUS 203B,A00,757213,Obermueller; Karola,14,0,15,1
1731501968925,MUS 203D,A00,757214,Davis; Anthony Curtis,10,0,10,0
1731501968925,MUS 203D,B00,757215,Lou; Michelle Siulai,10,0,10,0
1731501968925,MUS 203D,C00,757216,Obermueller; Karola,9,0,10,1
1731501968925,MUS 203D,D00,757217,Steiger; Rand,10,0,10,0
1731501968925,MUS 203D,E00,757218,McCormack; Timothy Matthew,10,0,10,0
1731501968925,MUS 203D,F00,795580,Liang; Lei,10,0,10,0
1731501969951,MUS 204,A00,757219,Lou; Michelle Siulai,13,0,15,2
1731501970979,MUS 205,A00,757220,Hankins; Sarah E.,13,0,15,2
1731501972010,MUS 206,A00,757221,Hankins; Sarah E.,14,0,15,1
1731501972010,MUS 206,B00,757222,Narucki; Susan M,14,0,15,1
1731501972010,MUS 206,C00,795581,Smythe; Cory Benjamin,15,0,15,0
1731501973037,MUS 207,A00,757223,Guy; Nancy,14,0,15,1
1731501974064,MUS 210,A00,757224,McCormack; Timothy Matthew,13,0,15,2
1731501975092,MUS 215D,A00,757225,Cimini; Amy Marie,14,0,15,1
1731501976123,MUS 232,001,736044,Dresser; Mark Stuart,10,0,10,0
1731501976123,MUS 232,002,736045,Curtis; Charles Rector,10,0,10,0
1731501976123,MUS 232,003,736046,Terrazas Perez; Wilfrido D,9,0,10,1
1731501976123,MUS 232,004,736047,Ohnishi; Takae,10,0,10,0
1731501976123,MUS 232,005,736048,Carlson; Erik,10,0,10,0
1731501976123,MUS 232,006,736049,Narucki; Susan M,9,0,10,1
1731501976123,MUS 232,007,736050,Staff,10,0,10,0
1731501976123,MUS 232,008,736051,Schick; Steven,10,0,10,0
1731501977152,MUS 234,A00,757226,Yadegari; Shahrokh D,20,0,20,0
1731501978177,MUS 245,A00,757230,Carlson; Erik,19,0,20,1
1731501979208,MUS 267,A00,757231,Smyth; Tamara R.,18,0,20,2
1731501980235,MUS 270D,A00,795583,Freitas Caetano; Marcelo,20,0,20,0
1731501981267,MUS 271A,A00,757235,Erbe; Tom,19,0,20,1
1731501982294,NANO 11,A00,757236,Fenning; David,100,0,100,0
1731501983320,NANO 15,A01,757238,Yang; Kesong,25,0,25,0
1731501984347,NANO 104,A00,757239,Vazquez Mena; Oscar,68,0,70,2
1731501985379,NANO 107,A01,757272,Cubukcu; Ertugrul,69,0,70,1
1731501986410,NANO 114,A00,757277,Jahed Motlagh; Zeinab,38,0,40,2
1731501987461,NANO 117,A00,757280,Cubukcu; Ertugrul,68,0,70,2
1731501988489,NANO 120A,A01,757286,Sirbuly; Donald,30,0,35,5
1731501988489,NANO 120A,B01,757294,Jokerst; Jesse Vincent,35,0,35,0
1731501989518,NANO 134,A00,757295,Pokorski; Jonathan Kyle,35,0,40,5
1731501990544,NANO 141A,A00,757296,Lubarda; Vlado,38,0,40,2
1731501991571,NANO 168,A00,757297,Fullerton; Eric E,37,0,40,3
1731501992602,NANO 200,A00,757302,Jahed Motlagh; Zeinab,88,0,120,32
1731501993631,NANO 203,A00,757314,Fenning; David,20,0,60,40
1731501994657,NANO 204,A00,757315,Li; Wan-Lu,28,0,30,2
1731501995683,NANO 205,A00,757323,Jokerst; Jesse Vincent,46,0,60,14
1731501996710,NANO 206,A00,757326,Chen; Shaochen,26,0,60,34
1731501997742,NANO 247B,A00,757331,Wang; Joseph,25,0,35,10
1731501998768,NANO 252,A00,757334,Meyers; Marc,16,0,20,4
1731501999798,NANO 265,A00,757355,Luo; Jian,8,0,10,2
1731502000834,NANO 272,A00,757357,Xu; Sheng,43,0,50,7
1731502001861,NEU 200B,A00,765050,Abdel-Azim; Eiman,0,0,0,0
1731502002890,NEU 276,A01,765052,Dore; Kim Bohemie,26,0,28,2
1731502003921,NEU 296,001,791944,Evans; Sean Jeffrey,5,0,10,5
1731502003921,NEU 296,002,791945,Graves; Jennifer Sharon Ol,9,0,10,1
1731502003921,NEU 296,003,791948,Staff,10,0,10,0
1731502004947,NEUG 221,A00,765055,Staff,7,0,12,5
1731502005974,NEUG 257,A01,765057,Halgren; Eric,16,0,18,2
1731502007000,NEUG 296,A00,765058,Bloodgood; Brenda Laurie,9999,0,9999,0
1731502008026,OPTH 296,001,792241,Baxter; Sally Liu,9,0,10,1
1731502008026,OPTH 296,002,792242,Staff,10,0,10,0
1731502008026,OPTH 296,003,792243,Staff,10,0,10,0
1731502009055,ORTH 296,001,792255,Staff,10,0,10,0
1731502009055,ORTH 296,002,792256,Staff,10,0,10,0
1731502009055,ORTH 296,003,792257,Staff,10,0,10,0
1731502010086,PAE 230,A00,791542,Villarreal Jr.; Elias,30,0,30,0
1731502011116,PAE 231,A00,791543,Villarreal Jr.; Elias,30,0,30,0
1731502012142,PAE 232,A00,791544,Villarreal Jr.; Elias,30,0,30,0
1731502013172,PAE 233,A00,791545,Villarreal Jr.; Elias,30,0,30,0
1731502014198,PAE 234,A01,791547,Villarreal Jr.; Elias,30,0,30,0
1731502015227,PAE 235,A01,791549,Villarreal Jr.; Elias,30,0,30,0
1731502016252,PAE 236,A00,791550,Villarreal Jr.; Elias,30,0,30,0
1731502017278,PATH 221,A00,761937,Yang; Jing,0,0,0,0
1731502018306,PATH 224,A01,799580,Ross; Camille,20,0,20,0
1731502019333,PATH 225,A01,797833,Klemke; Richard,25,0,25,0
1731502020360,PATH 296,001,792280,Staff,10,0,10,0
1731502020360,PATH 296,002,792282,Staff,10,0,10,0
1731502020360,PATH 296,003,792283,Staff,10,0,10,0
1731502021386,PEDS 296,001,792351,Staff,10,0,10,0
1731502021386,PEDS 296,002,792352,Staff,10,0,10,0
1731502021386,PEDS 296,003,792354,Staff,10,0,10,0
1731502022423,PH 40,A00,746085,Larsen; Britta Ann,94,0,100,6
1731502023457,PH 45,A01,785847,Stone; Matthew David,26,0,30,4
1731502023457,PH 45,A02,785848,Stone; Matthew David,26,0,30,4
1731502023457,PH 45,A03,785880,Stone; Matthew David,0,0,0,0
1731502023457,PH 45,A04,785898,Stone; Matthew David,0,0,0,0
1731502024485,PH 91,A00,746164,Harrell; Maralee Mae,100,0,100,0
1731502025510,PH 95,A00,746180,Larsen; Britta Ann,30,0,30,0
1731502026535,PH 98,A00,799480,Larsen; Britta Ann,0,0,0,0
1731502027572,PH 101,A00,746187,Tan; Gene Brian,28,0,40,12
1731502027572,PH 101,B00,746272,Miller; Lindsay Morgan,35,0,40,5
1731502028602,PH 102,A01,785945,Rana; Brinda Kanti,21,0,30,9
1731502028602,PH 102,A02,785966,Rana; Brinda Kanti,24,0,30,6
1731502029629,PH 110,A00,746301,Hartman; Sheri R,55,0,55,0
1731502029629,PH 110,B00,746625,Hartman; Sheri R,40,0,45,5
1731502030662,PH 120,A00,746626,Long; Kanya Claudine,49,0,55,6
1731502031691,PH 130,A00,746635,Kayser; Georgia Lyn,57,0,65,8
1731502032718,PH 161,A00,746643,Zoumas-Morse; Christine E.,55,0,60,5
1731502033774,PH 172,A00,746647,Ryan; Margaret Angela Kapp,35,0,40,5
1731502034807,PH 193,A00,746656,Staff,0,0,0,0
1731502034807,PH 193,B00,746659,Staff,0,0,0,0
1731502034807,PH 193,C00,746662,Staff,0,0,0,0
1731502034807,PH 193,D00,746667,Staff,0,0,0,0
1731502034807,PH 193,E00,746679,Staff,0,0,0,0
1731502034807,PH 193,F00,746683,Staff,0,0,0,0
1731502035839,PH 194,A00,746685,Nguyen; Annie Lu,0,0,0,0
1731502036872,PH 196AH,A01,746696,Binkin; Nancy Jeanne,20,0,20,0
1731502037917,PHAR 222,A00,761971,Yang; Jing,20,0,20,0
1731502038947,PHAR 255,A00,761972,Joiner; William J.,24,0,24,0
1731502039977,PHAR 275,A01,761977,Antal; Corina Elena & Obara; Christopher & Mendiola; Andrew & Gonzalez; David J,10,0,10,0
1731502041005,PHAR 295,A00,761978,Joiner; William J.,9,0,10,1
1731502042033,PHB 222,A00,746697,Messer; Karen Sue,30,0,50,20
1731502043060,PHB 226,A00,746698,Tu; Xin,15,0,25,10
1731502044086,PHB 243B,A01,746710,Thomas; Ronald G,9,0,20,11
1731502045113,PHB 244B,A00,746823,Vaida; Florin,24,0,45,21
1731502046144,PHB 280,A00,746910,Natarajan; Loki,48,0,75,27
1731502047171,PHB 291,A00,795411,Staff,14,0,25,11
1731502048208,PHIL 10,A01,761088,Carr; Jennifer Rose,39,0,44,5
1731502048208,PHIL 10,A02,761090,Carr; Jennifer Rose,44,0,44,0
1731502048208,PHIL 10,A03,761092,Carr; Jennifer Rose,42,0,44,2
1731502048208,PHIL 10,A04,761096,Carr; Jennifer Rose,44,0,44,0
1731502048208,PHIL 10,A05,761198,Carr; Jennifer Rose,44,0,44,0
1731502048208,PHIL 10,A06,761200,Carr; Jennifer Rose,43,0,44,1
1731502048208,PHIL 10,A07,761236,Carr; Jennifer Rose,44,0,44,0
1731502048208,PHIL 10,A08,761241,Carr; Jennifer Rose,43,0,44,1
1731502048208,PHIL 10,A09,761243,Carr; Jennifer Rose,0,0,0,0
1731502048208,PHIL 10,A10,761244,Carr; Jennifer Rose,0,0,0,0
1731502049237,PHIL 12,A01,761252,Kovaka; Karenc,29,0,30,1
1731502049237,PHIL 12,A02,761254,Kovaka; Karenc,0,0,0,0
1731502049237,PHIL 12,A03,761277,Kovaka; Karenc,30,0,30,0
1731502049237,PHIL 12,A04,761278,Kovaka; Karenc,29,0,30,1
1731502049237,PHIL 12,A05,761279,Kovaka; Karenc,30,0,30,0
1731502049237,PHIL 12,A06,761280,Kovaka; Karenc,29,0,30,1
1731502049237,PHIL 12,A07,761281,Kovaka; Karenc,30,0,30,0
1731502049237,PHIL 12,A08,761282,Kovaka; Karenc,0,0,0,0
1731502050264,PHIL 16,A00,761283,Harrell; Maralee Mae,31,0,33,2
1731502051290,PHIL 24,A00,761284,Callender; Craig Adam,120,0,120,0
1731502052322,PHIL 27,A01,761286,Lamey; Andy M.,17,0,25,8
1731502052322,PHIL 27,A02,761287,Lamey; Andy M.,18,0,25,7
1731502052322,PHIL 27,A03,761288,Lamey; Andy M.,0,0,0,0
1731502052322,PHIL 27,A04,761289,Lamey; Andy M.,0,0,0,0
1731502052322,PHIL 27,A05,761292,Lamey; Andy M.,21,0,25,4
1731502052322,PHIL 27,A06,761294,Lamey; Andy M.,20,0,25,5
1731502053349,PHIL 28,A01,761401,Brandt; Reuven A,16,0,25,9
1731502053349,PHIL 28,A02,761404,Brandt; Reuven A,23,0,25,2
1731502053349,PHIL 28,A03,761406,Brandt; Reuven A,23,0,25,2
1731502053349,PHIL 28,A04,761425,Brandt; Reuven A,18,0,25,7
1731502053349,PHIL 28,A05,761427,Brandt; Reuven A,25,0,25,0
1731502053349,PHIL 28,A06,761433,Brandt; Reuven A,23,0,25,2
1731502053349,PHIL 28,A07,761434,Brandt; Reuven A,0,0,0,0
1731502053349,PHIL 28,A08,761438,Brandt; Reuven A,0,0,0,0
1731502053349,PHIL 28,A09,761571,Brandt; Reuven A,8,0,25,17
1731502053349,PHIL 28,A10,761572,Brandt; Reuven A,24,0,25,1
1731502054379,PHIL 32,A01,761605,Johnson; Monte,23,0,25,2
1731502054379,PHIL 32,A02,761606,Johnson; Monte,25,0,25,0
1731502055408,PHIL 35,A00,761621,Marechal; Patricia,175,0,180,5
1731502056435,PHIL 51,A00,761645,Kovaka; Karenc,216,0,216,0
1731502057470,PHIL 90,A00,761646,Rudolph; Rachel Etta,31,0,33,2
1731502057470,PHIL 90,B00,761648,Kocurek; Alexander William,32,0,33,1
1731502058499,PHIL 100,A00,761696,Marechal; Patricia,24,0,32,8
1731502059527,PHIL 107,A00,761697,Tolley; Clinton,33,0,33,0
1731502060557,PHIL 111,A00,761698,Watkins; Eric,39,0,40,1
1731502061584,PHIL 122,A00,761699,Sher; Gila,31,0,33,2
1731502062611,PHIL 132,A00,761700,Sher; Gila,31,0,33,2
1731502063643,PHIL 136,A00,761701,Grush; Rick Scott,31,0,33,2
1731502064668,PHIL 138,A00,761721,Vargas; Manuel Rogelio,58,0,60,2
1731502065700,PHIL 149,A00,761738,Fulkerson; Matthew Todd,113,0,120,7
1731502066735,PHIL 163,A01,761771,Brandt; Reuven A,23,0,25,2
1731502066735,PHIL 163,A02,761774,Brandt; Reuven A,22,0,25,3
1731502066735,PHIL 163,A03,761778,Brandt; Reuven A,22,0,25,3
1731502066735,PHIL 163,A04,761785,Brandt; Reuven A,24,0,25,1
1731502066735,PHIL 163,A05,761810,Brandt; Reuven A,0,0,0,0
1731502066735,PHIL 163,A06,761819,Brandt; Reuven A,19,0,25,6
1731502066735,PHIL 163,A07,761823,Brandt; Reuven A,18,0,25,7
1731502066735,PHIL 163,A08,761827,Brandt; Reuven A,0,0,0,0
1731502066735,PHIL 163,A09,761833,Brandt; Reuven A,24,0,25,1
1731502066735,PHIL 163,A10,761840,Brandt; Reuven A,23,0,25,2
1731502067766,PHIL 167,A00,761841,Lamey; Andy M.,29,0,33,4
1731502068793,PHIL 176,A00,761843,Vargas; Manuel Rogelio,32,0,33,1
1731502069825,PHIL 177,A00,761848,Shields; Christopher John,33,0,33,0
1731502070856,PHIL 185,A00,794683,Shields; Christopher John,30,0,33,3
1731502072920,PHIL 191B,A00,799969,Tolley; Clinton,2,0,2,0
1731502072920,PHIL 191B,B00,799970,Bazargan-Forward; Saba,1,0,1,0
1731502073951,PHIL 201A,A00,761865,Tolley; Clinton,18,0,20,2
1731502074979,PHIL 206A,A00,761866,Carr; Jennifer Rose,17,0,20,3
1731502076005,PHIL 209C,A00,761870,McKenzie; Kerry V.,5,0,5,0
1731502077035,PHIL 209D,A00,761873,Lampland; Martha,5,0,5,0
1731502078061,PHIL 210,A00,761878,Johnson; Monte,19,0,20,1
1731502079089,PHIL 245,A00,761883,Cartwright; Nancy D.,14,0,20,6
1731502080117,PHIL 260,A00,761889,Bazargan-Forward; Saba & Yuan; Yuan,20,0,20,0
1731502081143,PHIL 271,A00,761891,Vargas; Manuel Rogelio & Fulkerson; Matthew Todd,10,0,10,0
1731502082171,PHIL 275,A00,761899,Watkins; Eric,10,0,10,0
1731502083196,PHIL 277,A00,761911,Tolley; Clinton,8,0,10,2
1731502084222,PHIL 278,A00,761919,Fulkerson; Matthew Todd & Cohen; Jonathan David,10,0,10,0
1731502085247,PHIL 280,A00,761930,Kovaka; Karenc,9999,0,9999,0
1731502086274,PHIL 281,A00,761931,Tolley; Clinton,10,0,10,0
1731502087304,PHIL 283,A00,794690,Tolley; Clinton & Vargas; Manuel Rogelio,10,0,10,0
1731502088333,PHIL 284,A00,761932,Kovaka; Karenc,10,0,10,0
1731502089360,PHIL 286,A00,761933,Chen; Keming & Callender; Craig Adam,10,0,10,0
1731502090387,PHIL 287,A00,761935,Johnson; Monte,10,0,10,0
1731502091423,PHIL 290,001,776411,Nelkin; Dana Kay,9999,0,9999,0
1731502091423,PHIL 290,002,776412,Bazargan-Forward; Saba,9999,0,9999,0
1731502091423,PHIL 290,003,776413,Brandt; Reuven A,9999,0,9999,0
1731502091423,PHIL 290,004,776414,Brink; David O.,9999,0,9999,0
1731502091423,PHIL 290,005,776415,Callender; Craig Adam,9999,0,9999,0
1731502091423,PHIL 290,006,776416,Carr; Jennifer Rose,9999,0,9999,0
1731502091423,PHIL 290,007,776483,Cartwright; Nancy D.,9999,0,9999,0
1731502091423,PHIL 290,008,776498,Cohen; Jonathan David,9999,0,9999,0
1731502091423,PHIL 290,009,776743,Danks; David J,9999,0,9999,0
1731502091423,PHIL 290,010,776746,Fulkerson; Matthew Todd,9999,0,9999,0
1731502091423,PHIL 290,011,776753,Grush; Rick Scott,9999,0,9999,0
1731502091423,PHIL 290,012,776756,Hardimon; Michael O.,9999,0,9999,0
1731502091423,PHIL 290,013,776760,Harrell; Maralee Mae,9999,0,9999,0
1731502091423,PHIL 290,014,776761,Johnson; Monte,9999,0,9999,0
1731502091423,PHIL 290,015,776762,Kovaka; Karenc,9999,0,9999,0
1731502091423,PHIL 290,016,776763,Lamey; Andy M.,9999,0,9999,0
1731502091423,PHIL 290,017,776766,Marechal; Patricia,9999,0,9999,0
1731502091423,PHIL 290,018,776771,McKenzie; Kerry V.,9999,0,9999,0
1731502091423,PHIL 290,019,776778,Rickless; Samuel Charles,9999,0,9999,0
1731502091423,PHIL 290,020,776782,Sher; Gila,9999,0,9999,0
1731502091423,PHIL 290,021,776785,Shields; Christopher John,9999,0,9999,0
1731502091423,PHIL 290,022,776787,Tolley; Clinton,9999,0,9999,0
1731502091423,PHIL 290,023,776796,Vargas; Manuel Rogelio,9999,0,9999,0
1731502091423,PHIL 290,024,776799,Watkins; Eric,9999,0,9999,0
1731502091423,PHIL 290,025,776802,Chen; Keming,9999,0,9999,0
1731502091423,PHIL 290,026,794693,Rudolph; Rachel Etta,9999,0,9999,0
1731502091423,PHIL 290,027,794696,Kocurek; Alexander William,9999,0,9999,0
1731502091423,PHIL 290,028,794697,Yuan; Yuan,9999,0,9999,0
1731502092454,PHIL 295,001,776806,Bazargan-Forward; Saba,9999,0,9999,0
1731502092454,PHIL 295,002,776808,Brandt; Reuven A,9999,0,9999,0
1731502092454,PHIL 295,003,776811,Brink; David O.,9999,0,9999,0
1731502092454,PHIL 295,004,776818,Callender; Craig Adam,9999,0,9999,0
1731502092454,PHIL 295,005,776820,Carr; Jennifer Rose,9999,0,9999,0
1731502092454,PHIL 295,006,776821,Cartwright; Nancy D.,9999,0,9999,0
1731502092454,PHIL 295,007,776825,Chen; Keming,9999,0,9999,0
1731502092454,PHIL 295,008,776827,Cohen; Jonathan David,9999,0,9999,0
1731502092454,PHIL 295,009,776831,Danks; David J,9999,0,9999,0
1731502092454,PHIL 295,010,776840,Fulkerson; Matthew Todd,9999,0,9999,0
1731502092454,PHIL 295,011,776842,Grush; Rick Scott,9999,0,9999,0
1731502092454,PHIL 295,012,776846,Hardimon; Michael O.,9999,0,9999,0
1731502092454,PHIL 295,013,776933,Harrell; Maralee Mae,9999,0,9999,0
1731502092454,PHIL 295,014,776934,Johnson; Monte,9999,0,9999,0
1731502092454,PHIL 295,015,776941,Kovaka; Karenc,9999,0,9999,0
1731502092454,PHIL 295,016,776960,Lamey; Andy M.,9999,0,9999,0
1731502092454,PHIL 295,017,777007,Marechal; Patricia,9999,0,9999,0
1731502092454,PHIL 295,018,777008,McKenzie; Kerry V.,9999,0,9999,0
1731502092454,PHIL 295,019,777047,Nelkin; Dana Kay,9999,0,9999,0
1731502092454,PHIL 295,020,777237,Rickless; Samuel Charles,9999,0,9999,0
1731502092454,PHIL 295,021,777242,Sher; Gila,9999,0,9999,0
1731502092454,PHIL 295,022,777245,Shields; Christopher John,9999,0,9999,0
1731502092454,PHIL 295,023,777246,Tolley; Clinton,9999,0,9999,0
1731502092454,PHIL 295,024,777247,Vargas; Manuel Rogelio,9999,0,9999,0
1731502092454,PHIL 295,025,777248,Watkins; Eric,9999,0,9999,0
1731502092454,PHIL 295,026,794698,Rudolph; Rachel Etta,9999,0,9999,0
1731502092454,PHIL 295,027,794699,Kocurek; Alexander William,9999,0,9999,0
1731502092454,PHIL 295,028,794710,Yuan; Yuan,9999,0,9999,0
1731502093480,PHYS 1A,A00,759213,Tsai; Philbert S,330,0,360,30
1731502094509,PHYS 1AL,001,759214,Yagil; Avi & Tsai; Philbert S,25,0,30,5
1731502094509,PHYS 1AL,002,759215,Yagil; Avi & Tsai; Philbert S,29,0,30,1
1731502094509,PHYS 1AL,003,759216,Yagil; Avi & Tsai; Philbert S,28,0,30,2
1731502094509,PHYS 1AL,004,759217,Yagil; Avi & Tsai; Philbert S,28,0,30,2
1731502094509,PHYS 1AL,005,759218,Yagil; Avi & Tsai; Philbert S,21,0,30,9
1731502094509,PHYS 1AL,006,759219,Yagil; Avi & Tsai; Philbert S,28,0,30,2
1731502094509,PHYS 1AL,007,759220,Yagil; Avi & Tsai; Philbert S,26,0,30,4
1731502094509,PHYS 1AL,008,759221,Yagil; Avi & Tsai; Philbert S,30,0,30,0
1731502094509,PHYS 1AL,009,759222,Yagil; Avi & Tsai; Philbert S,28,0,30,2
1731502094509,PHYS 1AL,010,759223,Yagil; Avi & Tsai; Philbert S,27,0,30,3
1731502094509,PHYS 1AL,011,759225,Yagil; Avi & Tsai; Philbert S,26,0,30,4
1731502094509,PHYS 1AL,012,759226,Yagil; Avi & Tsai; Philbert S,28,0,30,2
1731502095541,PHYS 1B,A00,759229,Smith; Douglas E,573,0,600,27
1731502095541,PHYS 1B,B00,759230,Smith; Douglas E,575,0,600,25
1731502096574,PHYS 1BL,001,759232,Yagil; Avi & Tsai; Philbert S,29,0,30,1
1731502096574,PHYS 1BL,002,759233,Yagil; Avi & Tsai; Philbert S,28,0,30,2
1731502096574,PHYS 1BL,003,759235,Yagil; Avi & Tsai; Philbert S,20,0,30,10
1731502096574,PHYS 1BL,004,759236,Yagil; Avi & Tsai; Philbert S,23,0,30,7
1731502096574,PHYS 1BL,005,759237,Yagil; Avi & Tsai; Philbert S,30,0,30,0
1731502096574,PHYS 1BL,006,759238,Yagil; Avi & Tsai; Philbert S,27,0,30,3
1731502096574,PHYS 1BL,007,759239,Yagil; Avi & Tsai; Philbert S,26,0,30,4
1731502096574,PHYS 1BL,008,759240,Yagil; Avi & Tsai; Philbert S,30,0,30,0
1731502096574,PHYS 1BL,009,759241,Yagil; Avi & Tsai; Philbert S,26,0,30,4
1731502096574,PHYS 1BL,010,759242,Yagil; Avi & Tsai; Philbert S,29,0,30,1
1731502096574,PHYS 1BL,011,759243,Yagil; Avi & Tsai; Philbert S,28,0,30,2
1731502096574,PHYS 1BL,012,759244,Yagil; Avi & Tsai; Philbert S,29,0,30,1
1731502096574,PHYS 1BL,015,759248,Yagil; Avi & Tsai; Philbert S,20,0,30,10
1731502096574,PHYS 1BL,016,759250,Yagil; Avi & Tsai; Philbert S,26,0,30,4
1731502096574,PHYS 1BL,017,759254,Yagil; Avi & Tsai; Philbert S,20,0,30,10
1731502096574,PHYS 1BL,018,759256,Yagil; Avi & Tsai; Philbert S,27,0,30,3
1731502096574,PHYS 1BL,019,759257,Yagil; Avi & Tsai; Philbert S,30,0,30,0
1731502096574,PHYS 1BL,020,759259,Yagil; Avi & Tsai; Philbert S,27,0,30,3
1731502096574,PHYS 1BL,021,759260,Yagil; Avi & Tsai; Philbert S,30,0,30,0
1731502096574,PHYS 1BL,022,759261,Yagil; Avi & Tsai; Philbert S,29,0,30,1
1731502096574,PHYS 1BL,023,759262,Yagil; Avi & Tsai; Philbert S,29,0,30,1
1731502096574,PHYS 1BL,024,759265,Yagil; Avi & Tsai; Philbert S,30,0,30,0
1731502096574,PHYS 1BL,025,759266,Yagil; Avi & Tsai; Philbert S,28,0,30,2
1731502096574,PHYS 1BL,026,759270,Yagil; Avi & Tsai; Philbert S,28,0,30,2
1731502096574,PHYS 1BL,027,759271,Yagil; Avi & Tsai; Philbert S,27,0,30,3
1731502096574,PHYS 1BL,028,759275,Yagil; Avi & Tsai; Philbert S,29,0,30,1
1731502096574,PHYS 1BL,029,759276,Yagil; Avi & Tsai; Philbert S,27,0,30,3
1731502096574,PHYS 1BL,030,759277,Yagil; Avi & Tsai; Philbert S,29,0,30,1
1731502096574,PHYS 1BL,031,759278,Yagil; Avi & Tsai; Philbert S,27,0,30,3
1731502096574,PHYS 1BL,032,759280,Yagil; Avi & Tsai; Philbert S,30,0,30,0
1731502096574,PHYS 1BL,033,759298,Yagil; Avi & Tsai; Philbert S,30,0,30,0
1731502096574,PHYS 1BL,034,759338,Yagil; Avi & Tsai; Philbert S,30,0,30,0
1731502096574,PHYS 1BL,035,759363,Yagil; Avi & Tsai; Philbert S,26,0,30,4
1731502096574,PHYS 1BL,036,759376,Yagil; Avi & Tsai; Philbert S,28,0,30,2
1731502097609,PHYS 1C,A00,759402,Bal; Gurleen K,341,0,362,21
1731502098639,PHYS 1CL,001,759406,Yagil; Avi & Tsai; Philbert S,25,0,30,5
1731502098639,PHYS 1CL,002,759408,Yagil; Avi & Tsai; Philbert S,23,0,30,7
1731502098639,PHYS 1CL,003,759464,Yagil; Avi & Tsai; Philbert S,27,0,30,3
1731502098639,PHYS 1CL,004,759467,Yagil; Avi & Tsai; Philbert S,25,0,30,5
1731502098639,PHYS 1CL,005,759469,Yagil; Avi & Tsai; Philbert S,27,0,30,3
1731502098639,PHYS 1CL,006,794532,Yagil; Avi & Tsai; Philbert S,26,0,30,4
1731502098639,PHYS 1CL,007,794533,Yagil; Avi & Tsai; Philbert S,27,0,30,3
1731502098639,PHYS 1CL,008,794534,Yagil; Avi & Tsai; Philbert S,30,0,30,0
1731502098639,PHYS 1CL,009,794535,Yagil; Avi & Tsai; Philbert S,29,0,30,1
1731502098639,PHYS 1CL,010,794536,Yagil; Avi & Tsai; Philbert S,30,0,30,0
1731502098639,PHYS 1CL,011,794537,Yagil; Avi & Tsai; Philbert S,28,0,30,2
1731502098639,PHYS 1CL,012,794538,Yagil; Avi & Tsai; Philbert S,29,0,30,1
1731502099681,PHYS 2A,A01,759498,Bal; Gurleen K,30,0,30,0
1731502099681,PHYS 2A,A02,759546,Bal; Gurleen K,30,0,30,0
1731502099681,PHYS 2A,A03,759548,Bal; Gurleen K,30,0,30,0
1731502099681,PHYS 2A,A04,759549,Bal; Gurleen K,30,0,30,0
1731502099681,PHYS 2A,A05,759550,Bal; Gurleen K,29,0,30,1
1731502099681,PHYS 2A,A06,759551,Bal; Gurleen K,29,0,30,1
1731502099681,PHYS 2A,A07,759552,Bal; Gurleen K,30,0,30,0
1731502099681,PHYS 2A,A08,759553,Bal; Gurleen K,30,0,30,0
1731502099681,PHYS 2A,A09,759554,Bal; Gurleen K,30,0,30,0
1731502099681,PHYS 2A,A10,759555,Bal; Gurleen K,30,0,30,0
1731502099681,PHYS 2A,A11,759556,Bal; Gurleen K,30,0,30,0
1731502099681,PHYS 2A,A12,759558,Bal; Gurleen K,29,0,30,1
1731502099681,PHYS 2A,B01,759560,Dudko; Olga,26,0,30,4
1731502099681,PHYS 2A,B02,759561,Dudko; Olga,30,0,30,0
1731502099681,PHYS 2A,B03,759562,Dudko; Olga,30,0,30,0
1731502099681,PHYS 2A,B04,759563,Dudko; Olga,29,0,30,1
1731502099681,PHYS 2A,B05,759565,Dudko; Olga,27,0,30,3
1731502099681,PHYS 2A,B06,759566,Dudko; Olga,28,0,30,2
1731502099681,PHYS 2A,B07,759567,Dudko; Olga,24,0,30,6
1731502099681,PHYS 2A,B08,759568,Dudko; Olga,30,0,30,0
1731502099681,PHYS 2A,B09,759569,Dudko; Olga,27,0,30,3
1731502099681,PHYS 2A,B10,759611,Dudko; Olga,29,0,30,1
1731502099681,PHYS 2A,B11,759661,Dudko; Olga,24,0,30,6
1731502099681,PHYS 2A,B12,759664,Dudko; Olga,24,0,30,6
1731502100713,PHYS 2B,A01,759701,Shotwell; Brian,29,0,30,1
1731502100713,PHYS 2B,A02,759737,Shotwell; Brian,30,0,30,0
1731502100713,PHYS 2B,A03,759743,Shotwell; Brian,29,0,30,1
1731502100713,PHYS 2B,A04,759744,Shotwell; Brian,30,0,30,0
1731502100713,PHYS 2B,A05,759745,Shotwell; Brian,28,0,30,2
1731502100713,PHYS 2B,A06,759779,Shotwell; Brian,27,0,30,3
1731502100713,PHYS 2B,A07,759782,Shotwell; Brian,28,0,30,2
1731502100713,PHYS 2B,A08,759796,Shotwell; Brian,29,0,30,1
1731502100713,PHYS 2B,A09,759798,Shotwell; Brian,26,0,30,4
1731502100713,PHYS 2B,A10,759905,Shotwell; Brian,29,0,30,1
1731502100713,PHYS 2B,A11,759989,Shotwell; Brian,28,0,30,2
1731502100713,PHYS 2B,A12,759992,Shotwell; Brian,23,0,30,7
1731502101752,PHYS 2C,A01,759994,Jun; Suckjoon,22,0,30,8
1731502101752,PHYS 2C,A02,759995,Jun; Suckjoon,27,0,30,3
1731502101752,PHYS 2C,A03,759996,Jun; Suckjoon,30,0,30,0
1731502101752,PHYS 2C,A04,759997,Jun; Suckjoon,29,0,30,1
1731502101752,PHYS 2C,A05,760002,Jun; Suckjoon,30,0,30,0
1731502101752,PHYS 2C,A06,760021,Jun; Suckjoon,30,0,30,0
1731502101752,PHYS 2C,A07,760032,Jun; Suckjoon,28,0,30,2
1731502101752,PHYS 2C,A08,760035,Jun; Suckjoon,30,0,30,0
1731502101752,PHYS 2C,A09,760041,Jun; Suckjoon,30,0,30,0
1731502101752,PHYS 2C,A10,760042,Jun; Suckjoon,30,0,30,0
1731502101752,PHYS 2C,A11,760043,Jun; Suckjoon,30,0,30,0
1731502101752,PHYS 2C,A12,760044,Jun; Suckjoon,30,0,30,0
1731502102779,PHYS 2CL,A01,760046,Jun; Suckjoon,24,0,28,4
1731502102779,PHYS 2CL,A02,760047,Jun; Suckjoon,26,0,28,2
1731502102779,PHYS 2CL,A03,760048,Jun; Suckjoon,25,0,28,3
1731502102779,PHYS 2CL,A04,760049,Jun; Suckjoon,25,0,28,3
1731502102779,PHYS 2CL,A05,760050,Jun; Suckjoon,24,0,28,4
1731502102779,PHYS 2CL,A06,760051,Jun; Suckjoon,28,0,28,0
1731502102779,PHYS 2CL,A07,760052,Jun; Suckjoon,25,0,28,3
1731502102779,PHYS 2CL,A08,760053,Jun; Suckjoon,26,0,28,2
1731502103809,PHYS 2D,A01,760055,Hirsch; Jorge Eduardo,29,0,32,3
1731502103809,PHYS 2D,A02,760056,Hirsch; Jorge Eduardo,31,0,32,1
1731502104843,PHYS 4A,A01,760058,Averitt; Richard Douglas,41,0,45,4
1731502104843,PHYS 4A,A02,760085,Averitt; Richard Douglas,44,0,45,1
1731502104843,PHYS 4A,A03,760086,Averitt; Richard Douglas,44,0,45,1
1731502104843,PHYS 4A,A04,760087,Averitt; Richard Douglas,45,0,45,0
1731502105872,PHYS 4D,A01,760090,Frano Pereira; Alex M,40,0,40,0
1731502105872,PHYS 4D,A02,760096,Frano Pereira; Alex M,39,0,40,1
1731502105872,PHYS 4D,A03,760097,Frano Pereira; Alex M,40,0,40,0
1731502106900,PHYS 12,A01,760099,Branson; James G,59,0,60,1
1731502107932,PHYS 39,A01,796284,Jun; Suckjoon,0,0,0,0
1731502108957,PHYS 41,A01,760104,Green; Daniel Richard,48,0,50,2
1731502109984,PHYS 87,A00,796262,Grinstein; Benjamin,20,0,20,0
1731502111019,PHYS 100B,A01,760163,Barreiro Guerrero; Julio,72,0,75,3
1731502112052,PHYS 105A,A01,760203,Lin; Tongyan,33,0,38,5
1731502112052,PHYS 105A,A02,760212,Lin; Tongyan,36,0,37,1
1731502113077,PHYS 110B,A01,760214,Serra; Mattia,74,0,75,1
1731502114107,PHYS 124,A01,760217,Arnold; Kam S,38,0,40,2
1731502115135,PHYS 130A,A01,760219,Parker; Daniel E,38,0,40,2
1731502116165,PHYS 130C,A01,760221,You; Yizhuang,22,0,30,8
1731502117210,PHYS 136,A00,760222,Grinstein; Benjamin,50,0,50,0
1731502118245,PHYS 139,A00,760223,Di Ventra; Massimiliano & Schuller; Ivan K,28,0,30,2
1731502119271,PHYS 140B,A01,760225,Arovas; Daniel P,26,0,30,4
1731502120304,PHYS 142,A01,794356,Duarte; Javier Mauricio,52,0,55,3
1731502121337,PHYS 152A,A01,760229,Butov; Leonid,39,0,40,1
1731502122367,PHYS 160,A01,760231,Fuller; George Michael,64,0,65,1
1731502123397,PHYS 176,A00,760232,Hwa; Terence T.,10,0,10,0
1731502124431,PHYS 178,A00,760233,Kleinfeld; David,32,0,35,3
1731502125457,PHYS 203A,A01,760242,Fogler; Michael M.,13,0,30,17
1731502126483,PHYS 211B,A00,760255,Grover; Tarun,28,0,30,2
1731502127510,PHYS 212B,A01,760269,Chivukula; Raja S,18,0,30,12
1731502128538,PHYS 215B,A00,760325,McGreevy; John A.,24,0,30,6
1731502129566,PHYS 225B,A00,760326,Flauger; Raphael M,27,0,30,3
1731502130593,PHYS 239,A00,760327,Di Ventra; Massimiliano & Schuller; Ivan K,12,0,15,3
1731502130593,PHYS 239,B00,760328,Goldenfeld; Nigel,25,0,30,5
1731502131620,PHYS 242,A00,794365,Duarte; Javier Mauricio,2,0,5,3
1731502132651,PHYS 250,A00,760331,Parker; Daniel E,45,0,50,5
1731502133681,PHYS 251,A00,760332,Grinstein; Benjamin,18,0,20,2
1731502134709,PHYS 252,A00,760333,Diamond; Patrick H,8,0,10,2
1731502135742,PHYS 253,A00,760336,Fuller; George Michael & Keating; Brian,19,0,20,1
1731502136773,PHYS 254,A00,760337,Tan; Tzer Han,30,0,30,0
1731502137804,PHYS 259A,A00,795452,Hwa; Terence T.,18,0,20,2
1731502138830,PHYS 260,A00,760340,Fuller; George Michael,46,0,50,4
1731502139859,PHYS 261,A00,760341,Schuller; Ivan K,28,0,30,2
1731502140886,PHYS 276,A00,760342,Hwa; Terence T.,6,0,10,4
1731502141917,PHYS 278,A00,760343,Kleinfeld; David,14,0,15,1
1731502142948,POLI 5D,A01,761982,Dai; Yinlin,6,0,6,0
1731502142948,POLI 5D,A02,761984,Dai; Yinlin,6,0,6,0
1731502142948,POLI 5D,A03,761987,Dai; Yinlin,6,0,6,0
1731502142948,POLI 5D,A04,761988,Dai; Yinlin,6,0,6,0
1731502142948,POLI 5D,A05,762321,Dai; Yinlin,5,0,6,1
1731502142948,POLI 5D,B01,762356,Dai; Yinlin,6,0,6,0
1731502142948,POLI 5D,B02,762362,Dai; Yinlin,6,0,6,0
1731502142948,POLI 5D,B03,762365,Dai; Yinlin,5,0,6,1
1731502142948,POLI 5D,B04,762369,Dai; Yinlin,6,0,6,0
1731502142948,POLI 5D,B05,762370,Dai; Yinlin,6,0,6,0
1731502143981,POLI 10D,A01,762376,Noble; Benjamin S,29,0,32,3
1731502143981,POLI 10D,A02,762377,Noble; Benjamin S,29,0,32,3
1731502143981,POLI 10D,A03,762384,Noble; Benjamin S,29,0,32,3
1731502143981,POLI 10D,A04,762385,Noble; Benjamin S,29,0,32,3
1731502143981,POLI 10D,A05,762390,Noble; Benjamin S,32,0,32,0
1731502143981,POLI 10D,A06,762397,Noble; Benjamin S,32,0,32,0
1731502145012,POLI 11D,A01,762400,Desposato; Scott,33,0,34,1
1731502145012,POLI 11D,A02,762403,Desposato; Scott,32,0,34,2
1731502145012,POLI 11D,A03,762406,Desposato; Scott,33,0,34,1
1731502145012,POLI 11D,A04,762408,Desposato; Scott,33,0,34,1
1731502145012,POLI 11D,A05,762409,Desposato; Scott,33,0,34,1
1731502145012,POLI 11D,A06,762411,Desposato; Scott,34,0,34,0
1731502146039,POLI 87,A00,799971,Mignozzetti; Umberto,20,0,20,0
1731502147068,POLI 100W,A00,762448,Paglayan; Agustina,111,0,120,9
1731502148100,POLI 104B,A00,762450,Smith; Glenn Chatmas,208,0,216,8
1731502149131,POLI 104C,A00,762453,Salam; Amna,102,0,115,13
1731502150156,POLI 104J,A00,762454,Nichter; Maysa,180,0,196,16
1731502151185,POLI 104U,A00,762456,Nichter; Maysa,130,0,146,16
1731502152211,POLI 108,A00,762463,Adida; Claire,289,0,295,6
1731502153243,POLI 110B,A00,762465,Ingham; Sean,54,0,56,2
1731502154276,POLI 113BR,A00,762468,Hoston; Germaine,193,0,200,7
1731502154276,POLI 113BR,B00,796178,Hoston; Germaine,30,0,30,0
1731502155349,POLI 114BR,A00,762469,Hoston; Germaine,195,0,200,5
1731502155349,POLI 114BR,B00,796626,Hoston; Germaine,30,0,30,0
1731502156374,POLI 117R,A00,762470,Forman; Fonna,27,0,40,13
1731502157404,POLI 118,A00,762472,Wiens; David,97,0,104,7
1731502158431,POLI 120G,A00,762598,Fisk; David Lee,111,0,115,4
1731502159457,POLI 124A,A00,762698,Fortunato; David,54,0,56,2
1731502160485,POLI 127,A00,762700,Feeley; Maureen Catherine,157,0,158,1
1731502161515,POLI 135,A00,762703,Fisk; David Lee,144,0,146,2
1731502162545,POLI 137,A00,762704,Saiegh; Sebastian,53,0,56,3
1731502163571,POLI 138,A00,762707,Draper; Matthew William,111,0,115,4
1731502164605,POLI 142J,A00,762708,Slantchev; Branislav,109,0,115,6
1731502165633,POLI 142L,A00,762709,Wagner; Wendy,138,0,146,8
1731502166661,POLI 147B,A00,762711,Roeder; Philip G,143,0,146,3
1731502167687,POLI 153,A00,762712,Fisk; David Lee,139,0,146,7
1731502168716,POLI 160AA,A00,762714,Staff,207,0,223,16
1731502169748,POLI 191B,A00,762715,Fowler; James,26,0,26,0
1731502170775,POLI 194,A00,770731,Hill; Seth J,9999,0,9999,0
1731502171802,POLI 197SD,A00,794843,Nichter; Maysa,9999,0,9999,0
1731502172829,POLI 203A,A00,762716,Ingham; Sean,21,0,25,4
1731502173860,POLI 212,A00,762739,Goldman; Harvey Stern,1,0,2,1
1731502174893,POLI 216,A00,762740,Wiens; David,23,0,25,2
1731502175920,POLI 220C,A00,762771,Garfias Royo; Ek Francisco,24,0,25,1
1731502176946,POLI 229,A00,762772,Saiegh; Sebastian,11,0,12,1
1731502176946,POLI 229,B00,762783,Liu; Guoer,22,0,25,3
1731502177973,POLI 231,A00,762784,Nichter; Simeon C,22,0,25,3
1731502179003,POLI 231E,A00,762788,Lowes; Sara Rachel & Bazzi; Samuel A,3,0,5,2
1731502180029,POLI 245,A00,762789,Naoi; Megumi,8,0,12,4
1731502181058,POLI 248,A00,762792,Lake; David A,19,0,25,6
1731502182084,POLI 257,A00,762795,Hill; Seth J,25,0,25,0
1731502183113,POLI 258,A00,762798,Noble; Benjamin S,25,0,25,0
1731502184144,POLI 271,A00,762799,Ahlquist; John S.,23,0,24,1
1731502185171,POLI 272,A00,762802,Mignozzetti; Umberto,11,0,12,1
1731502186202,POLI 281,A00,762803,Ban; Pamela M,13,0,13,0
1731502187228,POLI 282,A00,762804,Ferree; Karen E,23,0,25,2
1731502188255,POLI 283,A00,762805,Slantchev; Branislav,20,0,25,5
1731502189285,POLI 285,A00,762807,Ingham; Sean,10,0,10,0
1731502190315,POLI 286,A00,762808,Mignozzetti; Umberto,25,0,25,0
1731502191341,POLI 288,A00,762810,Fowler; James,12,0,12,0
1731502192368,PSY 296,001,792382,Staff,10,0,10,0
1731502192368,PSY 296,002,792383,Staff,10,0,10,0
1731502192368,PSY 296,003,792385,Staff,10,0,10,0
1731502193400,PSYC 1,A00,762811,Wennberg; Janna Wold,288,0,300,12
1731502194427,PSYC 2,A00,762815,Moranton; Nirelia Melbina-,247,0,250,3
1731502195455,PSYC 4,A00,795584,Anagnostaras; Stephan,285,0,295,10
1731502196493,PSYC 60,A01,786029,Lowe; Angela Beth,35,0,35,0
1731502196493,PSYC 60,A02,786035,Lowe; Angela Beth,33,0,35,2
1731502196493,PSYC 60,A03,786043,Lowe; Angela Beth,32,0,35,3
1731502196493,PSYC 60,A04,786046,Lowe; Angela Beth,32,0,35,3
1731502196493,PSYC 60,A05,786048,Lowe; Angela Beth,33,0,35,2
1731502196493,PSYC 60,A06,786049,Lowe; Angela Beth,33,0,35,2
1731502196493,PSYC 60,A07,786050,Lowe; Angela Beth,35,0,35,0
1731502196493,PSYC 60,B01,786056,Steiner; Eric Tomas,33,0,35,2
1731502196493,PSYC 60,B02,786058,Steiner; Eric Tomas,32,0,35,3
1731502196493,PSYC 60,B03,786061,Steiner; Eric Tomas,33,0,35,2
1731502196493,PSYC 60,B04,786065,Steiner; Eric Tomas,33,0,35,2
1731502196493,PSYC 60,B05,786068,Steiner; Eric Tomas,34,0,35,1
1731502196493,PSYC 60,B06,786071,Steiner; Eric Tomas,34,0,35,1
1731502196493,PSYC 60,B07,786075,Steiner; Eric Tomas,34,0,35,1
1731502197522,PSYC 70,A01,786078,Geller; Emma Harlan,27,0,35,8
1731502197522,PSYC 70,A02,786081,Geller; Emma Harlan,30,0,35,5
1731502197522,PSYC 70,A03,786084,Geller; Emma Harlan,35,0,35,0
1731502197522,PSYC 70,A04,786088,Geller; Emma Harlan,35,0,35,0
1731502197522,PSYC 70,A05,786089,Geller; Emma Harlan,35,0,35,0
1731502197522,PSYC 70,A06,786094,Geller; Emma Harlan,34,0,35,1
1731502198549,PSYC 71,A01,762821,Pilegard; Celeste Cristine,10,0,25,15
1731502198549,PSYC 71,A02,762822,Pilegard; Celeste Cristine,24,0,25,1
1731502198549,PSYC 71,B01,762826,Lowe; Angela Beth,24,0,25,1
1731502198549,PSYC 71,B02,762827,Lowe; Angela Beth,23,0,25,2
1731502199579,PSYC 101,A00,762829,Walker; Caren Michelle,255,0,295,40
1731502200610,PSYC 102,A00,762832,Gentner; Tim,220,0,225,5
1731502201637,PSYC 105,A00,762833,Brady; Timothy Francis,294,0,328,34
1731502202670,PSYC 106,A00,762834,Dobkins; Karen R.,282,0,295,13
1731502203703,PSYC 108,A00,762835,Adrian; Julia Anna,240,0,250,10
1731502204734,PSYC 110,A00,762838,Heyman; Gail D.,35,0,35,0
1731502205762,PSYC 111A,A01,762841,Geller; Emma Harlan,35,0,35,0
1731502206792,PSYC 116B,A01,762844,Lang; Ariel,21,0,21,0
1731502207823,PSYC 124,A00,762845,Dickenson; Janna Alene,76,0,80,4
1731502208850,PSYC 125,A00,762851,Rose; Fred E.,134,0,145,11
1731502209876,PSYC 137,A00,762853,Lin; Chujun,289,0,295,6
1731502210907,PSYC 144,A00,762855,Yilmaz; Anne Sheyda,285,0,295,10
1731502211946,PSYC 148,A00,762856,Mc Kenzie; Craig R.M.,90,0,100,10
1731502212979,PSYC 151,A00,762858,Glaser; Dale,67,0,70,3
1731502214006,PSYC 153,A00,762859,Harris; Christine Renee,241,0,250,9
1731502215035,PSYC 154,B00,762860,Lacefield; Katharine I,277,0,295,18
1731502216066,PSYC 162,A00,762863,Wixted; John T,284,0,295,11
1731502217098,PSYC 168,A00,762864,Chapman; Eddie Nathaniel,260,0,328,68
1731502218127,PSYC 172,A00,762865,Dickenson; Janna Alene,288,0,300,12
1731502219159,PSYC 175,A00,762868,Dobkins; Karen R.,35,0,35,0
1731502220186,PSYC 179,A00,762869,Lacefield; Katharine I,269,0,328,59
1731502221211,PSYC 181,A00,762872,Anagnostaras; Stephan,318,0,328,10
1731502222240,PSYC 184,A00,762873,Wilson; Brent M,281,0,295,14
1731502223267,PSYC 185,A00,762875,Aron; Adam,249,0,250,1
1731502224298,PSYC 187,A00,762876,Schachner; Adena,0,0,35,35
1731502225337,PSYC 193,A00,762879,Chapman; Eddie Nathaniel,29,0,35,6
1731502225337,PSYC 193,B00,762880,Pilegard; Celeste Cristine,48,0,50,2
1731502225337,PSYC 193,C00,762927,Rickard; Timothy C.,24,0,25,1
1731502225337,PSYC 193,D00,762934,Mukku; Dhananjaya,34,0,35,1
1731502225337,PSYC 193,E00,762935,Staff,48,0,50,2
1731502226371,PSYC 193L,A01,762937,Staff,23,0,35,12
1731502226371,PSYC 193L,B01,762939,Brown; Sandra A,65,0,65,0
1731502227401,PSYC 194B,A01,762941,Heyman; Gail D.,25,0,25,0
1731502228427,PSYC 201B,A01,762943,Staff,11,0,20,9
1731502229454,PSYC 220,A00,762944,Winkielman; Piotr,11,0,20,9
1731502230484,PSYC 224,A00,762945,Staff,28,0,30,2
1731502231512,PSYC 242,A00,762946,Staff,27,0,30,3
1731502232542,PSYC 247,A00,762947,Walker; Caren Michelle,19,0,20,1
1731502233569,PSYC 269,A00,762948,Schachner; Adena,19,0,20,1
1731502234595,PSYC 270B,A00,762949,Dobkins; Karen R.,18,0,20,2
1731502235628,PSYC 272,A00,762950,Mukku; Dhananjaya,20,0,20,0
1731502235628,PSYC 272,B00,762951,Brashier; Nadia Marie,16,0,20,4
1731502236656,PSYC 274,A00,762954,Staff,28,0,30,2
1731502237686,PSYC 275,A00,762955,Staff,19,0,30,11
1731502238718,PSYC 280,A00,762956,Serences; John Thomas,68,0,85,17
1731502239755,PSYC 296,001,777832,Anagnostaras; Stephan,9999,0,9999,0
1731502239755,PSYC 296,002,777833,Aron; Adam,9999,0,9999,0
1731502239755,PSYC 296,003,777834,Mukku; Dhananjaya,9999,0,9999,0
1731502239755,PSYC 296,004,777835,Barner; David A.,9998,0,9999,1
1731502239755,PSYC 296,005,777845,Schachner; Adena,9999,0,9999,0
1731502239755,PSYC 296,006,777846,Brown; Sandra A,9999,0,9999,0
1731502239755,PSYC 296,007,777847,Ferreira; Victor,9999,0,9999,0
1731502239755,PSYC 296,008,777848,Geller; Emma Harlan,9998,0,9999,1
1731502239755,PSYC 296,009,777849,Gentner; Tim,9999,0,9999,0
1731502239755,PSYC 296,010,777850,Gorman; Michael R.,9999,0,9999,0
1731502239755,PSYC 296,011,777852,Gremel; Christina M,9999,0,9999,0
1731502239755,PSYC 296,012,777854,Harris; Christine Renee,9999,0,9999,0
1731502239755,PSYC 296,013,777856,Pashler; Harold E,9999,0,9999,0
1731502239755,PSYC 296,014,777857,Pilegard; Celeste Cristine,9999,0,9999,0
1731502239755,PSYC 296,015,777858,Powell; Lindsey Jane,9999,0,9999,0
1731502239755,PSYC 296,016,777864,Rickard; Timothy C.,9998,0,9999,1
1731502239755,PSYC 296,017,777866,Serences; John Thomas,9998,0,9999,1
1731502239755,PSYC 296,018,777867,Walker; Caren Michelle,9998,0,9999,1
1731502239755,PSYC 296,019,777888,Lin; Chujun,9998,0,9999,1
1731502239755,PSYC 296,020,777889,Brashier; Nadia Marie,9997,0,9999,2
1731502239755,PSYC 296,021,777890,Oesch; Nicholas W,9999,0,9999,0
1731502239755,PSYC 296,022,777892,Long; Bria,9999,0,9999,0
1731502240789,RAD 278,A00,763247,Contijoch; Francisco,0,0,0,0
1731502241816,RAD 296,001,792406,Berman; Zachary,9,0,10,1
1731502241816,RAD 296,002,792408,Staff,10,0,10,0
1731502241816,RAD 296,003,792409,Staff,10,0,10,0
1731502242851,RELI 101,A00,763768,Rahimi; Babak,36,0,40,4
1731502243881,REV 20,A00,794904,Pomeroy; Robert S.,40,0,40,0
1731502244906,REV 87,A00,794931,Markman; Kristina,20,0,20,0
1731502245935,RMAS 296,001,792520,Murphy; James D,10,0,10,0
1731502245935,RMAS 296,002,792521,Staff,10,0,10,0
1731502245935,RMAS 296,003,792522,Staff,10,0,10,0
1731502246963,RMED 296,001,792600,Duleba; Antoni,9,0,10,1
1731502246963,RMED 296,002,792611,Staff,10,0,10,0
1731502246963,RMED 296,003,792620,Staff,10,0,10,0
1731502247990,SE 9,A01,763260,Kuester; Falko,28,0,34,6
1731502247990,SE 9,A02,763263,Kuester; Falko,33,0,33,0
1731502247990,SE 9,A03,763264,Kuester; Falko,31,0,33,2
1731502249024,SE 101A,A01,763356,Van Den Einde; Yael Dahlia,194,0,200,6
1731502250051,SE 101B,A01,763358,Todd; Michael,199,0,200,1
1731502251083,SE 102,A01,763360,Jandaghi Semnani; Shabnam,32,0,45,13
1731502251083,SE 102,A02,763361,Jandaghi Semnani; Shabnam,44,0,45,1
1731502251083,SE 102,A03,763362,Jandaghi Semnani; Shabnam,40,0,45,5
1731502252110,SE 103,A01,763364,Van Den Einde; Yael Dahlia,73,0,75,2
1731502252110,SE 103,A02,763365,Van Den Einde; Yael Dahlia,69,0,75,6
1731502253139,SE 110A,A01,763508,Lanza Di Scalea; Francesco,143,0,146,3
1731502254166,SE 110B,A00,763509,Asaro; Robert J,54,0,56,2
1731502255201,SE 115,A01,763555,Zhu; Qiang,198,0,200,2
1731502256226,SE 130A,A00,763556,Loh; Kenneth J. H.,37,0,40,3
1731502257253,SE 140A,A01,763558,Uang; Chia-Ming,2,0,24,22
1731502257253,SE 140A,A02,763559,Uang; Chia-Ming,10,0,24,14
1731502257253,SE 140A,A03,763560,Uang; Chia-Ming,22,0,24,2
1731502257253,SE 140A,A04,763561,Uang; Chia-Ming,20,0,24,4
1731502258281,SE 143A,A01,763563,Kosmatka; John B,15,0,32,17
1731502258281,SE 143A,A02,763564,Kosmatka; John B,32,0,32,0
1731502259315,SE 151A,A01,763566,Shing; P. Benson,71,0,100,29
1731502260344,SE 160A,A01,763569,Kosmatka; John B,168,0,175,7
1731502261374,SE 167,A01,763571,Chadha; Mayank,12,0,15,3
1731502262405,SE 171,A01,763573,Kim; Hyonny,20,0,35,15
1731502263436,SE 182,A01,763627,Hutchinson; Tara,44,0,50,6
1731502264462,SE 201B,A00,763629,Conte; Joel P,25,0,50,25
1731502265495,SE 203A,A00,763635,Tsampras; Georgios,39,0,65,26
1731502266521,SE 207,A00,763636,Palermo; Alessandro,0,0,20,20
1731502267555,SE 232,A01,763638,Jandaghi Semnani; Shabnam,21,0,40,19
1731502268588,SE 242,A01,763644,Tomac; Ingrid,5,0,25,20
1731502269614,SE 243,A00,763684,Hutchinson; Tara,40,0,40,0
1731502270642,SE 251A,A00,763751,Qiao; Yu,19,0,25,6
1731502271668,SE 252,A00,763752,Lanza Di Scalea; Francesco,20,0,25,5
1731502272696,SE 260A,A00,763753,Kosmatka; John B,11,0,15,4
1731502273728,SE 262,A00,763754,Kim; Hyonny,4,0,5,1
1731502274754,SE 266,A00,763755,Loh; Kenneth J. H.,5,0,15,10
1731502275782,SE 267A,A01,763758,Chadha; Mayank,12,0,15,3
1731502276810,SE 270,A00,763760,Morrison; Machel Leigh,26,0,35,9
1731502277836,SE 272,A00,763761,Asaro; Robert J,13,0,15,2
1731502278862,SE 273,A00,763762,Jandaghi Semnani; Shabnam,15,0,15,0
1731502279894,SE 276B,A00,763763,Chen; Jiun-Shyan,27,0,30,3
1731502280926,SE 281,A01,763765,Kuester; Falko,27,0,40,13
1731502281952,SE 290,A00,794880,Chen; Jiun-Shyan,57,0,100,43
1731502282992,SE 296,001,779072,Asaro; Robert J,9999,0,9999,0
1731502282992,SE 296,002,779073,Chen; Jiun-Shyan,9999,0,9999,0
1731502282992,SE 296,003,779074,Conte; Joel P,9999,0,9999,0
1731502282992,SE 296,004,779075,Elgamal; Ahmed,9999,0,9999,0
1731502282992,SE 296,005,779076,Hutchinson; Tara,9999,0,9999,0
1731502282992,SE 296,006,779077,Jandaghi Semnani; Shabnam,9999,0,9999,0
1731502282992,SE 296,007,779080,Kim; Hyonny,9999,0,9999,0
1731502282992,SE 296,008,779081,Kim; Hyunsun Alicia,9999,0,9999,0
1731502282992,SE 296,009,779082,Kosmatka; John B,9999,0,9999,0
1731502282992,SE 296,010,779085,Krysl; Petr,9999,0,9999,0
1731502282992,SE 296,011,779095,Kuester; Falko,9999,0,9999,0
1731502282992,SE 296,012,779096,Lanza Di Scalea; Francesco,9999,0,9999,0
1731502282992,SE 296,013,779098,Loh; Kenneth J. H.,9999,0,9999,0
1731502282992,SE 296,014,779172,McCartney; John Scott,9999,0,9999,0
1731502282992,SE 296,015,779175,Morrison; Machel Leigh,9999,0,9999,0
1731502282992,SE 296,016,779178,Mosqueda; Gilberto,9999,0,9999,0
1731502282992,SE 296,017,779179,Qiao; Yu,9999,0,9999,0
1731502282992,SE 296,018,779180,Shing; P. Benson,9999,0,9999,0
1731502282992,SE 296,019,779182,Todd; Michael,9998,0,9999,1
1731502282992,SE 296,020,779183,Tomac; Ingrid,9999,0,9999,0
1731502282992,SE 296,021,779185,Tsampras; Georgios,9999,0,9999,0
1731502282992,SE 296,022,779186,Uang; Chia-Ming,9999,0,9999,0
1731502282992,SE 296,023,779187,Van Den Einde; Yael Dahlia,9999,0,9999,0
1731502282992,SE 296,024,779188,Zhu; Qiang,9999,0,9999,0
1731502282992,SE 296,025,779190,Tehrani; Mehran,9999,0,9999,0
1731502282992,SE 296,026,779213,Palermo; Alessandro,9999,0,9999,0
1731502282992,SE 296,027,779214,Chadha; Mayank,9999,0,9999,0
1731502284021,SIO 1,A01,764333,Stegman; David,35,0,36,1
1731502284021,SIO 1,A02,764349,Stegman; David,35,0,36,1
1731502284021,SIO 1,A03,764383,Stegman; David,36,0,36,0
1731502284021,SIO 1,A04,764386,Stegman; David,35,0,36,1
1731502285106,SIO 3,A01,764389,Aburto Oropeza; Marco Octavio,35,0,35,0
1731502285106,SIO 3,A02,794529,Aburto Oropeza; Marco Octavio,35,0,35,0
1731502285106,SIO 3,A03,794527,Aburto Oropeza; Marco Octavio,34,0,35,1
1731502285106,SIO 3,A04,794528,Aburto Oropeza; Marco Octavio,35,0,35,0
1731502286135,SIO 25,A01,764394,Rivera-Collazo; Isabel C,40,0,40,0
1731502286135,SIO 25,A02,764395,Rivera-Collazo; Isabel C,37,0,40,3
1731502286135,SIO 25,A03,764397,Rivera-Collazo; Isabel C,40,0,40,0
1731502286135,SIO 25,A04,764401,Rivera-Collazo; Isabel C,39,0,40,1
1731502286135,SIO 25,A05,764454,Rivera-Collazo; Isabel C,38,0,40,2
1731502286135,SIO 25,A06,764460,Rivera-Collazo; Isabel C,38,0,40,2
1731502286135,SIO 25,A07,764480,Rivera-Collazo; Isabel C,38,0,40,2
1731502286135,SIO 25,A08,764484,Rivera-Collazo; Isabel C,39,0,40,1
1731502286135,SIO 25,A09,764488,Rivera-Collazo; Isabel C,39,0,40,1
1731502286135,SIO 25,A10,764490,Rivera-Collazo; Isabel C,38,0,40,2
1731502287165,SIO 45,A00,764491,Cook; Geoffrey W,91,0,120,29
1731502288191,SIO 65,A00,764497,Cook; Geoffrey W,34,0,35,1
1731502289220,SIO 87,A00,764567,Aburto Oropeza; Marco Octavio,25,0,25,0
1731502289220,SIO 87,B00,764568,Cook; Geoffrey W,20,0,20,0
1731502290249,SIO 90,A00,764570,Staff,57,0,65,8
1731502291281,SIO 102,A01,764574,Day; James M.D.,41,0,45,4
1731502292309,SIO 107,A00,764576,Schartup; Amina Bocary,28,0,30,2
1731502293339,SIO 109R,A00,764581,Forman; Fonna,53,0,75,22
1731502294365,SIO 116,A00,764582,Benmarhnia; Tarik,14,0,25,11
1731502295401,SIO 119,A01,764636,Send; Uwe & Andersson; Andreas Jerry,24,0,32,8
1731502295401,SIO 119,A02,764658,Send; Uwe & Andersson; Andreas Jerry,30,0,32,2
1731502295401,SIO 119,A03,764662,Send; Uwe & Andersson; Andreas Jerry,31,0,32,1
1731502295401,SIO 119,A04,764663,Send; Uwe & Andersson; Andreas Jerry,31,0,32,1
1731502296430,SIO 120,A01,764666,Cook; Geoffrey W,19,0,24,5
1731502297456,SIO 123,A00,764667,Allen; Andrew Ellis,38,0,40,2
1731502298483,SIO 126,A01,764669,Palenik; Brian,27,0,30,3
1731502298483,SIO 126,A02,764670,Palenik; Brian,29,0,30,1
1731502299513,SIO 133,A01,764673,Baumann-Pickering ; Simone & Kacev; David,27,0,36,9
1731502299513,SIO 133,A02,764674,Baumann-Pickering ; Simone & Kacev; David,33,0,36,3
1731502299513,SIO 133,A03,764675,Baumann-Pickering ; Simone & Kacev; David,30,0,36,6
1731502299513,SIO 133,A04,764676,Baumann-Pickering ; Simone & Kacev; David,34,0,36,2
1731502300541,SIO 134,A01,764678,Barton; Andrew David,13,0,14,1
1731502300541,SIO 134,A02,764680,Barton; Andrew David,12,0,14,2
1731502300541,SIO 134,A03,764682,Barton; Andrew David,8,0,14,6
1731502300541,SIO 134,A04,764684,Barton; Andrew David,13,0,14,1
1731502300541,SIO 134,A05,764685,Barton; Andrew David,13,0,14,1
1731502300541,SIO 134,A06,764686,Barton; Andrew David,12,0,15,3
1731502300541,SIO 134,A07,764687,Barton; Andrew David,12,0,15,3
1731502300541,SIO 134,A08,764688,Barton; Andrew David,15,0,15,0
1731502301567,SIO 144,A00,764690,Day; James M.D.,5,0,5,0
1731502302597,SIO 161,A01,764693,Fan; Wenyuan,18,0,20,2
1731502303629,SIO 162,A00,764694,Wright; Vashan,23,0,25,2
1731502304657,SIO 164,A00,764696,Staff,42,0,45,3
1731502305689,SIO 172,A00,764697,Norris; Joel Roland,35,0,40,5
1731502306716,SIO 178,A00,764699,Becker; Janet Maria,20,0,20,0
1731502307748,SIO 182,A00,764701,Constable; Steven C,19,0,20,1
1731502308775,SIO 187,A01,764776,Kacev; David,33,0,35,2
1731502308775,SIO 187,A02,764777,Kacev; David,32,0,35,3
1731502308775,SIO 187,A03,764779,Kacev; David,34,0,35,1
1731502308775,SIO 187,A04,764781,Kacev; David,32,0,35,3
1731502309802,SIO 190L,A01,764790,Sandin; Stuart Adrian,32,0,35,3
1731502310829,SIO 194,A00,770729,Hill; Seth J,9999,0,9999,0
1731502311855,SIOB 262,A00,764791,Moore; Bradley S.,23,0,25,2
1731502312888,SIOB 265,A01,764793,Jensen; Paul R.,8,0,12,4
1731502313914,SIOB 272,A01,764796,Sandin; Stuart Adrian,9,0,20,11
1731502313914,SIOB 272,A02,764797,Sandin; Stuart Adrian,14,0,20,6
1731502314942,SIOB 279,A00,794515,Barton; Andrew David,11,0,20,9
1731502315970,SIOB 286,A01,764803,Mesnick; Sarah & Smith; Jennifer,0,0,20,20
1731502316996,SIOB 291,A00,764806,Staff,0,0,0,0
1731502318023,SIOB 296,A00,794530,Staff,0,0,0,20
1731502319053,SIOB 297,A00,764807,Allen; Eric,17,0,25,8
1731502320080,SIOC 200C,A00,764808,Lin; Ying-Tsong,19,0,20,1
1731502321111,SIOC 202A,A00,764810,Hao; Xuanting & Lin; Ying-Tsong,22,0,30,8
1731502322138,SIOC 203B,A00,764811,Llewellyn Smith; Stefan G.,22,0,25,3
1731502323171,SIOC 207B,A00,764813,Meyer; Florian,1,0,5,4
1731502324200,SIOC 208,A00,764814,Merrifield; Mark A,30,0,40,10
1731502325233,SIOC 209,A00,764881,Benmarhnia; Tarik,12,0,30,18
1731502325233,SIOC 209,B00,794517,Charbit; Lia,30,0,30,0
1731502326260,SIOC 211A,A00,764882,Mackinnon; Jennifer A.,18,0,25,7
1731502327287,SIOC 212A,A00,764892,Eisenman; Ian,9,0,20,11
1731502328321,SIOC 216A,A00,794518,Werner; Bradley T.,19,0,20,1
1731502329352,SIOC 217B,A00,764895,Norris; Joel Roland,12,0,20,8
1731502330384,SIOC 217D,A00,764904,Keeling; Ralph F. & Russell; Lynn M.,19,0,20,1
1731502331419,SIOC 219,A00,796147,Mackinnon; Jennifer A. & Young; William Roy,29,0,30,1
1731502332451,SIOC 221B,A00,764907,Gille; Sarah T,17,0,25,8
1731502333482,SIOC 223,A00,764910,Send; Uwe & Merrifield; Mark A,18,0,20,2
1731502334517,SIOC 237B,A00,764912,Stramski; Dariusz,17,0,20,3
1731502335545,SIOC 296,A00,799576,Staff,0,0,0,0
1731502336574,SIOG 200C,A00,794531,Fan; Wenyuan,0,0,0,0
1731502337605,SIOG 223B,A00,764966,Agnew; Duncan Carr & Fan; Wenyuan,18,0,20,2
1731502338641,SIOG 227A,A00,765040,Gabriel; Anne Alice-Agnes,5,0,10,5
1731502339667,SIOG 228,A00,765043,Kacev; David,7,0,20,13
1731502340694,SIOG 229,A00,765046,Borsa; Adrian Antal,19,0,20,1
1731502341724,SIOG 234,A00,765047,Sandwell; David T,13,0,15,2
1731502342751,SIOG 237,A01,765099,Fialko; Yuri A.,18,0,20,2
1731502343778,SIOG 239,A00,765100,Gabriel; Anne Alice-Agnes,20,0,20,0
1731502344808,SIOG 252A,A00,765102,Day; James M.D.,5,0,10,5
1731502345834,SIOG 260,A00,765105,Schartup; Amina Bocary,21,0,50,29
1731502346859,SOCE 194,A00,770728,Hill; Seth J,9999,0,9999,0
1731502347885,SOCG 202,A00,764221,Goldman; Harvey Stern,4,0,10,6
1731502348913,SOCG 203,A00,764223,Ribas Norris; Janet Vanesa,1,0,10,9
1731502349938,SOCG 205,A00,764255,Sutton; April Marie,6,0,10,4
1731502350965,SOCG 208B,A00,764258,Ng; Kwai,5,0,10,5
1731502351992,SOCG 209,A00,764259,Lewis; Kevin Michael,0,0,10,10
1731502353021,SOCG 247,A00,764260,Edington; Claire Ellen,5,0,5,0
1731502354048,SOCG 253,A00,764262,Evans; John Hyde,4,0,8,4
1731502355076,SOCG 255C,A00,764266,McKenzie; Kerry V.,5,0,5,0
1731502356103,SOCG 255D,A00,764272,Lampland; Martha,5,0,5,0
1731502357129,SOCG 284,B00,800628,Navon; Daniel,0,0,0,0
1731502358161,SOCG 290,A00,794511,Gong; Neil M,9,0,10,1
1731502359194,SOCI 1,A01,763771,Rogers; Julia Ellen,30,0,30,0
1731502359194,SOCI 1,A02,763835,Rogers; Julia Ellen,29,0,30,1
1731502359194,SOCI 1,A03,763839,Rogers; Julia Ellen,30,0,30,0
1731502359194,SOCI 1,A04,763845,Rogers; Julia Ellen,27,0,30,3
1731502359194,SOCI 1,A05,763860,Rogers; Julia Ellen,29,0,30,1
1731502359194,SOCI 1,A06,763866,Rogers; Julia Ellen,30,0,30,0
1731502360221,SOCI 2,A01,763874,Staff,32,0,32,0
1731502360221,SOCI 2,A02,763875,Staff,30,0,32,2
1731502360221,SOCI 2,A03,763876,Staff,30,0,32,2
1731502360221,SOCI 2,A04,763896,Staff,30,0,32,2
1731502360221,SOCI 2,A05,763899,Staff,30,0,32,2
1731502360221,SOCI 2,A06,763901,Staff,31,0,32,1
1731502360221,SOCI 2,A07,763902,Staff,30,0,32,2
1731502360221,SOCI 2,A08,763904,Staff,31,0,32,1
1731502361249,SOCI 20,A01,763907,Kenworthy; Lane A.,30,0,30,0
1731502361249,SOCI 20,A02,763908,Kenworthy; Lane A.,26,0,30,4
1731502362276,SOCI 60,A01,763977,Ribas Norris; Janet Vanesa,28,0,32,4
1731502362276,SOCI 60,A02,763979,Ribas Norris; Janet Vanesa,31,0,32,1
1731502363303,SOCI 70,A01,763986,Lewis; Kevin Michael,25,0,30,5
1731502363303,SOCI 70,A02,763988,Lewis; Kevin Michael,30,0,30,0
1731502363303,SOCI 70,A03,763990,Lewis; Kevin Michael,27,0,30,3
1731502363303,SOCI 70,A04,764042,Lewis; Kevin Michael,27,0,30,3
1731502364331,SOCI 100,A01,764047,Goldman; Harvey Stern,29,0,30,1
1731502364331,SOCI 100,A02,764048,Goldman; Harvey Stern,29,0,30,1
1731502364331,SOCI 100,A03,764052,Goldman; Harvey Stern,28,0,30,2
1731502364331,SOCI 100,A04,764058,Goldman; Harvey Stern,28,0,30,2
1731502365357,SOCI 103M,A00,764059,Kilpatrick; Kevin,25,0,30,5
1731502366385,SOCI 104,A00,764066,Arnal; Maud Marie Leonie,25,0,30,5
1731502367420,SOCI 106,A00,795036,Shafir; Gershon,29,0,30,1
1731502368450,SOCI 109,A00,764070,Kilpatrick; Kevin,29,0,30,1
1731502369479,SOCI 117,A01,764078,Jones; Gabrielle Anastasia,15,0,17,2
1731502369479,SOCI 117,A02,764084,Jones; Gabrielle Anastasia,16,0,17,1
1731502369479,SOCI 117,A03,764085,Jones; Gabrielle Anastasia,17,0,17,0
1731502369479,SOCI 117,A04,764086,Jones; Gabrielle Anastasia,19,0,19,0
1731502369479,SOCI 117,B01,764163,Aragon; Maria Jose,8,0,10,2
1731502369479,SOCI 117,B02,764170,Aragon; Maria Jose,10,0,10,0
1731502370507,SOCI 118,A00,764178,Rogers; Julia Ellen,74,0,75,1
1731502371540,SOCI 119,A00,764179,Victoria Torres; Pablo,86,0,90,4
1731502372569,SOCI 120T,A00,764180,Staff,56,0,56,0
1731502373598,SOCI 124,A00,764181,Kenworthy; Lane A.,48,0,50,2
1731502374626,SOCI 125,A00,764182,Watson; Tobias,63,0,65,2
1731502375654,SOCI 126,A01,764184,Jones; Makeba,17,0,20,3
1731502375654,SOCI 126,A02,764185,Jones; Makeba,20,0,20,0
1731502375654,SOCI 126,A03,764186,Jones; Makeba,20,0,20,0
1731502376683,SOCI 127,A00,764187,Fitzgerald; David S,60,0,65,5
1731502377715,SOCI 130E,A00,764188,Pitt; Richard Norris,42,0,45,3
1731502378746,SOCI 133E,A00,764189,Pitt; Richard Norris,55,0,56,1
1731502379773,SOCI 135,A00,764190,Payne; Christine Anna,70,0,74,4
1731502380802,SOCI 136E,A00,764191,Ruiz; Jonathan Joseph,55,0,56,1
1731502381835,SOCI 136F,A00,764192,Gong; Neil M,55,0,56,1
1731502382867,SOCI 140,A00,764193,Tirshfield; Jeffrey T,46,0,49,3
1731502383899,SOCI 142,A00,764194,Crofts; Christine,56,0,70,14
1731502384926,SOCI 144P,A00,764195,Estefan; Michel,71,0,75,4
1731502385953,SOCI 148,A00,764196,Payne; Christine Anna,93,0,100,7
1731502386980,SOCI 148E,A00,764197,Calderon-Zaks; Michael Aar,43,0,45,2
1731502388009,SOCI 149,A00,764198,Alvarez; Camila Huerta,49,0,55,6
1731502389095,SOCI 150,A00,764200,Victoria Torres; Pablo,74,0,75,1
1731502390124,SOCI 154,A00,764201,Crofts; Christine,46,0,55,9
1731502391153,SOCI 159,B00,764202,Staff,56,0,56,0
1731502392180,SOCI 160,A00,764203,Ostovany; Khashayar,49,0,50,1
1731502393211,SOCI 161,A00,764204,Arnal; Maud Marie Leonie,53,0,56,3
1731502394237,SOCI 162,A00,764207,Rogers; Julia Ellen,53,0,55,2
1731502395267,SOCI 169,A00,764208,Shafir; Gershon,34,0,35,1
1731502396294,SOCI 170,A00,764209,Lampland; Martha,45,0,45,0
1731502397322,SOCI 171,A00,764210,Ruiz; Jonathan Joseph,51,0,56,5
1731502398350,SOCI 173,A00,764211,Navon; Daniel,99,0,100,1
1731502399381,SOCI 175,A00,764213,Calderon-Zaks; Michael Aar,64,0,65,1
1731502400408,SOCI 180,A00,764214,Ostovany; Khashayar,48,0,50,2
1731502401439,SOCI 183,A00,764215,Sutton; April Marie,25,0,25,0
1731502402470,SOCI 188,A01,764217,Andrews; Abigail Leslie,0,0,0,0
1731502403499,SOCI 188E,A00,764219,Jules-Rosette; Bennetta W.,30,0,30,0
1731502404526,SOCI 196B,A00,764220,Turner; Christena L.,14,0,15,1
1731502405553,SOMC 225,A00,792643,Rifkin; Dena E.,160,0,160,0
1731502406580,SOMC 227,A00,792651,Gold; Jeffrey Joseph,160,0,160,0
1731502407610,SOMC 237,A00,792671,Gold; Jeffrey Joseph,160,0,160,0
1731502408639,SOMC 238,A00,792678,Papamatheakis; Demosthenes,160,0,160,0
1731502409668,SOMC 239,A00,792686,Rifkin; Dena E.,160,0,160,0
1731502410702,SOMC 243,A00,793653,Gaines; Tommi L.,160,0,160,0
1731502411730,SOMC 245B,A01,792743,Noel; Geoffroy Pierre Jean,160,0,160,0
1731502412757,SOMC 246B,A00,792744,Eyler; Lisa T.,160,0,160,0
1731502413789,SOMC 247B,A50,792756,Calcutt; Nigel A,160,0,160,0
1731502414820,SOMC 248B,A00,792757,Joshi; Weena Erin,160,0,160,0
1731502415847,SOMC 251B,A00,792760,Eyler; Lisa T.,160,0,160,0
1731502416873,SOMC 252B,A00,792780,Taddonio; Michael Adam,160,0,160,0
1731502417905,SOMC 253B,A00,792808,Wooten; Darcy A,160,0,160,0
1731502418934,SOMC 254B,A00,792815,Joshi; Weena Erin,160,0,160,0
1731502419962,SOMC 255B,A00,792836,Allison; Matthew,160,0,160,0
1731502420989,SOMC 256B,A00,792845,Shapiro; Desiree Nicolette,160,0,160,0
1731502422017,SPPH 263A,A00,792290,O'Donoghue; Anthony John & Abagyan; Ruben,47,0,50,3
1731502423047,SPPS 200A,A00,792291,Luli; Alex J,100,0,100,0
1731502424080,SPPS 202,A00,792292,Fricovsky; Eduardo Santiago,76,0,80,4
1731502425112,SPPS 207,A01,792296,Hernandez Y Delso; Inmacul,76,0,80,4
1731502426138,SPPS 208,A00,792297,Bounthavong; Mark,76,0,80,4
1731502427164,SPPS 210,001,799992,Gustafsson; Asa Birgitta,99,0,99,0
1731502428193,SPPS 212B,A01,792301,Humber; Douglas M,80,0,80,0
1731502429218,SPPS 212D,A01,792304,Patel; Nimish,80,0,80,0
1731502430244,SPPS 216,A00,792305,Fitzgerald; Robert,80,0,80,0
1731502431272,SPPS 218A,A00,792306,Vijapurkar; Ulka,80,0,80,0
1731502432299,SPPS 223,A01,792308,Hook; Vivian Yuan-Ho,95,0,99,4
1731502433332,SPPS 224,A01,792310,Momper; Jeremiah D,76,0,80,4
1731502434357,SPPS 234,A00,792312,Rifkin; Dena E.,80,0,80,0
1731502435383,SPPS 248,A00,792315,Brandl; Katharina,80,0,80,0
1731502436411,SPPS 251,A00,792316,Chen; Timothy,20,0,20,0
1731502437440,SPPS 254,A00,792317,Shapiro; Desiree Nicolette,49,0,50,1
1731502438467,SPPS 264B,A00,792319,Tsunoda; Shirley M.,30,0,30,0
1731502439497,SPPS 270B,A00,792320,Fricovsky; Eduardo Santiago,30,0,30,0
1731502440528,SPPS 274,A00,792323,Namba; Jennifer Mariko,60,0,60,0
1731502441554,SPPS 278,A00,792325,Fricovsky; Eduardo Santiago,99,0,99,0
1731502442580,SPPS 282,A00,792326,Radic; Zoran,10,0,10,0
1731502443608,SPPS 287,A00,792327,Tsunoda; Shirley M.,60,0,60,0
1731502444643,SPPS 288,A00,792328,Saunders; Ila Maewal,98,0,99,1
1731502445672,SPPS 289,A00,792329,Armour; Jon Christopher,60,0,60,0
1731502446699,SURG 296,001,792875,Reid; Christopher,9,0,10,1
1731502446699,SURG 296,002,792880,Staff,10,0,10,0
1731502446699,SURG 296,003,792882,Staff,10,0,10,0
1731502447734,SYN 1,001,768443,Rosenberg; Ryan Glenn,17,0,20,3
1731502447734,SYN 1,002,768444,Iatarola; Briana Marie,11,0,20,9
1731502447734,SYN 1,003,768445,Bishop; Graham,14,0,20,6
1731502447734,SYN 1,004,768446,Atkinson; Arthur Laird,19,0,20,1
1731502447734,SYN 1,005,768447,Girard; Gabrielle,20,0,20,0
1731502447734,SYN 1,006,768455,Girard; Gabrielle,20,0,20,0
1731502447734,SYN 1,007,768471,Fish; Gwendolyn Anne,20,0,20,0
1731502447734,SYN 1,008,768473,Deavenport; James Cary,16,0,20,4
1731502447734,SYN 1,009,768474,Hom; Kirstyn Courtney,20,0,20,0
1731502447734,SYN 1,010,768494,Hom; Kirstyn Courtney,12,0,20,8
1731502447734,SYN 1,011,768525,Deavenport; James Cary,19,0,20,1
1731502447734,SYN 1,012,768794,Lagapa; Jason,19,0,20,1
1731502447734,SYN 1,013,768795,Meyer; Leslie Rose,17,0,20,3
1731502447734,SYN 1,014,768798,Meyer; Leslie Rose,18,0,20,2
1731502448761,SYN 1R,001,768853,Atkinson; Arthur Laird,19,0,20,1
1731502449792,SYN 2,001,768857,Birberick; Brittany Celest,20,0,20,0
1731502449792,SYN 2,002,768859,Girard; Gabrielle,17,0,20,3
1731502449792,SYN 2,003,768862,Tawater; Hanna Jean,20,0,20,0
1731502449792,SYN 2,004,768869,Tawater; Hanna Jean,17,0,20,3
1731502449792,SYN 2,005,768871,Difruscio; Mark,20,0,20,0
1731502449792,SYN 2,006,768872,Rock; Martin,18,0,20,2
1731502449792,SYN 2,007,768876,Difruscio; Mark,17,0,20,3
1731502449792,SYN 2,008,768878,Staff,20,0,20,0
1731502449792,SYN 2,010,768890,Rock; Martin,18,0,20,2
1731502449792,SYN 2,011,768891,Browne; Emily,19,0,20,1
1731502450821,SYN 2R,001,768972,Staff,18,0,20,2
1731502451879,SYN 100,A01,768983,Gladstein; Jill M,15,0,15,0
1731502451879,SYN 100,A02,768990,Gladstein; Jill M,14,0,15,1
1731502451879,SYN 100,B01,769012,Tawater; Hanna Jean,6,0,15,9
1731502451879,SYN 100,B02,769014,Tawater; Hanna Jean,5,0,15,10
1731502451879,SYN 100,C01,769019,Rosenberg; Ryan Glenn,11,0,15,4
1731502451879,SYN 100,C02,769022,Rosenberg; Ryan Glenn,15,0,15,0
1731502451879,SYN 100,D01,769025,Rosenberg; Ryan Glenn,14,0,15,1
1731502451879,SYN 100,D02,769027,Rosenberg; Ryan Glenn,12,0,15,3
1731502451879,SYN 100,E01,769044,Browne; Emily,13,0,15,2
1731502451879,SYN 100,E02,769053,Browne; Emily,14,0,15,1
1731502451879,SYN 100,F01,769071,Browne; Emily,10,0,15,5
1731502451879,SYN 100,F02,769072,Browne; Emily,15,0,15,0
1731502451879,SYN 100,G01,769096,Iatarola; Briana Marie,13,0,15,2
1731502451879,SYN 100,G02,769202,Iatarola; Briana Marie,10,0,15,5
1731502451879,SYN 100,H01,769221,Meyer; Leslie Rose,12,0,15,3
1731502451879,SYN 100,H02,795165,Meyer; Leslie Rose,14,0,15,1
1731502451879,SYN 100,I01,769227,Deavenport; James Cary,11,0,15,4
1731502451879,SYN 100,I02,769228,Deavenport; James Cary,12,0,15,3
1731502451879,SYN 100,J01,769230,Hom; Kirstyn Courtney,11,0,15,4
1731502451879,SYN 100,J02,769231,Hom; Kirstyn Courtney,14,0,15,1
1731502451879,SYN 100,K01,769233,Bishop; Graham,14,0,24,10
1731502451879,SYN 100,L01,769237,Difruscio; Mark,6,0,15,9
1731502451879,SYN 100,L02,769238,Difruscio; Mark,12,0,15,3
1731502451879,SYN 100,M01,769277,Gormally; Brenna,13,0,15,2
1731502451879,SYN 100,M02,769284,Gormally; Brenna,15,0,15,0
1731502451879,SYN 100,N01,769291,Rock; Martin,11,0,15,4
1731502451879,SYN 100,N02,769292,Rock; Martin,15,0,15,0
1731502451879,SYN 100,O01,769308,Atkinson; Arthur Laird,11,0,15,4
1731502451879,SYN 100,O02,769309,Atkinson; Arthur Laird,15,0,15,0
1731502452908,SYN 150,001,769422,Gladstein; Jill M,20,0,20,0
1731502452908,SYN 150,002,769423,Vega; Adrian,19,0,20,1
1731502452908,SYN 150,003,769424,Fish; Gwendolyn Anne,19,0,20,1
1731502452908,SYN 150,004,769427,Lagapa; Jason,20,0,20,0
1731502452908,SYN 150,005,769430,Lagapa; Jason,20,0,20,0
1731502452908,SYN 150,006,769431,Fish; Gwendolyn Anne,20,0,20,0
1731502452908,SYN 150,007,796615,Vega; Adrian,19,0,20,1
1731502453933,SYN 150R,001,769499,Vega; Adrian,20,0,20,0
1731502454962,TDAC 1,A00,760383,Walsh; Kim C.,11,0,20,9
1731502454962,TDAC 1,B00,760388,Walsh; Kim C.,19,0,20,1
1731502454962,TDAC 1,C00,760389,Walsh; Kim C.,19,0,20,1
1731502454962,TDAC 1,D00,760395,Walsh; Kim C.,16,0,20,4
1731502454962,TDAC 1,E00,760396,Walsh; Kim C.,17,0,20,3
1731502454962,TDAC 1,F00,760406,Walsh; Kim C.,17,0,20,3
1731502455989,TDAC 101,A00,760817,Harting; Carla Kelso,19,0,20,1
1731502455989,TDAC 101,B00,760819,Salovey; Todd,17,0,20,3
1731502457016,TDAC 102,A00,795388,Walsh; Kim C.,19,0,20,1
1731502458045,TDAC 108,A00,795390,Staff,14,0,16,2
1731502459076,TDAC 111,A00,760821,Meyer; Ursula,20,0,20,0
1731502460105,TDAC 115,A00,760822,Buescher; Stephen W.,14,0,20,6
1731502461139,TDAC 122,A00,795391,Perry; Lamar,30,0,30,0
1731502461139,TDAC 122,B00,796062,Celik; Aysan Karagasli,30,0,30,0
1731502462167,TDDE 1,A01,760433,Guirguis; Mark C,16,0,18,2
1731502462167,TDDE 1,A02,760434,Guirguis; Mark C,17,0,18,1
1731502462167,TDDE 1,A03,760436,Guirguis; Mark C,16,0,18,2
1731502462167,TDDE 1,A04,760513,Guirguis; Mark C,18,0,18,0
1731502462167,TDDE 1,A05,760515,Guirguis; Mark C,18,0,18,0
1731502463196,TDDE 111,A00,760823,Benzoni; Elisa,0,0,0,0
1731502464224,TDDE 130,A00,760827,Guirguis; Mark C,19,0,20,1
1731502465252,TDDE 132,A00,760828,Guirguis; Mark C,20,0,20,0
1731502466283,TDDM 1,A00,760516,Wilson; Terry A.,29,0,30,1
1731502467310,TDDM 101,A00,795403,Johnston; Holly,29,0,30,1
1731502468339,TDDR 101,A00,760835,Powell; Lora,28,0,30,2
1731502469368,TDDR 102,A00,760836,Powell; Lora,20,0,20,0
1731502470399,TDDR 190,A00,795392,Perry; Lamar,35,0,35,0
1731502471431,TDGE 1,A01,760522,Salovey; Todd,20,0,20,0
1731502471431,TDGE 1,A02,760523,Salovey; Todd,20,0,20,0
1731502471431,TDGE 1,A03,760526,Salovey; Todd,20,0,20,0
1731502471431,TDGE 1,A04,760531,Salovey; Todd,18,0,20,2
1731502471431,TDGE 1,A05,760546,Salovey; Todd,20,0,20,0
1731502471431,TDGE 1,A06,760784,Salovey; Todd,19,0,20,1
1731502472458,TDGE 11,A00,760785,Anderson; Mysia Anyse,128,0,146,18
1731502473486,TDGE 25,A00,760786,Harting; Carla Kelso,18,0,20,2
1731502473486,TDGE 25,B00,760788,Harting; Carla Kelso,17,0,20,3
1731502473486,TDGE 25,C00,760789,Harting; Carla Kelso,14,0,20,6
1731502473486,TDGE 25,D00,760790,Harting; Carla Kelso,16,0,20,4
1731502474511,TDGE 87,A00,760791,Guirguis; Mark C,20,0,20,0
1731502474511,TDGE 87,B00,795393,Adler; Steven,20,0,20,0
1731502475539,TDGE 124,A00,760838,Fulton; Julia,231,0,250,19
1731502476566,TDGE 127,A00,760839,Havis; Allan,218,0,225,7
1731502477592,TDGE 131,A00,760840,Burelle; Julie Sara Veronique,203,0,205,2
1731502478620,TDGR 210B,A00,760881,Celik; Aysan Karagasli,10,0,10,0
1731502479647,TDGR 212,A00,760883,Meyer; Ursula,10,0,10,0
1731502480676,TDGR 219,A00,760886,Perry; Lamar,0,0,0,0
1731502481708,TDGR 221A,A00,760887,Staff,10,0,10,0
1731502482738,TDGR 223B,A00,760889,Buescher; Stephen W.,10,0,10,0
1731502483766,TDGR 224B,A00,760890,Meyer; Ursula,10,0,10,0
1731502484799,TDGR 225B,A00,760891,Blair; Kyle Adam,10,0,10,0
1731502485828,TDGR 229,A00,760892,Brill; Robert L.,1,0,1,0
1731502485828,TDGR 229,B00,760893,Stalling; Vanessa,1,0,1,0
1731502485828,TDGR 229,C00,760894,Porter; Lisa,1,0,1,0
1731502486859,TDGR 244,A00,760895,Iizuka; Naomi Hisako,20,0,20,0
1731502487885,TDGR 245,A00,760898,Stalling; Vanessa,5,0,5,0
1731502488912,TDGR 250,A00,760899,Stein; Deborah Isobel,7,0,7,0
1731502489938,TDGR 251,A00,760900,Iizuka; Naomi Hisako,5,0,5,0
1731502489938,TDGR 251,B00,760901,Stein; Deborah Isobel,5,0,5,0
1731502490964,TDGR 257A,A00,760903,Staff,7,0,7,0
1731502491991,TDGR 262,A01,796141,Petrovich; Victoria A.,10,0,10,0
1731502493073,TDGR 269A,A00,760905,Petrovich; Victoria A.,18,0,20,2
1731502494099,TDGR 270C,A00,760909,Kuhl; Christopher August,20,0,20,0
1731502495125,TDGR 270D,A00,760911,McElver; Robert Harrison,20,0,20,0
1731502496155,TDGR 274,A00,760912,Brill; Robert L.,9,0,10,1
1731502497182,TDGR 275,A00,760913,Kuhl; Christopher August,10,0,10,0
1731502498208,TDGR 276,A00,760914,Benzoni; Elisa,10,0,10,0
1731502499235,TDGR 278,A00,760915,Staff,10,0,10,0
1731502499235,TDGR 278,B00,760919,Staff,20,0,20,0
1731502500262,TDGR 279,A00,760920,Benzoni; Elisa,5,0,5,0
1731502500262,TDGR 279,B00,760921,Petrovich; Victoria A.,4,0,5,1
1731502500262,TDGR 279,C00,760923,McElver; Robert Harrison,5,0,5,0
1731502500262,TDGR 279,D00,760924,Kuhl; Christopher August,5,0,5,0
1731502500262,TDGR 279,E00,760927,Brill; Robert L.,4,0,5,1
1731502501296,TDGR 282,A00,760930,McElver; Robert Harrison,10,0,10,0
1731502502324,TDGR 286,A00,760931,Staff,10,0,10,0
1731502503351,TDGR 288,A00,760932,Porter; Lisa,5,0,5,0
1731502504378,TDGR 289C,A00,760933,Mehrishi; Rishika,10,0,10,0
1731502505409,TDGR 289D,A00,760934,Power; Jade Yukana,10,0,10,0
1731502506435,TDGR 292,A00,760936,Burelle; Julie Sara Veronique,14,0,15,1
1731502507462,TDGR 293,A00,760937,Perry; Lamar,2,0,2,0
1731502508492,TDGR 296,A00,760938,Porter; Lisa,3,0,3,0
1731502508492,TDGR 296,B00,760939,Powell; Lora,3,0,3,0
1731502509518,TDGR 297,001,760940,Iizuka; Naomi Hisako,3,0,3,0
1731502510544,TDHD 20,A00,760792,Jun; Grace Shin Hae,20,0,20,0
1731502511578,TDHD 176,A00,795405,Staff,45,0,45,0
1731502512605,TDHT 10,A00,760794,Power; Jade Yukana,15,0,15,0
1731502512605,TDHT 10,B00,760795,Power; Jade Yukana,13,0,15,2
1731502513637,TDHT 22,A01,760797,Yapp; Hentyle T,24,0,24,0
1731502513637,TDHT 22,A02,760799,Yapp; Hentyle T,24,0,24,0
1731502513637,TDHT 22,A03,760801,Yapp; Hentyle T,21,0,24,3
1731502514682,TDHT 101,A00,760843,Mehrishi; Rishika,24,0,25,1
1731502514682,TDHT 101,B00,760845,Perry; Lamar,23,0,25,2
1731502515710,TDHT 102,A00,760846,Anderson; Mysia Anyse,24,0,25,1
1731502516735,TDHT 111,A00,760849,Power; Jade Yukana,17,0,20,3
1731502517765,TDMV 1,A00,760802,Arcidiacono; Kristin,25,0,30,5
1731502517765,TDMV 1,B00,760803,Staff,26,0,30,4
1731502518792,TDMV 2,A00,796063,Sammartano; Tonnie,20,0,30,10
1731502519822,TDMV 3,A00,760805,Mack; Kara Shanai',34,0,40,6
1731502520848,TDMV 11,A00,760807,Staff,28,0,30,2
1731502521880,TDMV 20,A00,760808,Alvarez; Ana Maria,0,0,0,0
1731502521880,TDMV 20,B00,760810,Smith; Alison D,30,0,30,0
1731502522905,TDMV 110,A00,760851,Weinberg; Sadie,30,0,30,0
1731502523931,TDMV 120,A00,760852,Yapp; Hentyle T,29,0,30,1
1731502523931,TDMV 120,B00,760853,Brown; Bernard Joseph,0,0,0,0
1731502524958,TDMV 123,A00,760855,Duran; Marcos Antonio,28,0,30,2
1731502525982,TDMV 130,A00,760856,Mack; Kara Shanai',40,0,40,0
1731502527008,TDMV 138,A00,795397,Corrales; Joseph Bernales,34,0,40,6
1731502528037,TDMV 140,A00,760857,Staff,37,0,40,3
1731502528037,TDMV 140,B00,760859,Corrales; Joseph Bernales,37,0,40,3
1731502528037,TDMV 140,C00,760860,Caligagan; Tony,37,0,40,3
1731502529063,TDMV 142,A00,760861,Blanco; Juan Carlos,28,0,30,2
1731502530090,TDMV 143,A00,760862,Fyall; Daunte Edward,30,0,30,0
1731502531118,TDMV 144,A00,760864,Staff,29,0,30,1
1731502532146,TDMV 146,A00,760866,Caligagan; Tony,28,0,30,2
1731502533173,TDMV 148,A00,760867,Jun; Grace Shin Hae,38,0,40,2
1731502534198,TDPF 161,A00,760869,Brown; Bernard Joseph,40,0,40,0
1731502535223,TDPF 163,A00,760870,Fyall; Daunte Edward,30,0,30,0
1731502535223,TDPF 163,B00,760871,Johnston; Holly,30,0,30,0
1731502535223,TDPF 163,C00,760872,Blanco; Juan Carlos,30,0,30,0
1731502536247,TDPR 6,A01,760812,Guirguis; Mark C,50,0,50,0
1731502536247,TDPR 6,A02,760814,Guirguis; Mark C,50,0,50,0
1731502537273,TDPR 102,A00,760873,Guirguis; Mark C,20,0,20,0
1731502538299,TDPR 104,A00,760874,Powell; Lora,15,0,15,0
1731502539327,TDPW 101,A00,760875,Stein; Deborah Isobel,20,0,20,0
1731502539327,TDPW 101,B00,760876,Stein; Deborah Isobel,19,0,20,1
1731502539327,TDPW 101,C00,760877,Stein; Deborah Isobel,20,0,20,0
1731502539327,TDPW 101,D00,760878,Stein; Deborah Isobel,18,0,20,2
1731502539327,TDPW 101,E00,760879,Stein; Deborah Isobel,20,0,20,0
1731502540354,TDPW 104,A00,760880,Staff,20,0,20,0
1731502541383,TDTR 10,A00,760815,Yapp; Hentyle T,30,0,30,0
1731502542413,TDTR 15,A00,760816,Smith; Alison D,29,0,30,1
1731502543441,TDTR 104,A00,795400,Smith; Alison D,30,0,30,0
1731502544471,TMC 15,A00,799598,Staff,25,0,25,0
1731502545500,TMC 20,A00,795572,Carver; Leslie J.,25,0,25,0
1731502546526,UROL 296,001,793638,Staff,10,0,10,0
1731502546526,UROL 296,002,793644,Staff,10,0,10,0
1731502547559,USP 2,A01,762958,Pezzoli; Keith,33,0,35,2
1731502547559,USP 2,A02,762960,Pezzoli; Keith,31,0,35,4
1731502548586,USP 3,A01,762962,Wickland; Teo Akande,34,0,35,1
1731502548586,USP 3,A02,762963,Wickland; Teo Akande,31,0,35,4
1731502549615,USP 4,A00,762964,Staff,27,0,30,3
1731502550643,USP 5,A01,762967,Sun; Feiyang,31,0,35,4
1731502550643,USP 5,A02,762968,Sun; Feiyang,33,0,35,2
1731502551671,USP 6,A01,762970,Shvartzberg Carrio; Manuel,35,0,35,0
1731502551671,USP 6,A02,762971,Shvartzberg Carrio; Manuel,34,0,35,1
1731502552705,USP 15,A01,762973,Anderson; William Raymond,32,0,35,3
1731502552705,USP 15,A02,762974,Anderson; William Raymond,34,0,35,1
1731502553731,USP 25,A00,762975,Shenkman; Michael Thomas,69,0,70,1
1731502554758,USP 100,A00,762976,Arroyo; John Christopher,66,0,70,4
1731502555784,USP 101,A00,762977,Staff,65,0,65,0
1731502556815,USP 108,A00,762978,Pezzoli; Keith,29,0,30,1
1731502557849,USP 124,A00,762979,Fulton; William,64,0,70,6
1731502558876,USP 128A,A01,762982,Lewis; Leslie R,13,0,13,0
1731502559902,USP 138,A00,762984,Anderson; William Raymond,25,0,25,0
1731502560931,USP 141A,A00,762985,Lewis; Leslie R,25,0,25,0
1731502561961,USP 143,A00,762986,Hinds; Juli Beth,198,0,225,27
1731502562988,USP 150,A00,762987,Osias; David,55,0,60,5
1731502564014,USP 151,A00,763006,Boomhower; Matthew Charles,68,0,70,2
1731502565046,USP 152A,A01,763042,Moeder; Nathan L,27,0,30,3
1731502565046,USP 152A,A02,763060,Moeder; Nathan L,30,0,30,0
1731502566072,USP 153,A00,763071,Shenkman; Michael Thomas,64,0,70,6
1731502567105,USP 158A,A00,798344,Bajaj; Ravi Siddharth,35,0,35,0
1731502568135,USP 159A,A00,763078,Gherini; Paul Pier-Carlo,8,0,8,0
1731502569160,USP 165A,A00,763079,Collins; Caroline Imani,23,0,25,2
1731502570189,USP 165B,A00,763083,Shilon; Mor,13,0,15,2
1731502571218,USP 170,A00,763084,Entezam; Maryam,48,0,50,2
1731502572250,USP 171,A00,763147,Lerner; Amy M,43,0,55,12
1731502573276,USP 173,A00,763151,Shvartzberg Carrio; Manuel,44,0,50,6
1731502574301,USP 175,A00,763152,Peerson; Susan,23,0,25,2
1731502575327,USP 177A,A00,763156,Velasco; Diego,24,0,25,1
1731502575327,USP 177A,B00,763158,Garcia; Kathleen,24,0,25,1
1731502576357,USP 179,A00,763161,Peerson; Susan,23,0,25,2
1731502577384,USP 180,A00,763164,Frank; Lawrence Douglas,28,0,30,2
1731502578410,USP 183,A00,763165,Sutton; April Marie,25,0,25,0
1731502579438,USP 185B,A01,763169,Boomhower; Matthew Charles,0,0,0,4
1731502579438,USP 185B,B01,763180,Sun; Feiyang,0,0,0,0
1731502580468,USP 187,A01,763190,Martin; Isaac,23,0,30,7
1731502580468,USP 187,A02,763196,Martin; Isaac,30,0,30,0
1731502581500,USP 188,A01,763235,Andrews; Abigail Leslie,28,0,30,2
1731502582527,USP 189,A00,763237,Arroyo; John Christopher,25,0,25,0
1731502582527,USP 189,B00,763240,Osias; David,23,0,25,2
1731502583553,USP 191A,A00,763243,Staff,15,0,20,5
1731502584579,USP 193,A00,795586,Devereux; Christina Schopp,22,0,25,3
1731502585605,USP 194,A00,770726,Hill; Seth J,9999,0,9999,0
1731502586631,USP 271,A00,763245,Lerner; Amy M,0,0,5,5
1731502587666,VIS 2,A01,769502,Segade; Alexandro Abraham,25,0,25,0
1731502587666,VIS 2,A02,769503,Segade; Alexandro Abraham,24,0,25,1
1731502587666,VIS 2,A03,769504,Segade; Alexandro Abraham,25,0,25,0
1731502587666,VIS 2,A04,769505,Segade; Alexandro Abraham,24,0,25,1
1731502587666,VIS 2,A05,769506,Segade; Alexandro Abraham,25,0,25,0
1731502587666,VIS 2,A06,769507,Segade; Alexandro Abraham,25,0,25,0
1731502587666,VIS 2,A07,769508,Segade; Alexandro Abraham,0,0,0,0
1731502587666,VIS 2,A08,769509,Segade; Alexandro Abraham,0,0,0,0
1731502588695,VIS 6,A00,769510,Staff,141,0,146,5
1731502590756,VIS 11,A01,769513,Cartwright; Lisa,33,0,34,1
1731502590756,VIS 11,A02,769514,Cartwright; Lisa,33,0,34,1
1731502590756,VIS 11,A03,769515,Cartwright; Lisa,34,0,34,0
1731502590756,VIS 11,A04,769516,Cartwright; Lisa,34,0,34,0
1731502590756,VIS 11,A05,769517,Cartwright; Lisa,34,0,34,0
1731502590756,VIS 11,A06,769519,Cartwright; Lisa,33,0,34,1
1731502590756,VIS 11,A07,769521,Cartwright; Lisa,31,0,34,3
1731502590756,VIS 11,A08,769522,Cartwright; Lisa,34,0,34,0
1731502590756,VIS 11,A09,769523,Cartwright; Lisa,33,0,34,1
1731502590756,VIS 11,A10,769524,Cartwright; Lisa,33,0,34,1
1731502590756,VIS 11,A11,769554,Cartwright; Lisa,34,0,34,0
1731502590756,VIS 11,A12,769557,Cartwright; Lisa,34,0,34,0
1731502591800,VIS 21B,A01,769570,Shen; Kuiyi,31,0,32,1
1731502591800,VIS 21B,A02,769571,Shen; Kuiyi,31,0,32,1
1731502591800,VIS 21B,A03,769587,Shen; Kuiyi,31,0,32,1
1731502591800,VIS 21B,A04,769600,Shen; Kuiyi,32,0,32,0
1731502591800,VIS 21B,A05,769639,Shen; Kuiyi,32,0,32,0
1731502591800,VIS 21B,A06,769693,Shen; Kuiyi,32,0,32,0
1731502591800,VIS 21B,A07,769710,Shen; Kuiyi,31,0,32,1
1731502591800,VIS 21B,A08,769755,Shen; Kuiyi,32,0,32,0
1731502592835,VIS 22,A01,769936,Rose; Jordan M,32,0,32,0
1731502592835,VIS 22,A02,769969,Rose; Jordan M,32,0,32,0
1731502592835,VIS 22,A03,769978,Rose; Jordan M,31,0,32,1
1731502592835,VIS 22,A04,770005,Rose; Jordan M,32,0,32,0
1731502592835,VIS 22,A05,770007,Rose; Jordan M,32,0,32,0
1731502592835,VIS 22,A06,770009,Rose; Jordan M,31,0,32,1
1731502592835,VIS 22,A07,770047,Rose; Jordan M,28,0,32,4
1731502592835,VIS 22,A08,770048,Rose; Jordan M,31,0,32,1
1731502592835,VIS 22,A09,770050,Rose; Jordan M,32,0,32,0
1731502592835,VIS 22,A10,770055,Rose; Jordan M,32,0,32,0
1731502592835,VIS 22,A11,770057,Rose; Jordan M,32,0,32,0
1731502592835,VIS 22,A12,770063,Rose; Jordan M,32,0,32,0
1731502593869,VIS 41,A01,770086,D'Elena-Tweed; Jessica Erin,24,0,25,1
1731502593869,VIS 41,A02,770194,D'Elena-Tweed; Jessica Erin,23,0,25,2
1731502593869,VIS 41,A03,770195,D'Elena-Tweed; Jessica Erin,23,0,25,2
1731502593869,VIS 41,A04,770196,D'Elena-Tweed; Jessica Erin,23,0,25,2
1731502593869,VIS 41,A05,770197,D'Elena-Tweed; Jessica Erin,24,0,25,1
1731502593869,VIS 41,A06,770198,D'Elena-Tweed; Jessica Erin,25,0,25,0
1731502593869,VIS 41,A07,770199,D'Elena-Tweed; Jessica Erin,25,0,25,0
1731502593869,VIS 41,A08,770200,D'Elena-Tweed; Jessica Erin,24,0,25,1
1731502594902,VIS 60,A01,770202,Mostajo; Lorena,25,0,25,0
1731502594902,VIS 60,A02,770203,Mostajo; Lorena,25,0,25,0
1731502594902,VIS 60,A03,770204,Mostajo; Lorena,25,0,25,0
1731502594902,VIS 60,A04,770205,Mostajo; Lorena,25,0,25,0
1731502594902,VIS 60,A05,770206,Mostajo; Lorena,25,0,25,0
1731502594902,VIS 60,A06,770207,Mostajo; Lorena,25,0,25,0
1731502595928,VIS 83,A00,770208,Kester; Grant,195,0,200,5
1731502596957,VIS 100,A00,770210,Cruz; Edwin Teddy,140,0,146,6
1731502597989,VIS 101A,A00,770215,Park; Kyong Dong,10,0,15,5
1731502597989,VIS 101A,B00,770229,Riley; Joe,13,0,15,2
1731502599012,VIS 103,A00,770230,Cruz; Edwin Teddy,145,0,146,1
1731502600041,VIS 103B,A00,770234,Park; Kyong Dong,74,0,75,1
1731502601070,VIS 105A,A00,770237,Tonies; Joshua Vanjaymes,24,0,30,6
1731502602094,VIS 105B,A00,770239,Tonies; Joshua Vanjaymes,27,0,30,3
1731502603124,VIS 105C,A00,770240,Adler; Amy,13,0,15,2
1731502604150,VIS 106A,A00,770241,Tobe; Geoffroy,25,0,25,0
1731502604150,VIS 106A,B00,770243,De Luca; Mara Julia,22,0,25,3
1731502605177,VIS 106B,A00,770244,De Luca; Mara Julia,22,0,25,3
1731502606205,VIS 107A,A00,770248,Iglesias; Janelle Ann,21,0,25,4
1731502607229,VIS 107C,A00,770249,Staff,15,0,15,0
1731502608256,VIS 108,A00,770250,Moss; Ceci,15,0,15,0
1731502608256,VIS 108,B00,770251,Adler; Amy,11,0,15,4
1731502609283,VIS 110D,A00,770253,Dean; Danielle Adobi,11,0,15,4
1731502610308,VIS 110F,A00,770254,Iglesias; Janelle Ann,14,0,15,1
1731502611335,VIS 110M,A00,770256,Dean; Danielle Adobi,15,0,15,0
1731502612362,VIS 112,A00,770257,Welchman; John C.,12,0,15,3
1731502613390,VIS 114B,A00,770260,Tronzo; William,12,0,15,3
1731502614418,VIS 124G,A00,770261,Rose; Jordan M,72,0,75,3
1731502615444,VIS 125G,A00,770262,Kester; Grant,75,0,75,0
1731502616470,VIS 126HN,A00,770264,Newsome; Elizabeth Ann,74,0,75,1
1731502617498,VIS 128C,A00,770265,Gaines; Malik Julian,75,0,75,0
1731502618526,VIS 128D,A00,770267,Asplund; Ingrid Marie,73,0,75,2
1731502619552,VIS 129E,A00,770268,Shen; Kuiyi,15,0,15,0
1731502620580,VIS 131,A00,770269,Erdmann; Dean,15,0,15,0
1731502621607,VIS 133,A01,770274,Staff,34,0,34,0
1731502621607,VIS 133,A02,770275,Staff,33,0,34,1
1731502622635,VIS 133A,A00,770276,Staff,13,0,15,2
1731502623663,VIS 135,A01,770280,Staff,21,0,22,1
1731502623663,VIS 135,A02,770281,Staff,16,0,22,6
1731502624691,VIS 141A,A01,770284,Stalbaum; Brett,23,0,25,2
1731502624691,VIS 141A,A02,770285,Stalbaum; Brett,21,0,25,4
1731502625720,VIS 142,A01,770287,Stalbaum; Brett,25,0,25,0
1731502625720,VIS 142,A02,770288,Stalbaum; Brett,25,0,25,0
1731502625720,VIS 142,A03,770290,Stalbaum; Brett,25,0,25,0
1731502625720,VIS 142,A04,770291,Stalbaum; Brett,25,0,25,0
1731502625720,VIS 142,A05,770292,Stalbaum; Brett,24,0,25,1
1731502625720,VIS 142,A06,770293,Stalbaum; Brett,25,0,25,0
1731502626750,VIS 145A,A01,770301,Stone; Patricia,20,0,22,2
1731502626750,VIS 145A,A02,770302,Stone; Patricia,22,0,22,0
1731502626750,VIS 145A,A03,770303,Stone; Patricia,22,0,22,0
1731502626750,VIS 145A,A04,770304,Stone; Patricia,20,0,22,2
1731502626750,VIS 145A,A05,770306,Stone; Patricia,21,0,22,1
1731502626750,VIS 145A,A06,770307,Stone; Patricia,21,0,22,1
1731502627779,VIS 146B,A00,794512,Twomey; Robert Daniel,15,0,15,0
1731502628804,VIS 147A,A01,770309,Staff,22,0,22,0
1731502628804,VIS 147A,A02,770311,Staff,20,0,22,2
1731502628804,VIS 147A,A03,770312,Staff,22,0,22,0
1731502628804,VIS 147A,A04,770313,Staff,22,0,22,0
1731502629832,VIS 147B,A00,770316,Akten; Mehmet,11,0,15,4
1731502630866,VIS 149,A00,770318,Alexander; Amy J,14,0,15,1
1731502630866,VIS 149,B00,795449,Crandall; Jordan,13,0,15,2
1731502631893,VIS 150,A00,770319,Wardwell; Mariana Razo,70,0,75,5
1731502632923,VIS 157D,A01,770329,Williams; Alena J,33,0,34,1
1731502632923,VIS 157D,A02,770334,Williams; Alena J,33,0,34,1
1731502633948,VIS 160A,A00,770375,Akten; Mehmet,9,0,15,6
1731502633948,VIS 160A,B00,770380,Alexander; Amy J,14,0,15,1
1731502633948,VIS 160A,C00,770391,Twomey; Robert Daniel,11,0,15,4
1731502634974,VIS 161,A00,770470,D'Elena-Tweed; Jessica Erin,14,0,15,1
1731502636009,VIS 164,A00,770484,Cross; Brian R,19,0,22,3
1731502636009,VIS 164,B00,770535,Erdmann; Dean,22,0,22,0
1731502637038,VIS 165B,A00,770548,Sprague; Sean Jeffrey,20,0,22,2
1731502638064,VIS 169A,A00,770551,Mostajo; Lorena,20,0,22,2
1731502639090,VIS 171,A00,770552,Dinco; Dino,22,0,22,0
1731502640121,VIS 174,A00,770599,Cross; Brian R,20,0,22,2
1731502640121,VIS 174,B00,770666,Dinco; Dino,21,0,22,1
1731502640121,VIS 174,C00,770705,Dinco; Dino,22,0,22,0
1731502641145,VIS 179,A00,770708,Zurita; Dmitri,22,0,22,0
1731502642169,VIS 180A,A00,770709,Erdmann; Dean,22,0,22,0
1731502643194,VIS 180B,A00,770710,Stone; Patricia,21,0,22,1
1731502644219,VIS 182A,A00,770711,Sprague; Sean Jeffrey,21,0,22,1
1731502645244,VIS 185,A00,770712,Trigilio; Michael,17,0,22,5
1731502646268,VIS 200,A00,770713,Wardwell; Mariana Razo,12,0,15,3
1731502647297,VIS 201,A00,770714,Bratton; Benjamin H.,10,0,15,5
1731502648321,VIS 202,A00,770715,Mangolte; Babette,2,0,15,13
1731502649419,VIS 203,A00,770716,Segade; Alexandro Abraham,0,0,15,15
1731502650444,VIS 242,A00,770718,Cartwright; Lisa,8,0,15,7
1731502651469,VIS 255,A00,770719,Welchman; John C.,8,0,15,7
1731502652494,VIS 260,A00,770720,Newsome; Elizabeth Ann,9,0,15,6
1731502653547,WCWP 10A,001,765834,Staff,0,0,0,0
1731502653547,WCWP 10A,002,765835,Windham; Emily,13,0,20,7
1731502653547,WCWP 10A,003,765836,Windham; Emily,17,0,20,3
1731502653547,WCWP 10A,004,765837,Escobar; Jordan Christophe,17,0,20,3
1731502653547,WCWP 10A,005,765838,Windham; Emily,16,0,20,4
1731502653547,WCWP 10A,006,765839,Escobar; Jordan Christophe,18,0,20,2
1731502653547,WCWP 10A,007,765840,Escobar; Jordan Christophe,19,0,20,1
1731502653547,WCWP 10A,008,765841,Staff,0,0,0,0
1731502653547,WCWP 10A,009,765842,Merryman; Walter,19,0,20,1
1731502653547,WCWP 10A,010,765843,Merryman; Walter,18,0,20,2
1731502653547,WCWP 10A,011,765844,Staff,0,0,0,0
1731502653547,WCWP 10A,012,765855,Staff,0,0,0,0
1731502653547,WCWP 10A,013,766004,Staff,0,0,0,0
1731502653547,WCWP 10A,014,766006,Susi; Natalie,15,0,20,5
1731502653547,WCWP 10A,015,766008,Welji; Haleema Nazir,18,0,20,2
1731502653547,WCWP 10A,016,766010,Martiniuk; Jill,19,0,20,1
1731502653547,WCWP 10A,017,766012,Martiniuk; Jill,16,0,20,4
1731502653547,WCWP 10A,018,766050,Staff,0,0,0,0
1731502653547,WCWP 10A,019,766051,Martiniuk; Jill,14,0,20,6
1731502653547,WCWP 10A,020,766052,Staff,0,0,0,0
1731502653547,WCWP 10A,021,766053,Holloway Ii; Mathew,19,0,20,1
1731502653547,WCWP 10A,022,766054,Holloway Ii; Mathew,20,0,20,0
1731502653547,WCWP 10A,023,766055,Holloway Ii; Mathew,20,0,20,0
1731502654592,WCWP 10B,001,766056,Staff,0,0,0,0
1731502654592,WCWP 10B,002,766057,Ornelas; Tricia,19,0,20,1
1731502654592,WCWP 10B,003,766058,Ornelas; Tricia,19,0,20,1
1731502654592,WCWP 10B,004,766119,Gagnon; Jeffrey C,0,0,0,0
1731502654592,WCWP 10B,005,766120,Ornelas; Tricia,15,0,20,5
1731502654592,WCWP 10B,006,766127,Staff,0,0,0,0
1731502654592,WCWP 10B,007,766162,Staff,0,0,0,0
1731502654592,WCWP 10B,008,766181,Dhir; Simrita,20,0,20,0
1731502654592,WCWP 10B,009,766182,Dhir; Simrita,17,0,20,3
1731502654592,WCWP 10B,010,766186,Uriarte; Emma,11,0,20,9
1731502654592,WCWP 10B,011,766187,Dhir; Simrita,18,0,20,2
1731502654592,WCWP 10B,012,766188,Uriarte; Emma,12,0,20,8
1731502654592,WCWP 10B,013,766189,Staff,0,0,0,0
1731502654592,WCWP 10B,014,766190,Staff,0,0,0,0
1731502654592,WCWP 10B,015,766191,Staff,0,0,0,0
1731502654592,WCWP 10B,016,766193,Staff,0,0,0,0
1731502654592,WCWP 10B,017,766194,Staff,0,0,0,0
1731502654592,WCWP 10B,018,766195,Staff,0,0,0,0
1731502654592,WCWP 10B,019,766196,Staff,0,0,0,0
1731502654592,WCWP 10B,020,766198,Staff,0,0,0,0
1731502654592,WCWP 10B,021,766201,Staff,0,0,0,0
1731502654592,WCWP 10B,022,766203,Staff,0,0,0,0
1731502654592,WCWP 10B,023,766204,Staff,0,0,0,0
1731502654592,WCWP 10B,024,766205,Staff,0,0,0,0
1731502654592,WCWP 10B,025,766207,Staff,0,0,0,0
1731502654592,WCWP 10B,026,766208,Staff,0,0,0,0
1731502654592,WCWP 10B,027,766209,Staff,0,0,0,0
1731502654592,WCWP 10B,028,766210,Staff,0,0,0,0
1731502655620,WCWP 100,A00,766213,McCleary; Keith Long,17,0,20,3
1731502655620,WCWP 100,B00,766215,McCleary; Keith Long,20,0,20,0
1731502655620,WCWP 100,C00,766217,McCleary; Keith Long,20,0,20,0
1731502655620,WCWP 100,D00,766220,Twohig; Niall Ivan,17,0,20,3
1731502655620,WCWP 100,E00,766221,Twohig; Niall Ivan,14,0,20,6
1731502655620,WCWP 100,F00,766222,Young; Mark T,19,0,20,1
1731502655620,WCWP 100,G00,766223,Young; Mark T,18,0,20,2
1731502655620,WCWP 100,H00,766224,Twohig; Niall Ivan,20,0,20,0
1731502655620,WCWP 100,I00,766228,Young; Mark T,19,0,20,1
1731502656651,WES 237A,A00,763250,Weibel; Nadir,15,0,15,0
1731502657684,WES 268B,A01,763253,Ling; Patrick L,15,0,15,0
1731502658711,WES 269,A00,763255,Pannuto; Patrick William,15,0,15,0
1731502660930,AAPI 198,A00,795102,Solomon; Amanda Lee Albaniel,9999,0,9999,0
1731502661958,AAS 10,A01,734476,Butler; Elizabeth Annette,32,0,34,2
1731502661958,AAS 10,A02,734477,Butler; Elizabeth Annette,33,0,34,1
1731502662988,AAS 11,A01,734479,Butler; Elizabeth Annette,33,0,34,1
1731502662988,AAS 11,A02,734480,Butler; Elizabeth Annette,33,0,34,1
1731502664016,AESE 241,A00,733587,Erat; Sanjiv & Wade; Jon P,35,0,35,0
1731502665042,AESE 278B,A00,733588,Gessner; Richard K.,35,0,35,0
1731502666068,AESE 278C,A00,733589,Wade; Jon P,35,0,35,0
1731502667098,AESE 279A,A00,733591,Zak; Alexander & Wade; Jon P,35,0,35,0
1731502668128,ANAR 121,A01,733532,Staff,39,0,40,1
1731502669160,ANAR 143,A00,799583,Dunseth; Zachary Clark,29,0,30,1
1731502670187,ANAR 158,A00,733535,Goldstein; Paul S,36,0,40,4
1731502671213,ANAR 164,A00,733536,Staff,44,0,45,1
1731502672239,ANAR 165,A00,799586,Staff,30,0,30,0
1731502673269,ANBI 100,A00,733537,Fox; Patrick Keolu Ozer,39,0,40,1
1731502674293,ANBI 130,A00,733538,Non; Amy L,55,0,70,15
1731502675326,ANBI 134,A00,733552,Simonson; Tatum Sasha Summ,28,0,30,2
1731502676356,ANBI 140,A00,733553,Staff,34,0,40,6
1731502677387,ANBI 143,A00,733554,Wilder; Linnea Lorene,36,0,40,4
1731502678417,ANBI 173,A00,733555,Wilder; Linnea Lorene,69,0,70,1
1731502679442,ANES 296,001,791559,Staff,10,0,10,0
1731502679442,ANES 296,002,791560,Staff,10,0,10,0
1731502679442,ANES 296,003,791561,Staff,10,0,10,0
1731502680474,ANSC 101A,A00,733558,Kang; Byung Chu,148,0,150,2
1731502681500,ANSC 109,A00,733559,Pedersen; David,40,0,40,0
1731502682536,ANSC 125,A00,733560,Brenner; Suzanne A,65,0,70,5
1731502683565,ANSC 135,A00,733561,Stone; Annika Britt,38,0,40,2
1731502684593,ANSC 139,A00,733562,Csordas; Thomas J.,20,0,20,0
1731502685617,ANSC 146,A00,733563,Kang; Byung Chu,69,0,70,1
1731502686645,ANSC 148,A00,733564,Schonberg; Jeffrey,46,0,46,0
1731502687672,ANSC 150,A00,733565,Sloane; Julia Kathryn,35,0,35,0
1731502688702,ANSC 154,A00,733566,Brenner; Suzanne A,10,0,12,2
1731502689735,ANSC 164,A00,733567,Stewart; Alexander B,37,0,40,3
1731502690762,ANSC 184,A00,733568,Fortier; Jana,40,0,40,0
1731502691788,ANSC 190,A00,733569,Jassal; Aftab,39,0,40,1
1731502692816,ANTH 5,A00,733397,Semendeferi; Ekaterini,20,0,20,0
1731502693846,ANTH 10,A00,733400,Staff,247,0,250,3
1731502694879,ANTH 21,A01,733407,Stone; Annika Britt,30,0,30,0
1731502694879,ANTH 21,A02,733409,Stone; Annika Britt,29,0,30,1
1731502694879,ANTH 21,A03,733411,Stone; Annika Britt,27,0,30,3
1731502694879,ANTH 21,A04,733414,Stone; Annika Britt,24,0,30,6
1731502694879,ANTH 21,A05,733416,Stone; Annika Britt,27,0,30,3
1731502695911,ANTH 23,A01,733472,Stewart; Alexander B,35,0,35,0
1731502695911,ANTH 23,A02,733501,Stewart; Alexander B,34,0,35,1
1731502695911,ANTH 23,A03,733502,Stewart; Alexander B,34,0,35,1
1731502695911,ANTH 23,A04,733507,Stewart; Alexander B,35,0,35,0
1731502695911,ANTH 23,A05,733525,Stewart; Alexander B,35,0,35,0
1731502695911,ANTH 23,A06,733528,Stewart; Alexander B,35,0,35,0
1731502696939,ANTH 45,A00,733530,Jassal; Aftab,30,0,30,0
1731502697969,ANTH 87,A00,795649,Pedersen; David,20,0,20,0
1731502698997,ANTH 102,A00,733570,Fox; Patrick Keolu Ozer,144,0,150,6
1731502700022,ANTH 106,A00,733571,Sloane; Julia Kathryn,30,0,30,0
1731502701048,ANTH 107,A00,733572,Shtienberg; Gilad,28,0,30,2
1731502702079,ANTH 111,A00,733573,Bialecki; Jon Anthony,39,0,40,1
1731502703111,ANTH 128A,A01,733576,Lewis; Leslie R,12,0,12,0
1731502704139,ANTH 196B,A00,733577,Varma; Saiba,15,0,15,0
1731502705164,ANTH 200,A00,733578,Fox; Patrick Keolu Ozer,15,0,15,0
1731502706191,ANTH 203,A00,733579,Gagneux; Pascal,9,0,15,6
1731502707217,ANTH 212,A00,733582,Marchetto; Maria Carolina,14,0,15,1
1731502708243,ANTH 230,001,799994,Gagneux; Pascal,19,0,20,1
1731502709272,ANTH 231,A00,799587,Staff,13,0,15,2
1731502710298,ANTH 236,A00,733583,Csordas; Thomas J.,9,0,12,3
1731502711323,ANTH 269,A00,733584,Lampland; Martha,5,0,5,0
1731502712353,ANTH 273,A00,733585,McKenzie; Kerry V.,5,0,5,0
1731502713379,ANTH 280F,A00,733586,Yeh; Rihan Wen Xin,13,0,15,2
1731502714422,ANTH 295,001,799995,Algaze; Guillermo,3,0,3,0
1731502714422,ANTH 295,002,799996,Brenner; Suzanne A,3,0,3,0
1731502714422,ANTH 295,003,799997,Csordas; Thomas J.,3,0,3,0
1731502714422,ANTH 295,004,799998,Fox; Patrick Keolu Ozer,3,0,3,0
1731502714422,ANTH 295,005,799999,Gagneux; Pascal,3,0,3,0
1731502714422,ANTH 295,006,800000,Goldstein; Paul S,3,0,3,0
1731502714422,ANTH 295,007,800001,Hankins; Joseph D.,3,0,3,0
1731502714422,ANTH 295,008,800002,Jassal; Aftab,3,0,3,0
1731502714422,ANTH 295,009,800035,Jenkins; Janis A.,3,0,3,0
1731502714422,ANTH 295,010,800036,Kaiser; Bronwyn Nicole,3,0,3,0
1731502714422,ANTH 295,011,800037,Kang; Byung Chu,3,0,3,0
1731502714422,ANTH 295,012,800038,Marchetto; Maria Carolina,3,0,3,0
1731502714422,ANTH 295,013,800039,Non; Amy L,3,0,3,0
1731502714422,ANTH 295,014,800040,Pedersen; David,3,0,3,0
1731502714422,ANTH 295,015,800041,Rivera-Collazo; Isabel C,3,0,3,0
1731502714422,ANTH 295,016,800042,Varma; Saiba,3,0,3,0
1731502714422,ANTH 295,017,800043,Yeh; Rihan Wen Xin,3,0,3,0
1731502715451,ANTH 296,001,800044,Braswell; Geoffrey E.,3,0,3,0
1731502715451,ANTH 296,002,800045,Marchetto; Maria Carolina,3,0,3,0
1731502715451,ANTH 296,003,800107,Rivera-Collazo; Isabel C,3,0,3,0
1731502715451,ANTH 296,004,800108,Varma; Saiba,2,0,3,1
1731502715451,ANTH 296,005,800109,Algaze; Guillermo,3,0,3,0
1731502715451,ANTH 296,006,800110,Brenner; Suzanne A,3,0,3,0
1731502715451,ANTH 296,007,800111,Csordas; Thomas J.,3,0,3,0
1731502715451,ANTH 296,008,800112,Fox; Patrick Keolu Ozer,3,0,3,0
1731502715451,ANTH 296,009,800113,Gagneux; Pascal,3,0,3,0
1731502715451,ANTH 296,010,800114,Goldstein; Paul S,2,0,3,1
1731502715451,ANTH 296,011,800116,Hankins; Joseph D.,3,0,3,0
1731502715451,ANTH 296,012,800117,Jassal; Aftab,3,0,3,0
1731502715451,ANTH 296,013,800118,Jenkins; Janis A.,3,0,3,0
1731502715451,ANTH 296,014,800119,Kaiser; Bronwyn Nicole,2,0,3,1
1731502715451,ANTH 296,015,800120,Kang; Byung Chu,3,0,3,0
1731502715451,ANTH 296,016,800121,Levy; Thomas E,3,0,3,0
1731502715451,ANTH 296,017,800122,Non; Amy L,3,0,3,0
1731502715451,ANTH 296,018,800123,Pedersen; David,3,0,3,0
1731502715451,ANTH 296,019,800184,Postero; Nancy Grey,3,0,3,0
1731502715451,ANTH 296,020,800185,Semendeferi; Ekaterini,3,0,3,0
1731502715451,ANTH 296,021,800186,Yeh; Rihan Wen Xin,3,0,3,0
1731502716479,ASTR 3,A01,733595,Trumbo; Samantha Kathleen,294,0,300,6
1731502717511,ASTR 20B,A01,733598,Konopacky; Quinn Morgan,49,0,50,1
1731502718538,ASTR 99,001,799856,Konopacky; Quinn Morgan,9999,0,9999,0
1731502719571,ASTR 102,A01,733600,Diamond; Patrick H & Konopacky; Quinn Morgan,29,0,30,1
1731502720604,ASTR 105,A01,733607,Boggs; Steven Edward,30,0,30,0
1731502721634,ASTR 122,A01,733609,Keres; Dusan,40,0,40,0
1731502722661,ASTR 150,A01,733641,Theissen; Christopher Alexander,28,0,30,2
1731502722661,ASTR 150,A02,733642,Theissen; Christopher Alexander,28,0,30,2
1731502723689,ASTR 201,A00,790490,Burgasser; Adam Jonathan,9,0,15,6
1731502724716,ASTR 210,A00,733648,Staff,12,0,15,3
1731502725744,ASTR 220,A00,733650,Wright; Shelley Adams,12,0,15,3
1731502726775,ASTR 250,A00,733652,Theissen; Christopher Alexander & Hosseinzadeh; Griffin Alex,22,0,30,8
1731502727804,ASTR 251,A00,733653,Theissen; Christopher Alexander & Hosseinzadeh; Griffin Alex,23,0,30,7
1731502728835,AUD 236,A01,791504,Harris; Jeffrey Paul,5,0,5,0
1731502729879,AUD 263,A00,791538,Zettner; Erika,13,0,13,0
1731502730907,AUD 276,A00,791507,Zettner; Erika,13,0,13,0
1731502731932,AUD 284,A01,791509,Zettner; Erika,13,0,13,0
1731502732957,AUD 291,A00,791534,Zettner; Erika,13,0,13,0
1731502733983,AUD 296,A00,791535,Zettner; Erika,13,0,13,0
1731502735025,AWP 3,002,733077,Ajo; Frances Margaret,12,0,12,0
1731502735025,AWP 3,003,733078,Given; William Allan,12,0,12,0
1731502735025,AWP 3,004,733080,Ajo; Frances Margaret,12,0,12,0
1731502735025,AWP 3,005,733082,Westerfeld; Kevin John,12,0,12,0
1731502735025,AWP 3,007,733085,O'Neil; Courtney L,12,0,12,0
1731502735025,AWP 3,008,733087,O'Neil; Courtney L,12,0,12,0
1731502735025,AWP 3,009,733138,Zimmerman; Guy,12,0,12,0
1731502735025,AWP 3,010,733139,Zimmerman; Guy,12,0,12,0
1731502735025,AWP 3,011,733140,Westerfeld; Kevin John,12,0,12,0
1731502735025,AWP 3,012,733141,Zimmerman; Guy,11,0,12,1
1731502735025,AWP 3,013,733142,Sartor; Alexandra,12,0,12,0
1731502735025,AWP 3,014,733143,Sartor; Alexandra,12,0,12,0
1731502735025,AWP 3,015,733144,Vaughn; Kelsey Sara,12,0,12,0
1731502735025,AWP 3,016,733145,Vaughn; Kelsey Sara,12,0,12,0
1731502735025,AWP 3,019,733148,Kolodezh; Samuel,12,0,12,0
1731502735025,AWP 3,020,733149,Kolodezh; Samuel,12,0,12,0
1731502735025,AWP 3,022,733151,Kolodezh; Samuel,12,0,12,0
1731502736071,AWP 4A,001,733154,Tsurska Svetina; Olena,13,0,14,1
1731502736071,AWP 4A,002,733156,Tsurska Svetina; Olena,10,0,14,4
1731502736071,AWP 4A,003,733157,Chandler; Bailee Daniele,12,0,14,2
1731502736071,AWP 4A,004,733158,Chandler; Bailee Daniele,13,0,14,1
1731502736071,AWP 4A,005,733159,Hall; Graham T,14,0,14,0
1731502736071,AWP 4A,006,733160,Hall; Graham T,14,0,14,0
1731502736071,AWP 4A,007,733161,Falcon; Jennifer A,14,0,14,0
1731502736071,AWP 4A,008,733162,Falcon; Jennifer A,13,0,14,1
1731502736071,AWP 4A,011,733165,Tiernan; Christa Michelle,14,0,14,0
1731502736071,AWP 4A,012,733166,Tiernan; Christa Michelle,12,0,14,2
1731502736071,AWP 4A,013,733168,Gardella; Alexander Drew,14,0,14,0
1731502736071,AWP 4A,014,733169,Gardella; Alexander Drew,12,0,14,2
1731502736071,AWP 4A,016,733171,Coulter; Jane Elisabeth,14,0,14,0
1731502736071,AWP 4A,017,733172,Spicer; Jacqueline,14,0,14,0
1731502736071,AWP 4A,018,733173,Spicer; Jacqueline,14,0,14,0
1731502736071,AWP 4A,019,733174,Christie; Veronica Ann,14,0,14,0
1731502736071,AWP 4A,020,733175,Bolin; Jillian,14,0,14,0
1731502736071,AWP 4A,021,733176,Bolin; Jillian,14,0,14,0
1731502736071,AWP 4A,022,733177,Zroka; Amy Liane,14,0,14,0
1731502736071,AWP 4A,023,733178,Zroka; Amy Liane,14,0,14,0
1731502736071,AWP 4A,024,733179,Christie; Veronica Ann,13,0,14,1
1731502736071,AWP 4A,025,733181,Steinberg; Stacy A,14,0,14,0
1731502736071,AWP 4A,026,733182,Steinberg; Stacy A,12,0,14,2
1731502736071,AWP 4A,027,733184,Gilmore; Lauren Monica,14,0,14,0
1731502736071,AWP 4A,028,733185,Gilmore; Lauren Monica,14,0,14,0
1731502736071,AWP 4A,032,733195,Grant; Melinda G,14,0,14,0
1731502736071,AWP 4A,033,733198,Grant; Melinda G,14,0,14,0
1731502736071,AWP 4A,037,733286,Jones; William Jadie,13,0,14,1
1731502736071,AWP 4A,038,733310,Jones; William Jadie,14,0,14,0
1731502736071,AWP 4A,039,733318,Heiser; Jerrod A,14,0,14,0
1731502736071,AWP 4A,040,733320,Heiser; Jerrod A,13,0,14,1
1731502736071,AWP 4A,041,733321,Bourdeau; Joseph Albert,14,0,14,0
1731502736071,AWP 4A,042,733331,Bourdeau; Joseph Albert,14,0,14,0
1731502736071,AWP 4A,043,733337,Wilson; Natalie Ann,13,0,14,1
1731502736071,AWP 4A,044,733378,Wilson; Natalie Ann,12,0,14,2
1731502736071,AWP 4A,045,733379,Staff,14,0,14,0
1731502736071,AWP 4A,046,733380,Staff,14,0,14,0
1731502736071,AWP 4A,047,733385,Staff,14,0,14,0
1731502736071,AWP 4A,048,733386,Staff,14,0,14,0
1731502736071,AWP 4A,049,733388,Staff,0,0,0,0
1731502736071,AWP 4A,050,733389,Staff,0,0,0,0
1731502736071,AWP 4A,051,733390,Staff,0,0,0,0
1731502736071,AWP 4A,052,733392,Staff,0,0,0,0
1731502736071,AWP 4A,053,733394,Staff,0,0,0,0
1731502736071,AWP 4A,054,733395,Staff,0,0,0,0
1731502737097,BENG 1,A01,733659,Sah; Robert Lie-Yuan,62,0,65,3
1731502737097,BENG 1,A02,733715,Sah; Robert Lie-Yuan,60,0,65,5
1731502737097,BENG 1,A03,733716,Sah; Robert Lie-Yuan,63,0,65,2
1731502738125,BENG 112A,A01,733831,Schmid-Schoenbein; Geert W,28,0,35,7
1731502738125,BENG 112A,A02,733832,Schmid-Schoenbein; Geert W,34,0,35,1
1731502739151,BENG 119B,A00,733833,Taylor Amos; Alyssa C,22,0,30,8
1731502740178,BENG 120,A01,733837,Huang; Xiaohua,35,0,35,0
1731502740178,BENG 120,A02,733843,Huang; Xiaohua,33,0,35,2
1731502741205,BENG 123,A01,733846,Palsson; Bernhard O.,24,0,30,6
1731502741205,BENG 123,A02,733847,Palsson; Bernhard O.,24,0,30,6
1731502742232,BENG 126B,A00,733850,Taylor Amos; Alyssa C,26,0,30,4
1731502743258,BENG 127B,A00,733860,Taylor Amos; Alyssa C,30,0,30,0
1731502744286,BENG 128B,A00,733862,Taylor Amos; Alyssa C,30,0,30,0
1731502745317,BENG 129B,A00,733865,Taylor Amos; Alyssa C,30,0,30,0
1731502746342,BENG 130,A00,733907,Subramaniam; Shankar,141,0,145,4
1731502747371,BENG 139B,A00,734022,Taylor Amos; Alyssa C,30,0,30,0
1731502748404,BENG 140A,A01,734136,Silva; Gabriel,27,0,30,3
1731502748404,BENG 140A,A02,734141,Silva; Gabriel,25,0,30,5
1731502748404,BENG 140A,A03,734146,Silva; Gabriel,25,0,30,5
1731502749429,BENG 147B,A00,734149,Taylor Amos; Alyssa C,28,0,30,2
1731502750456,BENG 148B,A00,734154,Taylor Amos; Alyssa C,25,0,30,5
1731502751486,BENG 149B,A00,734172,Taylor Amos; Alyssa C,30,0,30,0
1731502752520,BENG 152,A01,734185,Taylor Amos; Alyssa C,19,0,20,1
1731502753603,BENG 161B,A00,734193,Huang; Xiaohua,55,0,70,15
1731502754658,BENG 168,A01,734228,Shi; Lingyan,22,0,40,18
1731502754658,BENG 168,A02,734229,Shi; Lingyan,39,0,40,1
1731502754658,BENG 168,A03,734231,Shi; Lingyan,37,0,40,3
1731502755684,BENG 169B,A00,734233,Taylor Amos; Alyssa C,24,0,30,6
1731502756710,BENG 179B,A00,734243,Taylor Amos; Alyssa C,28,0,30,2
1731502757760,BENG 181,A01,734246,Pevzner; Pavel Arkadjevich,37,0,40,3
1731502758787,BENG 186B,A01,734248,Cauwenberghs; Gert,69,0,70,1
1731502759817,BENG 187C,A00,734249,Taylor Amos; Alyssa C,121,0,170,49
1731502760846,BENG 189,A00,734250,Contijoch; Francisco,26,0,30,4
1731502761872,BENG 191,A00,734252,Lal; Ratnesh,15,0,20,5
1731502762902,BENG 202,A00,734255,Pevzner; Pavel Arkadjevich,25,0,25,0
1731502763927,BENG 204,A01,734257,Subramaniam; Shankar,0,0,50,50
1731502764959,BENG 207,A00,734258,Friend; James Robert,0,0,0,0
1731502765985,BENG 212,A00,734259,Palsson; Bernhard O.,0,0,20,20
1731502767011,BENG 223,A00,734260,Kravets; Vira V.,0,0,60,60
1731502768040,BENG 225,A01,734263,Bartko; Andrew Peter,0,0,0,0
1731502769070,BENG 230B,A00,734289,Engler; Adam J.,38,0,120,82
1731502770103,BENG 238,A00,734290,Chen; Ju & Sun; Wei & Shyy; Yeun-Jund & Sheikh; Farah & Ross; Robert Scott & King; Kevin R & Evans; Sylvia M & Cho; Yoshitake,0,0,40,40
1731502771132,BENG 241A,A01,734314,Cyphert; Erika Leah,0,0,50,50
1731502772162,BENG 241B,A00,734333,Khojah; Reem I,35,0,70,35
1731502773193,BENG 247B,A00,734334,Wang; Joseph,0,0,40,40
1731502774222,BENG 277,A00,734336,Khojah; Reem I,0,0,0,0
1731502775248,BENG 278,A00,734340,Contijoch; Francisco,0,0,0,0
1731502776274,BENG 280B,A00,734351,El Kaffas; Ahmed,20,0,56,36
1731502777302,BENG 281,A00,734352,Aguado; Brian Alberto,25,0,120,95
1731502778328,BENG 291,A00,734356,Lal; Ratnesh,15,0,30,15
1731502779356,BENG 292,A01,734364,Ross; Camille,20,0,20,0
1731502780381,BENG 294B,A01,734430,Schmid-Schoenbein; Geert W,12,0,20,8
1731502781411,BENG 295,A00,734431,Watson; John Thomas,9999,0,9999,0
1731502782444,BGGN 206B,A00,765115,Oegema; Karen & Desai; Arshad,28,0,60,32
1731502783472,BGGN 207,A01,765121,Ross; Camille,0,0,0,0
1731502784497,BGGN 209,A00,765126,Neal; Sonya E,0,0,30,30
1731502785525,BGGN 213,A00,765129,Grant; Barry J,24,0,30,6
1731502786552,BGGN 216,A01,765138,Mueller; Liam O'Connor,0,0,0,24
1731502787579,BGGN 225,A00,765141,Lu; Li-Fan & Zuniga; Elina I,0,0,30,30
1731502788606,BGGN 228,A00,765144,Perry; Michael William & Kiger; Amy,0,0,30,30
1731502789638,BGGN 237,A01,765148,Goren; Alon M,10,0,10,0
1731502790671,BGGN 240,A01,765160,Benna; Marcus K,4,0,5,1
1731502790671,BGGN 240,A02,765210,Benna; Marcus K,1,0,5,4
1731502790671,BGGN 240,A03,765211,Benna; Marcus K,3,0,5,2
1731502790671,BGGN 240,A04,765212,Benna; Marcus K,2,0,5,3
1731502791699,BGGN 246A,A00,765223,Sejnowski; Terrence J,18,0,30,12
1731502792729,BGGN 249B,A00,765226,Abdel-Azim; Eiman,0,0,0,0
1731502793980,BGGN 271,001,798422,Ackerman; Susan,9999,0,9999,0
1731502793980,BGGN 271,002,798586,Akbari; Omar Sultan,9997,0,9999,2
1731502793980,BGGN 271,003,798588,Allen; Nicola J,9998,0,9999,1
1731502793980,BGGN 271,004,798599,Alperin; Mariann,9998,0,9999,1
1731502793980,BGGN 271,005,798600,Antal; Corina Elena,9998,0,9999,1
1731502793980,BGGN 271,006,798612,Bouvet; Michael,9999,0,9999,0
1731502793980,BGGN 271,007,798613,Breen; Ellen C.,9999,0,9999,0
1731502793980,BGGN 271,008,798637,Bui; Jack D,9998,0,9999,1
1731502793980,BGGN 271,009,798666,Burnett; Lindsey,9998,0,9999,1
1731502793980,BGGN 271,010,798745,Caffrey; Conor,9998,0,9999,1
1731502793980,BGGN 271,011,798780,Castle; Michael James,9998,0,9999,1
1731502793980,BGGN 271,012,798781,Chang; John Tzu-yu,9999,0,9999,0
1731502793980,BGGN 271,013,798782,Chen; Xu,9998,0,9999,1
1731502793980,BGGN 271,014,798783,Cheng; Christine Shiang-Ling,9999,0,9999,0
1731502793980,BGGN 271,015,798784,Cheresh; David A.,9998,0,9999,1
1731502793980,BGGN 271,016,798803,Cherqui; Stephanie,9999,0,9999,0
1731502793980,BGGN 271,017,798804,Chu; Hiutung,9998,0,9999,1
1731502793980,BGGN 271,018,798806,Church; Kellie Breen,9999,0,9999,0
1731502793980,BGGN 271,019,798807,Cleland; Elsa Eleanor,9998,0,9999,1
1731502793980,BGGN 271,020,798808,Coufal; Nicole Gabriele,9999,0,9999,0
1731502793980,BGGN 271,021,798809,Croker; Ben Adam,9999,0,9999,0
1731502793980,BGGN 271,022,798810,Crotty Alexander; Laura E,9997,0,9999,2
1731502793980,BGGN 271,023,798811,De Silva; Shermin,9999,0,9999,0
1731502793980,BGGN 271,024,798812,Dhar; Debanjan,9998,0,9999,1
1731502793980,BGGN 271,025,798813,Doherty; Taylor Alan,9997,0,9999,2
1731502793980,BGGN 271,026,798814,Dore; Kim Bohemie,9997,0,9999,2
1731502793980,BGGN 271,027,798815,Dulawa; Stephanie Carole,9999,0,9999,0
1731502793980,BGGN 271,028,798817,Farley; Emma Kristen,9998,0,9999,1
1731502793980,BGGN 271,029,798818,Feldstein; Ariel E,9999,0,9999,0
1731502793980,BGGN 271,030,798819,Feng; Gen-Sheng,9999,0,9999,0
1731502793980,BGGN 271,031,798820,Fisch; Kathleen Marie,9995,0,9999,4
1731502793980,BGGN 271,032,798822,Friedman; Rick Adam,9999,0,9999,0
1731502793980,BGGN 271,033,798823,Furnari; Frank,9999,0,9999,0
1731502793980,BGGN 271,034,798825,George; Olivier,9998,0,9999,1
1731502793980,BGGN 271,035,798826,Ghosh; Pradipta,9998,0,9999,1
1731502793980,BGGN 271,036,798828,Glasgow; Stacey Marie,9998,0,9999,1
1731502793980,BGGN 271,037,798832,Golden; James W,9998,0,9999,1
1731502793980,BGGN 271,038,798833,Golden; Susan S.,9999,0,9999,0
1731502793980,BGGN 271,039,798834,Goren; Alon M,9998,0,9999,1
1731502793980,BGGN 271,040,798835,Guatelli; John C,9998,0,9999,1
1731502793980,BGGN 271,041,798836,Guma; Monica,9998,0,9999,1
1731502793980,BGGN 271,042,798837,Gustafsson; Asa Birgitta,9999,0,9999,0
1731502793980,BGGN 271,043,798838,Hamdoun; Amr,9999,0,9999,0
1731502793980,BGGN 271,044,798839,Hao; Nan,9999,0,9999,0
1731502793980,BGGN 271,045,798841,Hasty; Jeff M,9999,0,9999,0
1731502793980,BGGN 271,046,798842,Ideker; Trey,9999,0,9999,0
1731502793980,BGGN 271,047,798843,Jiang; Qingfei,9998,0,9999,1
1731502793980,BGGN 271,048,798845,Jin; Yishi,9997,0,9999,2
1731502793980,BGGN 271,049,798846,Joshi; Shweta,9999,0,9999,0
1731502793980,BGGN 271,050,798849,Ju; Won-Kyu,9998,0,9999,1
1731502793980,BGGN 271,051,798850,Jun; Suckjoon,9999,0,9999,0
1731502793980,BGGN 271,052,798852,Kaech; Susan Michelle,9997,0,9999,2
1731502793980,BGGN 271,053,798853,Kauffman; Alexander,9997,0,9999,2
1731502793980,BGGN 271,054,798854,Kleinfeld; David,9998,0,9999,1
1731502793980,BGGN 271,055,798855,Koloski; Miranda Jane,9998,0,9999,1
1731502793980,BGGN 271,056,798856,Komiyama; Takaki,9998,0,9999,1
1731502793980,BGGN 271,057,798858,Kronenberg; Mitchell E.,9999,0,9999,0
1731502793980,BGGN 271,058,798859,Kufareva; Irina,9999,0,9999,0
1731502793980,BGGN 271,059,798860,Lee; Yun Sok,9999,0,9999,0
1731502793980,BGGN 271,060,798861,Leutgeb; Stefan,9999,0,9999,0
1731502793980,BGGN 271,061,798862,Li; Willis Xiaowei,9998,0,9999,1
1731502793980,BGGN 271,062,798864,Lim; Byungkook,9999,0,9999,0
1731502793980,BGGN 271,063,798865,Lo; Stanley M.,9999,0,9999,0
1731502793980,BGGN 271,064,798867,Lopez Ramirez; Miguel Alej,9998,0,9999,1
1731502793980,BGGN 271,065,798868,Lu; Pengzhe,9998,0,9999,1
1731502793980,BGGN 271,066,798869,Lyons; Deirdre Colleen,9998,0,9999,1
1731502793980,BGGN 271,067,798870,Lyumkis; Dmitry Evgenievich,9999,0,9999,0
1731502793980,BGGN 271,068,798871,McConville; Patrick James,9998,0,9999,1
1731502793980,BGGN 271,069,798873,McDonnell; Lisa Marie,9999,0,9999,0
1731502793980,BGGN 271,070,798877,Mertens; Jerome Stefan,9999,0,9999,0
1731502793980,BGGN 271,071,798900,Morris; Gerald P,9999,0,9999,0
1731502793980,BGGN 271,072,798911,Muotri; Alysson,9999,0,9999,0
1731502793980,BGGN 271,073,798916,Muroyama; Andrew David,9998,0,9999,1
1731502793980,BGGN 271,074,798919,Murre; Cornelis,9998,0,9999,1
1731502793980,BGGN 271,075,798920,Nieh; James Charles,9997,0,9999,2
1731502793980,BGGN 271,076,798922,Niwa; Maho,9999,0,9999,0
1731502793980,BGGN 271,077,798925,Parast; Mana,9999,0,9999,0
1731502793980,BGGN 271,078,798927,Perry; Michael William,9999,0,9999,0
1731502793980,BGGN 271,079,798929,Pillus; Lorraine,9998,0,9999,1
1731502793980,BGGN 271,080,798932,Pogliano; Joseph,9999,0,9999,0
1731502793980,BGGN 271,081,798936,Pride; David Tevis,9999,0,9999,0
1731502793980,BGGN 271,082,798939,Pruneda-Paz; Jose L.,9998,0,9999,1
1731502793980,BGGN 271,083,798940,Rana; Tariq,9999,0,9999,0
1731502793980,BGGN 271,084,798945,Rao; Anjana,9999,0,9999,0
1731502793980,BGGN 271,085,798950,Raz; Eyal,9997,0,9999,2
1731502793980,BGGN 271,086,798952,Ren; Bing,9999,0,9999,0
1731502793980,BGGN 271,087,798955,Rifkin; Scott,9998,0,9999,1
1731502793980,BGGN 271,088,798956,Risbrough; Victoria Blythe,9998,0,9999,1
1731502793980,BGGN 271,089,798958,Rose; Noah Hartmann,9999,0,9999,0
1731502793980,BGGN 271,090,798962,Rosenfeld; Michael G,9999,0,9999,0
1731502793980,BGGN 271,091,798964,Saier; Milton H.,9998,0,9999,1
1731502793980,BGGN 271,092,798966,Saltiel; Alan,9997,0,9999,2
1731502793980,BGGN 271,093,798967,Sanchez-Lopez; Elsa,9998,0,9999,1
1731502793980,BGGN 271,094,798969,Schroeder; Julian I,9998,0,9999,1
1731502793980,BGGN 271,095,798970,Sebat; Lilia Mikhailovna,9997,0,9999,2
1731502793980,BGGN 271,096,798972,Sen; George L,9999,0,9999,0
1731502793980,BGGN 271,097,798974,Shaner; Nathan C.,9999,0,9999,0
1731502793980,BGGN 271,098,798976,Shurin; Jonathan,9997,0,9999,2
1731502793980,BGGN 271,099,798982,Sicklick; Jason Keith,9999,0,9999,0
1731502793980,BGGN 271,100,798985,Signer; Robert,9999,0,9999,0
1731502793980,BGGN 271,101,798986,Simonson; Tatum Sasha Summ,9998,0,9999,1
1731502793980,BGGN 271,102,798990,Steinmetz; Nicole F,9999,0,9999,0
1731502793980,BGGN 271,103,798992,Su; Chih-Ying,9999,0,9999,0
1731502793980,BGGN 271,104,798994,Suel; Gurol Mehmet,9999,0,9999,0
1731502793980,BGGN 271,105,799024,Telese; Francesca,9999,0,9999,0
1731502793980,BGGN 271,106,799032,Towers; Christina Garlingt,9997,0,9999,2
1731502793980,BGGN 271,107,799089,Valdez-Jasso; Daniela,9999,0,9999,0
1731502793980,BGGN 271,108,799108,Wahlin; Karl Jonas,9997,0,9999,2
1731502793980,BGGN 271,109,799109,Webster; Nicholas J G,9999,0,9999,0
1731502793980,BGGN 271,110,799127,Welsbie; Derek,9999,0,9999,0
1731502793980,BGGN 271,111,799128,Wildonger; Jill Cathleen,9997,0,9999,2
1731502793980,BGGN 271,112,799129,Yaksh; Tony L.,9999,0,9999,0
1731502793980,BGGN 271,113,799150,Yeo; Eugene Wei-Ming,9998,0,9999,1
1731502793980,BGGN 271,114,799151,Ying; Wei,9997,0,9999,2
1731502793980,BGGN 271,115,799152,Young; Jared W.,9999,0,9999,0
1731502793980,BGGN 271,116,799153,Zage; Peter,9999,0,9999,0
1731502793980,BGGN 271,117,799154,Zengler; Karsten B,9998,0,9999,1
1731502793980,BGGN 271,118,799155,Zhang; Jin,9999,0,9999,0
1731502793980,BGGN 271,119,799156,Zhao; Yunde,9999,0,9999,0
1731502793980,BGGN 271,120,799157,Zheng; Ye,9998,0,9999,1
1731502793980,BGGN 271,121,799158,Zhou; Huilin,9999,0,9999,0
1731502793980,BGGN 271,122,799159,Zou; Yimin,9998,0,9999,1
1731502795009,BGGN 275,A00,765242,Flagg; Matthew Paul,0,0,0,12
1731502796034,BGGN 276,A00,765243,Flagg; Matthew Paul,0,0,0,12
1731502797062,BGGN 290,A00,765245,Pasquinelli; Amy & Hampton; Randolph Y.,0,0,0,8
1731502798089,BGGN 293,A00,765250,Tour; Ella,0,0,30,30
1731502798089,BGGN 293,B00,765260,Petrie; Katherine Lynn,0,0,0,12
1731502799115,BGJC 204,A00,765301,Lu; Li-Fan & Chang; John Tzu-yu,9982,0,9999,17
1731502800298,BGRD 200,001,799275,Ackerman; Susan,9999,0,9999,0
1731502800298,BGRD 200,002,799276,Akbari; Omar Sultan,9997,0,9999,2
1731502800298,BGRD 200,003,799277,Allen; Eric,9999,0,9999,0
1731502800298,BGRD 200,004,799278,Allen; Nicola J,9998,0,9999,1
1731502800298,BGRD 200,005,799279,Alperin; Mariann,9998,0,9999,1
1731502800298,BGRD 200,006,799280,Amaro; Rommie E,9999,0,9999,0
1731502800298,BGRD 200,007,799281,Antal; Corina Elena,9998,0,9999,1
1731502800298,BGRD 200,008,799282,Asahina; Kenta,9999,0,9999,0
1731502800298,BGRD 200,009,799283,Augustine; Vineet,9999,0,9999,0
1731502800298,BGRD 200,010,799284,Ayres; Janelle Samantha,9998,0,9999,1
1731502800298,BGRD 200,011,799285,Banghart; Matthew Ryan,9999,0,9999,0
1731502800298,BGRD 200,012,799286,Barton; Andrew David,9999,0,9999,0
1731502800298,BGRD 200,013,799287,Benna; Marcus K,9999,0,9999,0
1731502800298,BGRD 200,014,799288,Bennett; Eric J,9999,0,9999,0
1731502800298,BGRD 200,015,799289,Biering; Scott B,9999,0,9999,0
1731502800298,BGRD 200,016,799290,Bloodgood; Brenda Laurie,9999,0,9999,0
1731502800298,BGRD 200,017,799291,Bouvet; Michael,9999,0,9999,0
1731502800298,BGRD 200,018,799292,Breen; Ellen C.,9999,0,9999,0
1731502800298,BGRD 200,019,799293,Briggs; Steven,9999,0,9999,0
1731502800298,BGRD 200,020,799294,Bui; Jack D,9998,0,9999,1
1731502800298,BGRD 200,021,799295,Burnett; Lindsey,9998,0,9999,1
1731502800298,BGRD 200,022,799296,Caffrey; Conor,9998,0,9999,1
1731502800298,BGRD 200,023,799297,Callaway; Edward M,9999,0,9999,0
1731502800298,BGRD 200,024,799298,Castle; Michael James,9999,0,9999,0
1731502800298,BGRD 200,025,799299,Chaim; Isaac,9999,0,9999,0
1731502800298,BGRD 200,026,799300,Chang; John Tzu-yu,9998,0,9999,1
1731502800298,BGRD 200,027,799301,Chen; Xu,9999,0,9999,0
1731502800298,BGRD 200,028,799302,Cheng; Christine Shiang-Ling,9999,0,9999,0
1731502800298,BGRD 200,029,799303,Cheresh; David A.,9998,0,9999,1
1731502800298,BGRD 200,030,799304,Cherqui; Stephanie,9999,0,9999,0
1731502800298,BGRD 200,031,799305,Chu; Hiutung,9998,0,9999,1
1731502800298,BGRD 200,032,799306,Church; Kellie Breen,9999,0,9999,0
1731502800298,BGRD 200,033,799307,Cleland; Elsa Eleanor,9997,0,9999,2
1731502800298,BGRD 200,034,799308,Cooper; Kimberly Lynn,9999,0,9999,0
1731502800298,BGRD 200,035,799309,Coufal; Nicole Gabriele,9999,0,9999,0
1731502800298,BGRD 200,036,799310,Croker; Ben Adam,9999,0,9999,0
1731502800298,BGRD 200,037,799311,Crotty Alexander; Laura E,9997,0,9999,2
1731502800298,BGRD 200,038,799313,Daugherty; Matthew Dorton,9998,0,9999,1
1731502800298,BGRD 200,039,799314,De Silva; Shermin,9999,0,9999,0
1731502800298,BGRD 200,040,799315,Desai; Arshad,9999,0,9999,0
1731502800298,BGRD 200,041,799316,Dhar; Debanjan,9998,0,9999,1
1731502800298,BGRD 200,042,799317,Dickinson; Alexandra Jazz,9999,0,9999,0
1731502800298,BGRD 200,043,799318,Dixon; Jesse,9998,0,9999,1
1731502800298,BGRD 200,044,799319,Doherty; Taylor Alan,9997,0,9999,2
1731502800298,BGRD 200,045,799320,Dore; Kim Bohemie,9997,0,9999,2
1731502800298,BGRD 200,046,799321,Dulawa; Stephanie Carole,9999,0,9999,0
1731502800298,BGRD 200,047,799323,Ecker; Joseph R,9998,0,9999,1
1731502800298,BGRD 200,048,799324,Engle; Dannielle D,9999,0,9999,0
1731502800298,BGRD 200,049,799325,Ernst; Andreas,9998,0,9999,1
1731502800298,BGRD 200,050,799326,Esko; Jeffrey D.,9999,0,9999,0
1731502800298,BGRD 200,051,799327,Farley; Emma Kristen,9998,0,9999,1
1731502800298,BGRD 200,052,799328,Feldstein; Ariel E,9999,0,9999,0
1731502800298,BGRD 200,053,799329,Feng; Gen-Sheng,9999,0,9999,0
1731502800298,BGRD 200,054,799330,Fisch; Kathleen Marie,9995,0,9999,4
1731502800298,BGRD 200,055,799331,Friedman; Rick Adam,9999,0,9999,0
1731502800298,BGRD 200,056,799332,Furnari; Frank,9999,0,9999,0
1731502800298,BGRD 200,057,799333,Gage; Fred H,9999,0,9999,0
1731502800298,BGRD 200,058,799334,George; Olivier,9998,0,9999,1
1731502800298,BGRD 200,059,799335,Ghosh; Pradipta,9998,0,9999,1
1731502800298,BGRD 200,060,799336,Glasgow; Stacey Marie,9998,0,9999,1
1731502800298,BGRD 200,061,799337,Glass; Christopher,9999,0,9999,0
1731502800298,BGRD 200,062,799338,Golden; James W,9998,0,9999,1
1731502800298,BGRD 200,063,799339,Golden; Susan S.,9999,0,9999,0
1731502800298,BGRD 200,064,799340,Goren; Alon M,9998,0,9999,1
1731502800298,BGRD 200,065,799341,Guatelli; John C,9998,0,9999,1
1731502800298,BGRD 200,066,799342,Guma; Monica,9998,0,9999,1
1731502800298,BGRD 200,067,799343,Gustafsson; Asa Birgitta,9999,0,9999,0
1731502800298,BGRD 200,068,799344,Gutkind; Jorge Silvio,9999,0,9999,0
1731502800298,BGRD 200,069,799345,Hamdoun; Amr,9999,0,9999,0
1731502800298,BGRD 200,070,799346,Hampton; Randolph Y.,9998,0,9999,1
1731502800298,BGRD 200,071,799347,Hao; Nan,9999,0,9999,0
1731502800298,BGRD 200,072,799348,Hargreaves; Diana Clare,9998,0,9999,1
1731502800298,BGRD 200,073,799349,Hasty; Jeff M,9999,0,9999,0
1731502800298,BGRD 200,074,799350,Hollern; Daniel Patrick,9998,0,9999,1
1731502800298,BGRD 200,075,799351,Holway; David A.,9999,0,9999,0
1731502800298,BGRD 200,076,799352,Huffaker; Alisa,9998,0,9999,1
1731502800298,BGRD 200,077,799353,Hui; Enfu,9999,0,9999,0
1731502800298,BGRD 200,078,799354,Hwa; Terence T.,9999,0,9999,0
1731502800298,BGRD 200,079,799355,Ideker; Trey,9999,0,9999,0
1731502800298,BGRD 200,080,799356,Jackrel; Sara,9997,0,9999,2
1731502800298,BGRD 200,081,799357,Jiang; Qingfei,9998,0,9999,1
1731502800298,BGRD 200,082,799358,Jin; Yishi,9997,0,9999,2
1731502800298,BGRD 200,083,799359,Joshi; Shweta,9999,0,9999,0
1731502800298,BGRD 200,084,799360,Ju; Won-Kyu,9998,0,9999,1
1731502800298,BGRD 200,085,799361,Jun; Suckjoon,9999,0,9999,0
1731502800298,BGRD 200,086,799362,Kadonaga; James T,9999,0,9999,0
1731502800298,BGRD 200,087,799363,Kaech; Susan Michelle,9995,0,9999,4
1731502800298,BGRD 200,088,799364,Kauffman; Alexander,9997,0,9999,2
1731502800298,BGRD 200,089,799365,Kleinfeld; David,9999,0,9999,0
1731502800298,BGRD 200,090,799366,Knight; Robin,9999,0,9999,0
1731502800298,BGRD 200,091,799367,Koloski; Miranda Jane,9998,0,9999,1
1731502800298,BGRD 200,092,799368,Komiyama; Takaki,9997,0,9999,2
1731502800298,BGRD 200,093,799369,Kosuri; Pallav,9998,0,9999,1
1731502800298,BGRD 200,094,799370,Kronenberg; Mitchell E.,9999,0,9999,0
1731502800298,BGRD 200,095,799371,Staff,9999,0,9999,0
1731502800298,BGRD 200,096,799372,Kryazhimskiy; Sergey A,9999,0,9999,0
1731502800298,BGRD 200,097,799373,Kufareva; Irina,9999,0,9999,0
1731502800298,BGRD 200,098,799374,Lee; Kuo Fen,9999,0,9999,0
1731502800298,BGRD 200,099,799375,Lee; Yun Sok,9999,0,9999,0
1731502800298,BGRD 200,100,799376,Leutgeb; Jill K.,9999,0,9999,0
1731502800298,BGRD 200,101,799377,Leutgeb; Stefan,9999,0,9999,0
1731502800298,BGRD 200,102,799378,Li; Willis Xiaowei,9998,0,9999,1
1731502800298,BGRD 200,103,799379,Lim; Byungkook,9998,0,9999,1
1731502800298,BGRD 200,104,799380,Lo; Stanley M.,9999,0,9999,0
1731502800298,BGRD 200,105,799381,Looger; Loren Lee,9998,0,9999,1
1731502800298,BGRD 200,106,799382,Lopez Ramirez; Miguel Alej,9998,0,9999,1
1731502800298,BGRD 200,107,799383,Lovett-Barron; Matthew Rod,9997,0,9999,2
1731502800298,BGRD 200,108,799384,Lu; Li-Fan,9998,0,9999,1
1731502800298,BGRD 200,109,799385,Lu; Pengzhe,9998,0,9999,1
1731502800298,BGRD 200,110,799386,Lykke-Andersen; Jens,9998,0,9999,1
1731502800298,BGRD 200,111,799387,Lyons; Deirdre Colleen,9998,0,9999,1
1731502800298,BGRD 200,112,799388,Lyumkis; Dmitry Evgenievich,9998,0,9999,1
1731502800298,BGRD 200,113,799389,Manor; Uri,9999,0,9999,0
1731502800298,BGRD 200,114,799390,Mayfield; Stephen P.,9998,0,9999,1
1731502800298,BGRD 200,115,799391,McConville; Patrick James,9999,0,9999,0
1731502800298,BGRD 200,116,799392,McDonnell; Lisa Marie,9999,0,9999,0
1731502800298,BGRD 200,117,799393,Mertens; Jerome Stefan,9999,0,9999,0
1731502800298,BGRD 200,118,799394,Meyer; Justin Raymond,9999,0,9999,0
1731502800298,BGRD 200,119,799395,Morris; Gerald P,9999,0,9999,0
1731502800298,BGRD 200,120,799396,Mueller; Lena,9998,0,9999,1
1731502800298,BGRD 200,121,799397,Muotri; Alysson,9999,0,9999,0
1731502800298,BGRD 200,122,799398,Muroyama; Andrew David,9995,0,9999,4
1731502800298,BGRD 200,123,799399,Murre; Cornelis,9998,0,9999,1
1731502800298,BGRD 200,124,799400,Reyes De Barboza; Nabora S,9999,0,9999,0
1731502800298,BGRD 200,125,799401,Neal; Sonya E,9998,0,9999,1
1731502800298,BGRD 200,126,799402,Nieh; James Charles,9997,0,9999,2
1731502800298,BGRD 200,127,799403,Nimmerjahn; Axel,9999,0,9999,0
1731502800298,BGRD 200,128,799404,Niwa; Maho,9999,0,9999,0
1731502800298,BGRD 200,129,799405,Nizet; Victor F.,9999,0,9999,0
1731502800298,BGRD 200,130,799406,Oegema; Karen,9999,0,9999,0
1731502800298,BGRD 200,131,799407,Panda; Satchidananda,9998,0,9999,1
1731502800298,BGRD 200,132,799408,Parast; Mana,9999,0,9999,0
1731502800298,BGRD 200,133,799409,Pasquinelli; Amy,9998,0,9999,1
1731502800298,BGRD 200,134,799410,Pekkurnaz Banghart; Gulcin,9999,0,9999,0
1731502800298,BGRD 200,135,799411,Perry; Michael William,9999,0,9999,0
1731502800298,BGRD 200,136,799413,Pillus; Lorraine,9998,0,9999,1
1731502800298,BGRD 200,137,799414,Pogliano; Joseph,9999,0,9999,0
1731502800298,BGRD 200,138,799415,Pogliano; Kit J.,9999,0,9999,0
1731502800298,BGRD 200,139,799416,Pride; David Tevis,9999,0,9999,0
1731502800298,BGRD 200,140,799417,Pruneda-Paz; Jose L.,9998,0,9999,1
1731502800298,BGRD 200,141,799418,Ramanan; Deepshika,9998,0,9999,1
1731502800298,BGRD 200,142,799419,Rana; Tariq,9998,0,9999,1
1731502800298,BGRD 200,143,799420,Rao; Anjana,9999,0,9999,0
1731502800298,BGRD 200,144,799421,Raz; Eyal,9997,0,9999,2
1731502800298,BGRD 200,145,799422,Reck-Peterson; Samara L,9999,0,9999,0
1731502800298,BGRD 200,146,799423,Ren; Bing,9999,0,9999,0
1731502800298,BGRD 200,147,799424,Rennison; Diana,9998,0,9999,1
1731502800298,BGRD 200,148,799425,Rifkin; Scott,9999,0,9999,0
1731502800298,BGRD 200,149,799426,Risbrough; Victoria Blythe,9998,0,9999,1
1731502800298,BGRD 200,150,799427,Rivera; Fabian Chavez,9997,0,9999,2
1731502800298,BGRD 200,151,799428,Rohner; Patrick Thomas,9999,0,9999,0
1731502800298,BGRD 200,152,799429,Rose; Noah Hartmann,9999,0,9999,0
1731502800298,BGRD 200,153,799430,Rosenfeld; Michael G,9999,0,9999,0
1731502800298,BGRD 200,154,799431,Russell; Alistair B,9999,0,9999,0
1731502800298,BGRD 200,155,799432,Saier; Milton H.,9998,0,9999,1
1731502800298,BGRD 200,156,799433,Saltiel; Alan,9997,0,9999,2
1731502800298,BGRD 200,157,799434,Sanchez-Lopez; Elsa,9999,0,9999,0
1731502800298,BGRD 200,158,799435,Saphire; Erica Ollmann,9999,0,9999,0
1731502800298,BGRD 200,159,799436,Schroeder; Julian I,9997,0,9999,2
1731502800298,BGRD 200,160,799437,Sebat; Lilia Mikhailovna,9997,0,9999,2
1731502800298,BGRD 200,161,799438,Sen; George L,9999,0,9999,0
1731502800298,BGRD 200,162,799439,Shah; Sameer B,9999,0,9999,0
1731502800298,BGRD 200,163,799440,Shaner; Nathan C.,9999,0,9999,0
1731502800298,BGRD 200,164,799441,Sharpee; Tatyana,9999,0,9999,0
1731502800298,BGRD 200,165,799442,Shaw; Reuben,9999,0,9999,0
1731502800298,BGRD 200,166,799443,Shurin; Jonathan,9997,0,9999,2
1731502800298,BGRD 200,167,799444,Sicklick; Jason Keith,9999,0,9999,0
1731502800298,BGRD 200,168,799445,Signer; Robert,9999,0,9999,0
1731502800298,BGRD 200,169,799446,Simonson; Tatum Sasha Summ,9998,0,9999,1
1731502800298,BGRD 200,170,799447,Soncin; Francesca,9999,0,9999,0
1731502800298,BGRD 200,171,799448,Steinmetz; Nicole F,9999,0,9999,0
1731502800298,BGRD 200,172,799449,Su; Chih-Ying,9998,0,9999,1
1731502800298,BGRD 200,173,799450,Suel; Gurol Mehmet,9997,0,9999,2
1731502800298,BGRD 200,174,799451,Sun; Xin,9998,0,9999,1
1731502800298,BGRD 200,175,799452,Telese; Francesca,9998,0,9999,1
1731502800298,BGRD 200,176,799453,Towers; Christina Garlingt,9995,0,9999,4
1731502800298,BGRD 200,177,799454,Traver; David,9999,0,9999,0
1731502800298,BGRD 200,178,799455,Troemel; Emily Ruth,9998,0,9999,1
1731502800298,BGRD 200,179,799456,Valdez-Jasso; Daniela,9999,0,9999,0
1731502800298,BGRD 200,180,799457,Vijayanand; Pandurangan,9999,0,9999,0
1731502800298,BGRD 200,181,799458,Villa Rodriguez; Elizabeth,9999,0,9999,0
1731502800298,BGRD 200,182,799459,Wahlin; Karl Jonas,9997,0,9999,2
1731502800298,BGRD 200,183,799460,Wang; Jean Yin Jen,9999,0,9999,0
1731502800298,BGRD 200,184,799461,Webster; Nicholas J G,9999,0,9999,0
1731502800298,BGRD 200,185,799462,Welsbie; Derek,9999,0,9999,0
1731502800298,BGRD 200,186,799463,Wildonger; Jill Cathleen,9996,0,9999,3
1731502800298,BGRD 200,187,799464,Winzeler; Elizabeth A,9999,0,9999,0
1731502800298,BGRD 200,188,799465,Yaksh; Tony L.,9999,0,9999,0
1731502800298,BGRD 200,189,799466,Yelon; Deborah,9997,0,9999,2
1731502800298,BGRD 200,190,799467,Yeo; Eugene Wei-Ming,9998,0,9999,1
1731502800298,BGRD 200,191,799468,Ying; Wei,9997,0,9999,2
1731502800298,BGRD 200,192,799469,Young; Jared W.,9999,0,9999,0
1731502800298,BGRD 200,193,799470,Zage; Peter,9999,0,9999,0
1731502800298,BGRD 200,194,799471,Zengler; Karsten B,9997,0,9999,2
1731502800298,BGRD 200,195,799472,Zhang; Dong-Er,9999,0,9999,0
1731502800298,BGRD 200,196,799473,Zhang; Jin,9999,0,9999,0
1731502800298,BGRD 200,197,799474,Zhao; Yunde,9999,0,9999,0
1731502800298,BGRD 200,198,799475,Zheng; Binhai,9999,0,9999,0
1731502800298,BGRD 200,199,799476,Zheng; Ye,9998,0,9999,1
1731502800298,BGRD 200,200,799477,Zhou; Huilin,9999,0,9999,0
1731502800298,BGRD 200,201,799478,Zou; Yimin,9998,0,9999,1
1731502800298,BGRD 200,202,799479,Zuniga; Elina I,9998,0,9999,1
1731502801327,BGSE 200,A00,765304,Tour; Ella & Petrie; Katherine Lynn,9987,0,9999,12
1731502802354,BGSE 205,A00,765321,Bennett; Eric J,43,0,50,7
1731502802354,BGSE 205,B00,765322,Bennett; Eric J,46,0,50,4
1731502802354,BGSE 205,C00,765369,Bennett; Eric J,36,0,50,14
1731502802354,BGSE 205,D00,765470,Bennett; Eric J,40,0,50,10
1731502802354,BGSE 205,E00,765471,Bennett; Eric J,45,0,50,5
1731502803383,BIBC 100,A01,786720,Hui; Enfu,70,0,73,3
1731502803383,BIBC 100,A02,786721,Hui; Enfu,64,0,73,9
1731502803383,BIBC 100,A03,786723,Hui; Enfu,67,0,73,6
1731502803383,BIBC 100,A04,786775,Hui; Enfu,67,0,73,6
1731502804414,BIBC 102,A01,786782,Feng; Gen-Sheng,72,0,73,1
1731502804414,BIBC 102,A02,786783,Feng; Gen-Sheng,71,0,73,2
1731502804414,BIBC 102,A03,786784,Feng; Gen-Sheng,73,0,73,0
1731502804414,BIBC 102,A04,786790,Feng; Gen-Sheng,73,0,73,0
1731502804414,BIBC 102,B01,786791,Dickinson; Alexandra Jazz,61,0,73,12
1731502804414,BIBC 102,B02,786792,Dickinson; Alexandra Jazz,64,0,73,9
1731502804414,BIBC 102,B03,786845,Dickinson; Alexandra Jazz,68,0,73,5
1731502804414,BIBC 102,B04,786859,Dickinson; Alexandra Jazz,50,0,73,23
1731502805452,BIBC 103,A01,757720,Coleman; Aaron B.,21,0,24,3
1731502805452,BIBC 103,A02,757773,Coleman; Aaron B.,22,0,24,2
1731502805452,BIBC 103,B01,757783,Coleman; Aaron B.,18,0,24,6
1731502805452,BIBC 103,B02,757784,Coleman; Aaron B.,21,0,24,3
1731502805452,BIBC 103,C01,758001,Burg; Michael,17,0,24,7
1731502805452,BIBC 103,C02,758019,Burg; Michael,24,0,24,0
1731502806483,BIBC 120,A01,758029,Hampton; Randolph Y.,61,0,87,26
1731502806483,BIBC 120,A02,758032,Hampton; Randolph Y.,65,0,87,22
1731502806483,BIBC 120,A03,758038,Hampton; Randolph Y.,77,0,87,10
1731502806483,BIBC 120,A04,758119,Hampton; Randolph Y.,74,0,87,13
1731502807515,BIBC 194,A00,758136,Hui; Enfu,25,0,32,7
1731502807515,BIBC 194,B00,758137,Niwa; Maho,25,0,32,7
1731502807515,BIBC 194,C00,758138,Corbett; Kevin Daniel,25,0,32,7
1731502808553,BICD 100,A01,786869,Troemel; Emily Ruth,72,0,73,1
1731502808553,BICD 100,A02,786870,Troemel; Emily Ruth,73,0,73,0
1731502808553,BICD 100,A03,786871,Troemel; Emily Ruth,73,0,73,0
1731502808553,BICD 100,A04,786872,Troemel; Emily Ruth,73,0,73,0
1731502808553,BICD 100,B01,786873,Grossman; Emily N,66,0,73,7
1731502808553,BICD 100,B02,786874,Grossman; Emily N,66,0,73,7
1731502808553,BICD 100,B03,786875,Grossman; Emily N,71,0,73,2
1731502808553,BICD 100,B04,786876,Grossman; Emily N,70,0,73,3
1731502808553,BICD 100,C01,786877,Grossman; Emily N,64,0,73,9
1731502808553,BICD 100,C02,786878,Grossman; Emily N,71,0,73,2
1731502808553,BICD 100,C03,786879,Grossman; Emily N,70,0,73,3
1731502808553,BICD 100,C04,786880,Grossman; Emily N,71,0,73,2
1731502809589,BICD 110,A01,758191,Chaim; Isaac,54,0,63,9
1731502809589,BICD 110,A02,758193,Chaim; Isaac,42,0,63,21
1731502809589,BICD 110,A03,758194,Chaim; Isaac,61,0,63,2
1731502809589,BICD 110,A04,758196,Chaim; Isaac,56,0,61,5
1731502809589,BICD 110,B01,758200,Manor; Uri,60,0,63,3
1731502809589,BICD 110,B02,758201,Manor; Uri,63,0,63,0
1731502809589,BICD 110,B03,758202,Manor; Uri,55,0,63,8
1731502809589,BICD 110,B04,758204,Manor; Uri,56,0,61,5
1731502810615,BICD 120,A01,758206,Estelle; Mark,20,0,23,3
1731502810615,BICD 120,A02,758208,Estelle; Mark,22,0,23,1
1731502810615,BICD 120,A03,758209,Estelle; Mark,23,0,23,0
1731502810615,BICD 120,A04,758214,Estelle; Mark,17,0,21,4
1731502811644,BICD 194,A00,758215,Hueschen; Christina Lynn,29,0,32,3
1731502812677,BIEB 102,A01,758218,Jackrel; Sara,46,0,48,2
1731502812677,BIEB 102,A02,758219,Jackrel; Sara,47,0,48,1
1731502812677,BIEB 102,A03,758220,Jackrel; Sara,48,0,48,0
1731502812677,BIEB 102,A04,758222,Jackrel; Sara,48,0,48,0
1731502813709,BIEB 121,A00,758224,Butler; Shannon Rhey,8,0,32,24
1731502813709,BIEB 121,B00,758225,Butler; Shannon Rhey,20,0,32,12
1731502814741,BIEB 134,A01,758227,Barton; Andrew David,10,0,11,1
1731502814741,BIEB 134,A02,758230,Barton; Andrew David,11,0,11,0
1731502814741,BIEB 134,A03,758231,Barton; Andrew David,9,0,11,2
1731502814741,BIEB 134,A04,758232,Barton; Andrew David,11,0,11,0
1731502814741,BIEB 134,A05,758233,Barton; Andrew David,7,0,11,4
1731502814741,BIEB 134,A06,758236,Barton; Andrew David,9,0,10,1
1731502814741,BIEB 134,A07,758237,Barton; Andrew David,10,0,10,0
1731502814741,BIEB 134,A08,758239,Barton; Andrew David,10,0,10,0
1731502815766,BIEB 135,A01,758241,Shurin; Jonathan,20,0,36,16
1731502816799,BIEB 140,A01,758243,Roy; Kaustuv,35,0,40,5
1731502816799,BIEB 140,A02,758248,Roy; Kaustuv,36,0,40,4
1731502816799,BIEB 140,A03,758250,Roy; Kaustuv,35,0,40,5
1731502816799,BIEB 140,A04,758251,Roy; Kaustuv,32,0,40,8
1731502817832,BIEB 152,A01,758255,Wodarz; Dominik Franz Xave,57,0,63,6
1731502817832,BIEB 152,A02,758256,Wodarz; Dominik Franz Xave,62,0,63,1
1731502817832,BIEB 152,A03,758257,Wodarz; Dominik Franz Xave,54,0,63,9
1731502817832,BIEB 152,A04,758260,Wodarz; Dominik Franz Xave,50,0,61,11
1731502818860,BIEB 156,A01,758262,Rose; Noah Hartmann & Rennison; Diana,26,0,29,3
1731502818860,BIEB 156,A02,758267,Rose; Noah Hartmann & Rennison; Diana,26,0,29,3
1731502818860,BIEB 156,A03,758269,Rose; Noah Hartmann & Rennison; Diana,29,0,29,0
1731502818860,BIEB 156,A04,758272,Rose; Noah Hartmann & Rennison; Diana,28,0,28,0
1731502819894,BILD 1,A01,786580,Ochoa Mikrut; Stacy Daniel,93,0,100,7
1731502819894,BILD 1,A02,786585,Ochoa Mikrut; Stacy Daniel,100,0,100,0
1731502819894,BILD 1,A03,786589,Ochoa Mikrut; Stacy Daniel,98,0,100,2
1731502819894,BILD 1,A04,786591,Ochoa Mikrut; Stacy Daniel,96,0,100,4
1731502819894,BILD 1,B01,786593,Madigan; Cressida Ariana,85,0,100,15
1731502819894,BILD 1,B02,786612,Madigan; Cressida Ariana,73,0,100,27
1731502819894,BILD 1,B03,786613,Madigan; Cressida Ariana,93,0,100,7
1731502819894,BILD 1,B04,786614,Madigan; Cressida Ariana,97,0,100,3
1731502819894,BILD 1,C01,786630,Cooper; Andrew Michael,97,0,100,3
1731502819894,BILD 1,C02,786631,Cooper; Andrew Michael,99,0,100,1
1731502819894,BILD 1,C03,786669,Cooper; Andrew Michael,100,0,100,0
1731502819894,BILD 1,C04,786704,Cooper; Andrew Michael,99,0,100,1
1731502820935,BILD 2,A01,786707,Owens; Melinda Tsao-Ying,64,0,65,1
1731502820935,BILD 2,A02,786708,Owens; Melinda Tsao-Ying,58,0,60,2
1731502820935,BILD 2,A03,786709,Owens; Melinda Tsao-Ying,57,0,60,3
1731502820935,BILD 2,A04,786710,Owens; Melinda Tsao-Ying,60,0,60,0
1731502820935,BILD 2,B01,786920,Owens; Melinda Tsao-Ying,59,0,60,1
1731502820935,BILD 2,B02,786975,Owens; Melinda Tsao-Ying,60,0,60,0
1731502820935,BILD 2,B03,786976,Owens; Melinda Tsao-Ying,64,0,65,1
1731502820935,BILD 2,B04,786979,Owens; Melinda Tsao-Ying,64,0,65,1
1731502820935,BILD 2,C01,786980,Su; Chih-Ying,61,0,63,2
1731502820935,BILD 2,C02,786981,Su; Chih-Ying,58,0,63,5
1731502820935,BILD 2,C03,786983,Su; Chih-Ying,60,0,63,3
1731502820935,BILD 2,C04,786985,Su; Chih-Ying,61,0,61,0
1731502821982,BILD 3,A01,786711,Hammond; LaTisha Marie,49,0,60,11
1731502821982,BILD 3,A02,786712,Hammond; LaTisha Marie,44,0,60,16
1731502821982,BILD 3,A03,786713,Hammond; LaTisha Marie,59,0,60,1
1731502821982,BILD 3,A04,786714,Hammond; LaTisha Marie,54,0,60,6
1731502821982,BILD 3,B01,786715,Hammond; LaTisha Marie,58,0,60,2
1731502821982,BILD 3,B02,786716,Hammond; LaTisha Marie,60,0,60,0
1731502821982,BILD 3,B03,786717,Hammond; LaTisha Marie,55,0,60,5
1731502821982,BILD 3,B04,786719,Hammond; LaTisha Marie,59,0,60,1
1731502821982,BILD 3,D01,786997,Pirino; Giorgia,58,0,60,2
1731502821982,BILD 3,D02,786998,Pirino; Giorgia,58,0,60,2
1731502821982,BILD 3,D03,786999,Pirino; Giorgia,58,0,60,2
1731502821982,BILD 3,D04,787001,Pirino; Giorgia,60,0,60,0
1731502823022,BILD 4,A01,757384,Gonzalez Gamboa; Ivonne,20,0,24,4
1731502823022,BILD 4,A02,757387,Gonzalez Gamboa; Ivonne,22,0,24,2
1731502823022,BILD 4,A03,757388,Gonzalez Gamboa; Ivonne,24,0,24,0
1731502823022,BILD 4,A04,757396,Gonzalez Gamboa; Ivonne,24,0,24,0
1731502823022,BILD 4,A05,757397,Gonzalez Gamboa; Ivonne,22,0,24,2
1731502823022,BILD 4,A06,757399,Gonzalez Gamboa; Ivonne,24,0,24,0
1731502823022,BILD 4,A07,757403,Gonzalez Gamboa; Ivonne,23,0,24,1
1731502823022,BILD 4,A08,757404,Gonzalez Gamboa; Ivonne,22,0,24,2
1731502823022,BILD 4,B01,757410,Gonzalez Gamboa; Ivonne,15,0,24,9
1731502823022,BILD 4,B02,757413,Gonzalez Gamboa; Ivonne,21,0,24,3
1731502823022,BILD 4,B03,757416,Gonzalez Gamboa; Ivonne,23,0,24,1
1731502823022,BILD 4,B04,757417,Gonzalez Gamboa; Ivonne,23,0,24,1
1731502823022,BILD 4,B05,757419,Gonzalez Gamboa; Ivonne,23,0,24,1
1731502823022,BILD 4,B06,757421,Gonzalez Gamboa; Ivonne,23,0,24,1
1731502823022,BILD 4,B07,757423,Gonzalez Gamboa; Ivonne,23,0,24,1
1731502823022,BILD 4,B08,757434,Gonzalez Gamboa; Ivonne,23,0,24,1
1731502823022,BILD 4,C01,757437,Ochoa Mikrut; Stacy Daniel,22,0,24,2
1731502823022,BILD 4,C02,757439,Ochoa Mikrut; Stacy Daniel,23,0,24,1
1731502823022,BILD 4,C03,757440,Ochoa Mikrut; Stacy Daniel,24,0,24,0
1731502823022,BILD 4,C04,757495,Ochoa Mikrut; Stacy Daniel,23,0,24,1
1731502823022,BILD 4,C05,757496,Ochoa Mikrut; Stacy Daniel,24,0,24,0
1731502823022,BILD 4,C06,757497,Ochoa Mikrut; Stacy Daniel,24,0,24,0
1731502823022,BILD 4,C07,757498,Ochoa Mikrut; Stacy Daniel,24,0,24,0
1731502823022,BILD 4,C08,757499,Ochoa Mikrut; Stacy Daniel,24,0,24,0
1731502823022,BILD 4,D01,757501,Lo; Stanley M.,14,0,24,10
1731502823022,BILD 4,D02,757502,Lo; Stanley M.,22,0,24,2
1731502823022,BILD 4,D03,757503,Lo; Stanley M.,24,0,24,0
1731502823022,BILD 4,D04,757504,Lo; Stanley M.,22,0,24,2
1731502823022,BILD 4,D05,757505,Lo; Stanley M.,22,0,24,2
1731502823022,BILD 4,D06,757506,Lo; Stanley M.,22,0,24,2
1731502823022,BILD 4,D07,757507,Lo; Stanley M.,24,0,24,0
1731502823022,BILD 4,D08,757508,Lo; Stanley M.,22,0,24,2
1731502824056,BILD 5,A01,786885,Mueller; Liam O'Connor,60,0,65,5
1731502824056,BILD 5,A02,786886,Mueller; Liam O'Connor,58,0,65,7
1731502824056,BILD 5,A03,786887,Mueller; Liam O'Connor,64,0,65,1
1731502824056,BILD 5,A04,786888,Mueller; Liam O'Connor,64,0,65,1
1731502824056,BILD 5,B01,786889,Reuther; Keefe,65,0,65,0
1731502824056,BILD 5,B02,786890,Reuther; Keefe,60,0,65,5
1731502824056,BILD 5,B03,786891,Reuther; Keefe,64,0,65,1
1731502824056,BILD 5,B04,786892,Reuther; Keefe,65,0,65,0
1731502825083,BILD 12,A01,757527,Komiyama; Takaki,24,0,24,0
1731502825083,BILD 12,A02,757530,Komiyama; Takaki,24,0,24,0
1731502825083,BILD 12,A03,757531,Komiyama; Takaki,21,0,24,3
1731502825083,BILD 12,A04,757532,Komiyama; Takaki,24,0,24,0
1731502826109,BILD 22,A01,757534,Strause; Linda G.,69,0,75,6
1731502826109,BILD 22,A02,757535,Strause; Linda G.,70,0,75,5
1731502826109,BILD 22,A03,757544,Strause; Linda G.,75,0,75,0
1731502826109,BILD 22,A04,757547,Strause; Linda G.,74,0,75,1
1731502827143,BILD 28,A01,757549,Idoyaga; Juliana,30,0,30,0
1731502827143,BILD 28,A02,757550,Idoyaga; Juliana,30,0,30,0
1731502827143,BILD 28,A03,757551,Idoyaga; Juliana,30,0,30,0
1731502827143,BILD 28,A04,757552,Idoyaga; Juliana,30,0,30,0
1731502828170,BILD 60,A01,757569,Meharena; Hiruy Sibhatu,16,0,16,0
1731502828170,BILD 60,A02,757570,Meharena; Hiruy Sibhatu,16,0,16,0
1731502828170,BILD 60,A03,757571,Meharena; Hiruy Sibhatu,16,0,16,0
1731502828170,BILD 60,A04,757572,Meharena; Hiruy Sibhatu,16,0,16,0
1731502829204,BILD 62,A01,757574,Juavinett; Ashley Lauren,22,0,24,2
1731502829204,BILD 62,A02,757575,Juavinett; Ashley Lauren,23,0,24,1
1731502829204,BILD 62,A03,757576,Juavinett; Ashley Lauren,21,0,24,3
1731502829204,BILD 62,A04,757712,Juavinett; Ashley Lauren,22,0,24,2
1731502830229,BILD 87,A00,757714,Saier; Milton H.,20,0,20,0
1731502830229,BILD 87,B00,757715,Saier; Milton H.,19,0,20,1
1731502831258,BIMM 100,A01,785694,Cook-Andersen; Heidi Leigh,46,0,48,2
1731502831258,BIMM 100,A02,785696,Cook-Andersen; Heidi Leigh,48,0,48,0
1731502831258,BIMM 100,A03,785706,Cook-Andersen; Heidi Leigh,42,0,48,6
1731502831258,BIMM 100,A04,785714,Cook-Andersen; Heidi Leigh,48,0,48,0
1731502831258,BIMM 100,B01,785715,Akbari; Omar Sultan,45,0,48,3
1731502831258,BIMM 100,B02,785716,Akbari; Omar Sultan,39,0,48,9
1731502831258,BIMM 100,B03,785717,Akbari; Omar Sultan,46,0,48,2
1731502831258,BIMM 100,B04,785718,Akbari; Omar Sultan,46,0,48,2
1731502832290,BIMM 101,A01,758279,Meaders; Clara Leigh,0,0,24,24
1731502832290,BIMM 101,A02,758280,Meaders; Clara Leigh,0,0,24,24
1731502832290,BIMM 101,B01,758282,Tour; Ella,8,0,24,16
1731502832290,BIMM 101,B02,758283,Tour; Ella,14,0,24,10
1731502832290,BIMM 101,C01,758285,Day; Christopher D,19,0,24,5
1731502832290,BIMM 101,C02,758286,Day; Christopher D,22,0,24,2
1731502832290,BIMM 101,D01,758293,Cooper; Andrew Michael,19,0,24,5
1731502832290,BIMM 101,D02,758323,Cooper; Andrew Michael,20,0,24,4
1731502832290,BIMM 101,E01,758342,Rusert; Jessica Marie,21,0,24,3
1731502832290,BIMM 101,E02,758343,Rusert; Jessica Marie,24,0,24,0
1731502832290,BIMM 101,F01,758345,Rusert; Jessica Marie,23,0,24,1
1731502832290,BIMM 101,F02,758346,Rusert; Jessica Marie,24,0,24,0
1731502833315,BIMM 112,A01,758422,Kadonaga; James T,38,0,40,2
1731502833315,BIMM 112,A02,758427,Kadonaga; James T,33,0,40,7
1731502833315,BIMM 112,A03,758428,Kadonaga; James T,35,0,40,5
1731502833315,BIMM 112,A04,758429,Kadonaga; James T,39,0,40,1
1731502834340,BIMM 114,A01,758433,Daugherty; Matthew Dorton,39,0,48,9
1731502834340,BIMM 114,A02,758434,Daugherty; Matthew Dorton,46,0,48,2
1731502834340,BIMM 114,A03,758441,Daugherty; Matthew Dorton,45,0,48,3
1731502834340,BIMM 114,A04,758449,Daugherty; Matthew Dorton,42,0,48,6
1731502835378,BIMM 121,A01,758694,Gustafson-Brown; Cindy,13,0,24,11
1731502835378,BIMM 121,A02,758695,Gustafson-Brown; Cindy,20,0,24,4
1731502835378,BIMM 121,B01,758854,Gustafson-Brown; Cindy,18,0,24,6
1731502835378,BIMM 121,B02,758855,Gustafson-Brown; Cindy,19,0,24,5
1731502835378,BIMM 121,C01,758859,Pirino; Giorgia,4,0,24,20
1731502835378,BIMM 121,C02,758860,Pirino; Giorgia,11,0,24,13
1731502836412,BIMM 134,A01,758866,Burg; Michael,76,0,103,27
1731502836412,BIMM 134,A02,758867,Burg; Michael,102,0,103,1
1731502836412,BIMM 134,A03,758868,Burg; Michael,84,0,103,19
1731502836412,BIMM 134,A04,758870,Burg; Michael,97,0,101,4
1731502837443,BIMM 143,A01,758872,Grant; Barry J,12,0,40,28
1731502837443,BIMM 143,B01,759109,Bozinovic; Goran,30,0,40,10
1731502838472,BIMM 143R,A01,759111,Bozinovic; Goran,23,0,40,17
1731502839520,BIMM 172,A01,759115,Briggs; Steven,10,0,15,5
1731502839520,BIMM 172,A02,759116,Briggs; Steven,11,0,15,4
1731502839520,BIMM 172,A03,759117,Briggs; Steven,5,0,15,10
1731502839520,BIMM 172,A04,759119,Briggs; Steven,10,0,15,5
1731502840551,BIMM 181,A01,759121,Pevzner; Pavel Arkadjevich,31,0,60,29
1731502841574,BIMM 194,A00,759122,Akbari; Omar Sultan,31,0,32,1
1731502841574,BIMM 194,B00,759123,Lykke-Andersen; Jens,11,0,32,21
1731502841574,BIMM 194,C00,759125,Hasty; Jeff M,29,0,32,3
1731502842606,BIOM 200C,A00,734458,Benner; Christopher William,2,0,28,26
1731502843632,BIOM 202,A01,734460,Corbett; Kevin Daniel,23,0,35,12
1731502844658,BIOM 203B,A00,800936,Gustafsson; Asa Birgitta,35,0,35,0
1731502845688,BIOM 218,A00,734462,Gagneux; Pascal,12,0,12,0
1731502846723,BIOM 246,A00,796600,Gordts; Philip & Lewis; Amanda Lark & Godula; Kamil & Gagneux; Pascal & Esko; Jeffrey D. & Bode; Lars,0,0,0,0
1731502847749,BIOM 253,A00,734463,Nizet; Victor F.,7,0,15,8
1731502848775,BIOM 255,A00,734466,Joiner; William J.,0,0,0,0
1731502849808,BIOM 256,A00,734467,Yang; Jing,0,0,0,0
1731502850834,BIOM 262,A01,734469,Goren; Alon M,19,0,20,1
1731502851872,BIOM 275,A01,734471,Antal; Corina Elena & Obara; Christopher & Mendiola; Andrew & Gonzalez; David J,1,0,28,27
1731502852905,BIOM 277,A01,797835,Klemke; Richard,0,0,0,0
1731502853933,BIOM 287,A00,734472,Khojah; Reem I,0,0,0,0
1731502854958,BIOM 295,A00,734474,Joiner; William J.,0,0,0,0
1731502856000,BIPN 100,A01,787002,Maita; Isabella Vincenza,57,0,61,4
1731502856000,BIPN 100,A02,787005,Maita; Isabella Vincenza,58,0,61,3
1731502856000,BIPN 100,A03,787008,Maita; Isabella Vincenza,58,0,61,3
1731502856000,BIPN 100,A04,787009,Maita; Isabella Vincenza,60,0,62,2
1731502856000,BIPN 100,B01,786881,Reyes Gonzalez; Catalina,61,0,61,0
1731502856000,BIPN 100,B02,786882,Reyes Gonzalez; Catalina,60,0,61,1
1731502856000,BIPN 100,B03,786883,Reyes Gonzalez; Catalina,55,0,61,6
1731502856000,BIPN 100,B04,786884,Reyes Gonzalez; Catalina,55,0,62,7
1731502856000,BIPN 100,C01,787011,Marino; Marc J,53,0,61,8
1731502856000,BIPN 100,C02,787013,Marino; Marc J,56,0,61,5
1731502856000,BIPN 100,C03,787014,Marino; Marc J,59,0,61,2
1731502856000,BIPN 100,C04,787015,Marino; Marc J,53,0,62,9
1731502856000,BIPN 100,D01,794575,Yang; Mingyu,35,0,36,1
1731502856000,BIPN 100,D02,794600,Yang; Mingyu,35,0,36,1
1731502856000,BIPN 100,D03,794576,Yang; Mingyu,35,0,36,1
1731502856000,BIPN 100,D04,794601,Yang; Mingyu,37,0,37,0
1731502857030,BIPN 102,A01,759131,Reyes Gonzalez; Catalina,36,0,61,25
1731502857030,BIPN 102,A02,759133,Reyes Gonzalez; Catalina,56,0,61,5
1731502857030,BIPN 102,A03,759134,Reyes Gonzalez; Catalina,56,0,61,5
1731502857030,BIPN 102,A04,759135,Reyes Gonzalez; Catalina,59,0,62,3
1731502858059,BIPN 105,A01,759139,Armour; Jon Christopher,4,0,21,17
1731502858059,BIPN 105,A02,759140,Armour; Jon Christopher,15,0,21,6
1731502858059,BIPN 105,B01,759144,Armour; Jon Christopher,14,0,21,7
1731502858059,BIPN 105,B02,759147,Armour; Jon Christopher,21,0,21,0
1731502859084,BIPN 140,A01,759149,Lovett-Barron; Matthew Rod,31,0,40,9
1731502859084,BIPN 140,A02,759150,Lovett-Barron; Matthew Rod,40,0,40,0
1731502859084,BIPN 140,A03,759152,Lovett-Barron; Matthew Rod,38,0,40,2
1731502859084,BIPN 140,A04,759154,Lovett-Barron; Matthew Rod,37,0,38,1
1731502860126,BIPN 145,A01,759171,Juavinett; Ashley Lauren,34,0,42,8
1731502860126,BIPN 145,B01,759173,Maita; Isabella Vincenza,40,0,42,2
1731502860126,BIPN 145,C01,759176,Marino; Marc J,30,0,42,12
1731502861152,BIPN 154,A01,759178,Lim; Byungkook,26,0,30,4
1731502861152,BIPN 154,A02,759179,Lim; Byungkook,28,0,30,2
1731502861152,BIPN 154,A03,759180,Lim; Byungkook,28,0,30,2
1731502861152,BIPN 154,A04,759181,Lim; Byungkook,26,0,31,5
1731502862182,BIPN 160,A01,759183,Root; Cory Matthew,45,0,62,17
1731502862182,BIPN 160,A02,759186,Root; Cory Matthew,58,0,62,4
1731502862182,BIPN 160,A03,759187,Root; Cory Matthew,61,0,62,1
1731502862182,BIPN 160,A04,759188,Root; Cory Matthew,51,0,61,10
1731502863208,BIPN 162,A01,759190,Benna; Marcus K,4,0,7,3
1731502863208,BIPN 162,A02,759191,Benna; Marcus K,2,0,7,5
1731502863208,BIPN 162,A03,759192,Benna; Marcus K,4,0,7,3
1731502863208,BIPN 162,A04,759194,Benna; Marcus K,8,0,9,1
1731502864236,BIPN 194,A00,759195,Ackerman; Susan,31,0,32,1
1731502864236,BIPN 194,B00,759196,Leutgeb; Jill K.,14,0,32,18
1731502864236,BIPN 194,C00,759197,Banghart; Matthew Ryan,28,0,32,4
1731502864236,BIPN 194,E00,759201,Meharena; Hiruy Sibhatu,32,0,32,0
1731502865267,BISP 193,001,795783,Maita; Isabella Vincenza,9999,0,9999,0
1731502866319,BISP 194,A00,759202,Newsam; John,14,0,32,18
1731502866319,BISP 194,B00,759203,Cooper; Kimberly Lynn,20,0,32,12
1731502867350,BNFO 262,A01,734447,Goren; Alon M,4,0,5,1
1731502868377,BNFO 281,A00,734448,Gaasterland; Theresa,74,0,100,26
1731502869405,BNFO 283,A00,734456,Fisch; Kathleen Marie & Sahoo; Debashis,7,0,23,16
1731502869405,BNFO 283,B00,734457,Abagyan; Ruben & Bansal; Vikas,11,0,23,12
1731502870433,BNFO 286,A00,734451,Ideker; Trey,26,0,30,4
1731502871461,BNFO 294,A01,734453,Ross; Camille,45,0,50,5
1731502872541,CAT 2,A01,740617,Bronstein; Phoebe Malan,16,0,16,0
1731502872541,CAT 2,A02,740618,Bronstein; Phoebe Malan,9,0,16,7
1731502872541,CAT 2,A03,740619,Bronstein; Phoebe Malan,0,0,16,16
1731502872541,CAT 2,A04,740620,Bronstein; Phoebe Malan,9,0,16,7
1731502872541,CAT 2,A05,740621,Bronstein; Phoebe Malan,8,0,16,8
1731502872541,CAT 2,A06,740623,Bronstein; Phoebe Malan,12,0,16,4
1731502872541,CAT 2,A07,740625,Bronstein; Phoebe Malan,14,0,16,2
1731502872541,CAT 2,A08,740628,Bronstein; Phoebe Malan,15,0,16,1
1731502872541,CAT 2,A09,740629,Bronstein; Phoebe Malan,16,0,16,0
1731502872541,CAT 2,A10,740679,Bronstein; Phoebe Malan,16,0,16,0
1731502872541,CAT 2,A11,740681,Bronstein; Phoebe Malan,13,0,16,3
1731502872541,CAT 2,A12,740686,Bronstein; Phoebe Malan,13,0,16,3
1731502872541,CAT 2,A13,740698,Bronstein; Phoebe Malan,12,0,16,4
1731502872541,CAT 2,A14,740703,Bronstein; Phoebe Malan,12,0,16,4
1731502872541,CAT 2,A15,740704,Bronstein; Phoebe Malan,15,0,16,1
1731502872541,CAT 2,A16,740709,Bronstein; Phoebe Malan,13,0,16,3
1731502872541,CAT 2,B01,740715,Bigham; David Joseph,15,0,16,1
1731502872541,CAT 2,B02,740761,Bigham; David Joseph,14,0,16,2
1731502872541,CAT 2,B03,740762,Bigham; David Joseph,12,0,16,4
1731502872541,CAT 2,B04,740763,Bigham; David Joseph,12,0,16,4
1731502872541,CAT 2,B05,740764,Bigham; David Joseph,16,0,16,0
1731502872541,CAT 2,B06,740765,Bigham; David Joseph,13,0,16,3
1731502872541,CAT 2,B07,740767,Bigham; David Joseph,16,0,16,0
1731502872541,CAT 2,B08,740768,Bigham; David Joseph,16,0,16,0
1731502872541,CAT 2,B09,740770,Bigham; David Joseph,16,0,16,0
1731502872541,CAT 2,B10,740772,Bigham; David Joseph,12,0,16,4
1731502872541,CAT 2,B11,740773,Bigham; David Joseph,15,0,16,1
1731502872541,CAT 2,B12,740774,Bigham; David Joseph,16,0,16,0
1731502872541,CAT 2,B13,740777,Bigham; David Joseph,14,0,16,2
1731502872541,CAT 2,B14,740780,Bigham; David Joseph,12,0,16,4
1731502872541,CAT 2,B15,740781,Bigham; David Joseph,16,0,16,0
1731502872541,CAT 2,B16,740848,Bigham; David Joseph,16,0,16,0
1731502872541,CAT 2,C01,740895,Marchisotto; Jennifer Anne,16,0,16,0
1731502872541,CAT 2,C02,740896,Marchisotto; Jennifer Anne,13,0,16,3
1731502872541,CAT 2,C03,740908,Marchisotto; Jennifer Anne,12,0,16,4
1731502872541,CAT 2,C04,740944,Marchisotto; Jennifer Anne,14,0,16,2
1731502872541,CAT 2,C05,740945,Marchisotto; Jennifer Anne,15,0,16,1
1731502872541,CAT 2,C06,740946,Marchisotto; Jennifer Anne,16,0,16,0
1731502872541,CAT 2,C07,740947,Marchisotto; Jennifer Anne,14,0,16,2
1731502872541,CAT 2,C08,740949,Marchisotto; Jennifer Anne,16,0,16,0
1731502872541,CAT 2,C09,740960,Marchisotto; Jennifer Anne,16,0,16,0
1731502872541,CAT 2,C10,740966,Marchisotto; Jennifer Anne,15,0,16,1
1731502872541,CAT 2,C11,741017,Marchisotto; Jennifer Anne,15,0,16,1
1731502872541,CAT 2,C12,741018,Marchisotto; Jennifer Anne,14,0,16,2
1731502872541,CAT 2,C13,741019,Marchisotto; Jennifer Anne,16,0,16,0
1731502872541,CAT 2,C14,741024,Marchisotto; Jennifer Anne,15,0,16,1
1731502872541,CAT 2,D01,741027,Nguyen; Hoang A.,14,0,16,2
1731502872541,CAT 2,D02,741028,Nguyen; Hoang A.,6,0,16,10
1731502872541,CAT 2,D03,741029,Nguyen; Hoang A.,9,0,16,7
1731502872541,CAT 2,D04,741031,Nguyen; Hoang A.,15,0,16,1
1731502872541,CAT 2,D05,741033,Nguyen; Hoang A.,16,0,16,0
1731502872541,CAT 2,D06,741034,Nguyen; Hoang A.,15,0,16,1
1731502872541,CAT 2,D07,741035,Nguyen; Hoang A.,16,0,16,0
1731502872541,CAT 2,D08,741036,Nguyen; Hoang A.,16,0,16,0
1731502872541,CAT 2,D09,741039,Nguyen; Hoang A.,14,0,16,2
1731502872541,CAT 2,D10,741042,Nguyen; Hoang A.,14,0,16,2
1731502872541,CAT 2,D11,741045,Nguyen; Hoang A.,15,0,16,1
1731502872541,CAT 2,D12,741047,Nguyen; Hoang A.,15,0,16,1
1731502872541,CAT 2,D13,741049,Nguyen; Hoang A.,15,0,16,1
1731502872541,CAT 2,D14,741054,Nguyen; Hoang A.,15,0,16,1
1731502873569,CAT 2CE,A01,741072,Popko; Elizabeth Ashley,24,0,25,1
1731502874600,CAT 87,A00,741105,Bronstein; Phoebe Malan,20,0,20,0
1731502874600,CAT 87,B00,795240,Delaville; Romain,20,0,20,0
1731502875629,CAT 124,A01,741118,Geibel; William,20,0,20,0
1731502875629,CAT 124,B01,799621,Staff,20,0,20,0
1731502876660,CAT 125,001,741143,Bigham; David Joseph,20,0,20,0
1731502876660,CAT 125,002,741149,Bigham; David Joseph,16,0,20,4
1731502876660,CAT 125,003,741152,Marchisotto; Jennifer Anne,20,0,20,0
1731502876660,CAT 125,004,741162,Marchisotto; Jennifer Anne,16,0,20,4
1731502876660,CAT 125,006,741164,Delaville; Romain,19,0,20,1
1731502876660,CAT 125,007,741180,Vanderschuit; Maya Alysia,19,0,20,1
1731502876660,CAT 125,008,741192,Vanderschuit; Maya Alysia,20,0,20,0
1731502876660,CAT 125,009,741193,Vanderschuit; Maya Alysia,19,0,20,1
1731502876660,CAT 125,010,741205,Morales; Celeste Georgianna,19,0,20,1
1731502876660,CAT 125,011,741207,Morales; Celeste Georgianna,20,0,20,0
1731502876660,CAT 125,012,741208,Morales; Celeste Georgianna,20,0,20,0
1731502876660,CAT 125,013,741209,Rose; Becca Rae,18,0,20,2
1731502876660,CAT 125,014,741215,Rose; Becca Rae,20,0,20,0
1731502876660,CAT 125,015,741222,Rose; Becca Rae,20,0,20,0
1731502876660,CAT 125,016,741224,Tosun; Adriana,18,0,20,2
1731502876660,CAT 125,017,741225,Tosun; Adriana,19,0,20,1
1731502877699,CAT 125R,A00,741229,Smith; Lauryn Alissa,17,0,20,3
1731502877699,CAT 125R,B00,741230,Smith; Lauryn Alissa,18,0,20,2
1731502877699,CAT 125R,C00,741231,Smith; Lauryn Alissa,16,0,20,4
1731502877699,CAT 125R,D00,741237,Hyland; Tina Mae,16,0,20,4
1731502877699,CAT 125R,E00,741240,Hyland; Tina Mae,17,0,20,3
1731502877699,CAT 125R,F00,741242,Hyland; Tina Mae,18,0,20,2
1731502877699,CAT 125R,G00,741243,Tosun; Adriana,15,0,20,5
1731502878746,CCE 1,001,744105,Labat Ii; Michael Luis,38,0,40,2
1731502878746,CCE 1,002,744106,Garcia; Kathryn Mary,37,0,40,3
1731502878746,CCE 1,003,744107,Lee; Kassandra,38,0,40,2
1731502878746,CCE 1,004,744108,Crawford; James,36,0,40,4
1731502878746,CCE 1,005,744109,Merryman; Ashley,39,0,40,1
1731502878746,CCE 1,006,744110,Santos; Vabianna Daria,39,0,40,1
1731502878746,CCE 1,007,744125,Bigley; Michele Heather,37,0,40,3
1731502879776,CCE 2,001,744126,Staff,19,0,20,1
1731502879776,CCE 2,002,744127,Garcia; Kathryn Mary,20,0,20,0
1731502879776,CCE 2,003,744128,Labat Ii; Michael Luis,20,0,20,0
1731502879776,CCE 2,004,744129,Labat Ii; Michael Luis,20,0,20,0
1731502879776,CCE 2,005,744130,Garcia; Kathryn Mary,20,0,20,0
1731502879776,CCE 2,006,744131,Lee; Kassandra,20,0,20,0
1731502879776,CCE 2,007,744132,Lee; Kassandra,20,0,20,0
1731502879776,CCE 2,008,744133,Santos; Vabianna Daria,20,0,20,0
1731502879776,CCE 2,009,744134,Santos; Vabianna Daria,19,0,20,1
1731502879776,CCE 2,010,744135,Bigley; Michele Heather,20,0,20,0
1731502879776,CCE 2,011,744167,Merryman; Ashley,20,0,20,0
1731502879776,CCE 2,012,744168,Merryman; Ashley,20,0,20,0
1731502880810,CCS 102,A00,795242,Werner; Bradley T.,15,0,20,5
1731502881838,CCS 123,A00,794510,Staff,25,0,25,0
1731502882870,CENG 15,A01,734482,Yang; Kesong,25,0,25,0
1731502883899,CENG 101A,A00,734483,Staff,49,0,50,1
1731502884928,CENG 101B,A00,734484,Liu; Ping,99,0,100,1
1731502885960,CENG 102,A00,734485,Powell; Alyssa,69,0,70,1
1731502885960,CENG 102,B00,734486,Powell; Alyssa,68,0,70,2
1731502886987,CENG 114,A00,734487,Jahed Motlagh; Zeinab,97,0,100,3
1731502888016,CENG 124A,A00,734488,Drews; Aaron,42,0,60,18
1731502888016,CENG 124A,B00,734489,Russ; Benjamin Edward,53,0,60,7
1731502889049,CENG 134,A00,734490,Pokorski; Jonathan Kyle,63,0,70,7
1731502890077,CENG 176A,A01,734492,Opatkiewicz; Justin Paul,11,0,48,37
1731502890077,CENG 176A,B01,734494,Zhang; Liangfang,55,0,60,5
1731502891106,CENG 205,A00,734495,Jahed Motlagh; Zeinab,40,0,60,20
1731502892132,CENG 213,A00,734496,Fenning; David,6,0,10,4
1731502893161,CENG 214,A00,734497,Li; Wan-Lu,10,0,10,0
1731502894186,CENG 215,A00,734498,Jokerst; Jesse Vincent,10,0,10,0
1731502895212,CENG 221B,A00,734499,Staff,28,0,50,22
1731502896238,CENG 251,A00,734500,Pascal; Tod A,29,0,50,21
1731502897271,CENG 252,A00,734501,Chen; Zheng,28,0,50,22
1731502898296,CENG 256,A00,734502,Meyers; Marc,10,0,10,0
1731502899324,CGS 101,A00,740473,Cuong; Marisol,35,0,35,0
1731502900354,CGS 108,A00,740486,Lu; Lillian,20,0,20,0
1731502901381,CGS 111,A00,740518,Martin Sandino; Amanda Maria Yoland,31,0,35,4
1731502902407,CGS 116,A00,740521,Cuong; Marisol,31,0,32,1
1731502903460,CGS 124,A00,740524,Martin Sandino; Amanda Maria Yoland,14,0,15,1
1731502904488,CGS 125,A00,740528,Browne; Errol Tsekani,19,0,20,1
1731502905515,CGS 135,A00,740534,Okonkwo; Holly,15,0,15,0
1731502906542,CGS 136,A00,740538,Chatti; Deepti,15,0,15,0
1731502907571,CGS 137,A00,740541,Martin Sandino; Amanda Maria Yoland,19,0,20,1
1731502908600,CGS 165,A00,740547,Browne; Errol Tsekani,13,0,15,2
1731502909632,CGS 167A,A00,740604,Patel; Shaista,11,0,12,1
1731502910658,CGS 187,A00,740608,Cuong; Marisol,13,0,15,2
1731502911694,CGS 196A,A00,740611,Taylor-Garcia; Daphne,1,0,1,0
1731502911694,CGS 196A,B00,799481,Hankins; Joseph D.,1,0,1,0
1731502911694,CGS 196A,C00,799482,Yapp; Hentyle T,1,0,1,0
1731502912721,CHEM 1,A00,734503,Brydges; Stacey,39,0,40,1
1731502913757,CHEM 6A,A01,784433,Lam; Tin Yiu,38,0,40,2
1731502913757,CHEM 6A,A02,784434,Lam; Tin Yiu,40,0,40,0
1731502913757,CHEM 6A,A03,784436,Lam; Tin Yiu,39,0,40,1
1731502913757,CHEM 6A,A04,784437,Lam; Tin Yiu,35,0,40,5
1731502913757,CHEM 6A,A05,784438,Lam; Tin Yiu,40,0,40,0
1731502913757,CHEM 6A,A06,784440,Lam; Tin Yiu,40,0,40,0
1731502913757,CHEM 6A,A07,784441,Lam; Tin Yiu,0,0,0,0
1731502913757,CHEM 6A,B01,784443,Lam; Tin Yiu,40,0,40,0
1731502913757,CHEM 6A,B02,784445,Lam; Tin Yiu,34,0,36,2
1731502913757,CHEM 6A,B03,784446,Lam; Tin Yiu,34,0,40,6
1731502913757,CHEM 6A,B04,784449,Lam; Tin Yiu,38,0,40,2
1731502913757,CHEM 6A,B05,784454,Lam; Tin Yiu,37,0,40,3
1731502913757,CHEM 6A,B06,784455,Lam; Tin Yiu,39,0,40,1
1731502913757,CHEM 6A,B07,784456,Lam; Tin Yiu,0,0,0,0
1731502913757,CHEM 6A,C01,784457,Ternansky; Robert J.,40,0,40,0
1731502913757,CHEM 6A,C02,784458,Ternansky; Robert J.,33,0,40,7
1731502913757,CHEM 6A,C03,784460,Ternansky; Robert J.,33,0,40,7
1731502913757,CHEM 6A,C04,784461,Ternansky; Robert J.,40,0,40,0
1731502913757,CHEM 6A,C05,784462,Ternansky; Robert J.,40,0,40,0
1731502913757,CHEM 6A,C06,784465,Ternansky; Robert J.,40,0,40,0
1731502913757,CHEM 6A,C07,784468,Ternansky; Robert J.,0,0,0,0
1731502914807,CHEM 6B,A01,784469,Kummel; Andrew C,40,0,40,0
1731502914807,CHEM 6B,A02,784470,Kummel; Andrew C,40,0,40,0
1731502914807,CHEM 6B,A03,784471,Kummel; Andrew C,39,0,40,1
1731502914807,CHEM 6B,A04,784472,Kummel; Andrew C,38,0,40,2
1731502914807,CHEM 6B,A05,784473,Kummel; Andrew C,37,0,40,3
1731502914807,CHEM 6B,A06,784474,Kummel; Andrew C,39,0,40,1
1731502914807,CHEM 6B,A07,784475,Kummel; Andrew C,0,0,0,0
1731502914807,CHEM 6B,B01,784481,Sailor; Michael Joseph,39,0,40,1
1731502914807,CHEM 6B,B02,784482,Sailor; Michael Joseph,39,0,40,1
1731502914807,CHEM 6B,B03,784483,Sailor; Michael Joseph,39,0,40,1
1731502914807,CHEM 6B,B04,784484,Sailor; Michael Joseph,40,0,40,0
1731502914807,CHEM 6B,B05,784485,Sailor; Michael Joseph,40,0,40,0
1731502914807,CHEM 6B,B06,784486,Sailor; Michael Joseph,40,0,40,0
1731502914807,CHEM 6B,B07,784487,Sailor; Michael Joseph,0,0,0,0
1731502914807,CHEM 6B,C01,784489,Stallings; Dontarie M,33,0,40,7
1731502914807,CHEM 6B,C02,784490,Stallings; Dontarie M,20,0,24,4
1731502914807,CHEM 6B,C03,784491,Stallings; Dontarie M,37,0,40,3
1731502914807,CHEM 6B,C04,784525,Stallings; Dontarie M,36,0,40,4
1731502914807,CHEM 6B,C05,784529,Stallings; Dontarie M,40,0,40,0
1731502914807,CHEM 6B,C06,784532,Stallings; Dontarie M,39,0,40,1
1731502914807,CHEM 6B,C07,784534,Stallings; Dontarie M,0,0,0,0
1731502914807,CHEM 6B,D01,784537,Stallings; Dontarie M,29,0,40,11
1731502914807,CHEM 6B,D02,784540,Stallings; Dontarie M,33,0,40,7
1731502914807,CHEM 6B,D03,784543,Stallings; Dontarie M,37,0,40,3
1731502914807,CHEM 6B,D04,784544,Stallings; Dontarie M,37,0,40,3
1731502914807,CHEM 6B,D05,784546,Stallings; Dontarie M,38,0,40,2
1731502914807,CHEM 6B,D06,784547,Stallings; Dontarie M,38,0,40,2
1731502914807,CHEM 6B,D07,784553,Stallings; Dontarie M,0,0,0,0
1731502914807,CHEM 6B,E01,784556,Young; Mark,40,0,40,0
1731502914807,CHEM 6B,E02,784557,Young; Mark,40,0,40,0
1731502914807,CHEM 6B,E03,784566,Young; Mark,40,0,40,0
1731502914807,CHEM 6B,E04,784568,Young; Mark,40,0,40,0
1731502914807,CHEM 6B,E05,784571,Young; Mark,40,0,40,0
1731502914807,CHEM 6B,E06,784572,Young; Mark,39,0,40,1
1731502914807,CHEM 6B,E07,784574,Young; Mark,0,0,0,0
1731502914807,CHEM 6B,F01,784578,Young; Mark,40,0,40,0
1731502914807,CHEM 6B,F02,784581,Young; Mark,40,0,40,0
1731502914807,CHEM 6B,F03,784582,Young; Mark,40,0,40,0
1731502914807,CHEM 6B,F04,784584,Young; Mark,40,0,40,0
1731502914807,CHEM 6B,F05,784585,Young; Mark,40,0,40,0
1731502914807,CHEM 6B,F06,784589,Young; Mark,40,0,40,0
1731502914807,CHEM 6B,F07,784591,Young; Mark,0,0,0,0
1731502914807,CHEM 6B,G01,785227,Schurmeier; Kimberly,35,0,40,5
1731502914807,CHEM 6B,G02,785228,Schurmeier; Kimberly,37,0,40,3
1731502914807,CHEM 6B,G03,785229,Schurmeier; Kimberly,35,0,40,5
1731502914807,CHEM 6B,G04,785230,Schurmeier; Kimberly,0,0,0,0
1731502914807,CHEM 6B,G05,785231,Schurmeier; Kimberly,39,0,40,1
1731502914807,CHEM 6B,G06,785233,Schurmeier; Kimberly,34,0,40,6
1731502914807,CHEM 6B,G07,785234,Schurmeier; Kimberly,39,0,40,1
1731502915836,CHEM 6BH,A01,785675,Yuen Zhou; Joel,49,0,50,1
1731502916873,CHEM 6C,A01,785073,Ternansky; Robert J.,40,0,40,0
1731502916873,CHEM 6C,A02,785074,Ternansky; Robert J.,37,0,40,3
1731502916873,CHEM 6C,A03,785148,Ternansky; Robert J.,38,0,40,2
1731502916873,CHEM 6C,A04,785155,Ternansky; Robert J.,40,0,40,0
1731502916873,CHEM 6C,A05,785158,Ternansky; Robert J.,0,0,0,0
1731502916873,CHEM 6C,A06,785159,Ternansky; Robert J.,36,0,40,4
1731502916873,CHEM 6C,A07,785160,Ternansky; Robert J.,40,0,40,0
1731502916873,CHEM 6C,B01,784597,Albizati; Kim F.,26,0,40,14
1731502916873,CHEM 6C,B02,784600,Albizati; Kim F.,38,0,40,2
1731502916873,CHEM 6C,B03,784603,Albizati; Kim F.,34,0,40,6
1731502916873,CHEM 6C,B04,784604,Albizati; Kim F.,34,0,40,6
1731502916873,CHEM 6C,B05,784606,Albizati; Kim F.,39,0,40,1
1731502916873,CHEM 6C,B06,784607,Albizati; Kim F.,38,0,40,2
1731502916873,CHEM 6C,B07,784610,Albizati; Kim F.,0,0,0,0
1731502917925,CHEM 7L,A01,734519,Leigh; Brian,24,0,24,0
1731502917925,CHEM 7L,A02,734520,Leigh; Brian,23,0,24,1
1731502917925,CHEM 7L,A03,734521,Leigh; Brian,24,0,24,0
1731502917925,CHEM 7L,A04,734522,Leigh; Brian,21,0,21,0
1731502917925,CHEM 7L,A05,734523,Leigh; Brian,22,0,24,2
1731502917925,CHEM 7L,A06,734524,Leigh; Brian,24,0,24,0
1731502917925,CHEM 7L,A07,734525,Leigh; Brian,23,0,24,1
1731502917925,CHEM 7L,A08,734526,Leigh; Brian,23,0,24,1
1731502917925,CHEM 7L,A09,734527,Leigh; Brian,23,0,24,1
1731502917925,CHEM 7L,A10,734528,Leigh; Brian,19,0,21,2
1731502917925,CHEM 7L,B01,734530,Leigh; Brian,14,0,24,10
1731502917925,CHEM 7L,B02,734531,Leigh; Brian,22,0,24,2
1731502917925,CHEM 7L,B03,734532,Leigh; Brian,24,0,24,0
1731502917925,CHEM 7L,B04,734533,Leigh; Brian,24,0,24,0
1731502917925,CHEM 7L,B05,734534,Leigh; Brian,24,0,24,0
1731502917925,CHEM 7L,B06,734535,Leigh; Brian,22,0,24,2
1731502917925,CHEM 7L,B07,734536,Leigh; Brian,20,0,21,1
1731502917925,CHEM 7L,B08,734537,Leigh; Brian,13,0,24,11
1731502917925,CHEM 7L,B09,734538,Leigh; Brian,21,0,24,3
1731502917925,CHEM 7L,B10,734539,Leigh; Brian,22,0,24,2
1731502917925,CHEM 7L,C01,734541,Leigh; Brian,21,0,24,3
1731502917925,CHEM 7L,C02,734542,Leigh; Brian,23,0,24,1
1731502917925,CHEM 7L,C03,734543,Leigh; Brian,23,0,24,1
1731502917925,CHEM 7L,C04,734624,Leigh; Brian,24,0,24,0
1731502917925,CHEM 7L,C05,734625,Leigh; Brian,20,0,24,4
1731502917925,CHEM 7L,C06,734626,Leigh; Brian,23,0,24,1
1731502917925,CHEM 7L,C07,734658,Leigh; Brian,21,0,24,3
1731502917925,CHEM 7L,C08,734668,Leigh; Brian,23,0,24,1
1731502917925,CHEM 7L,C09,734754,Leigh; Brian,24,0,24,0
1731502917925,CHEM 7L,C10,734758,Leigh; Brian,19,0,21,2
1731502918953,CHEM 11,A01,785161,Huang; Xuemei,36,0,40,4
1731502918953,CHEM 11,A02,785164,Huang; Xuemei,39,0,40,1
1731502918953,CHEM 11,A03,785168,Huang; Xuemei,39,0,40,1
1731502918953,CHEM 11,A04,785169,Huang; Xuemei,40,0,40,0
1731502918953,CHEM 11,A05,785175,Huang; Xuemei,39,0,40,1
1731502918953,CHEM 11,A06,785177,Huang; Xuemei,35,0,40,5
1731502918953,CHEM 11,A07,785178,Huang; Xuemei,39,0,40,1
1731502918953,CHEM 11,A08,785179,Huang; Xuemei,39,0,40,1
1731502919988,CHEM 40A,A01,784614,Cohen; Seth M,29,0,40,11
1731502919988,CHEM 40A,A02,784615,Cohen; Seth M,38,0,40,2
1731502919988,CHEM 40A,A03,784617,Cohen; Seth M,32,0,39,7
1731502919988,CHEM 40A,A04,784632,Cohen; Seth M,38,0,40,2
1731502919988,CHEM 40A,A05,784657,Cohen; Seth M,36,0,40,4
1731502919988,CHEM 40A,A06,784658,Cohen; Seth M,38,0,40,2
1731502919988,CHEM 40A,A07,784689,Cohen; Seth M,40,0,40,0
1731502919988,CHEM 40A,A08,784695,Cohen; Seth M,40,0,40,0
1731502921050,CHEM 40B,A01,785501,Weizman; Haim,38,0,40,2
1731502921050,CHEM 40B,A02,785503,Weizman; Haim,30,0,40,10
1731502921050,CHEM 40B,A03,785504,Weizman; Haim,25,0,40,15
1731502921050,CHEM 40B,A04,785505,Weizman; Haim,38,0,40,2
1731502921050,CHEM 40B,A05,785506,Weizman; Haim,39,0,40,1
1731502921050,CHEM 40B,A06,785507,Weizman; Haim,0,0,0,0
1731502921050,CHEM 40B,A07,798353,Weizman; Haim,35,0,40,5
1731502921050,CHEM 40B,A08,798354,Weizman; Haim,38,0,40,2
1731502921050,CHEM 40B,B01,785184,Romero; Erik Anthony,37,0,40,3
1731502921050,CHEM 40B,B02,785185,Romero; Erik Anthony,39,0,40,1
1731502921050,CHEM 40B,B03,785186,Romero; Erik Anthony,40,0,40,0
1731502921050,CHEM 40B,B04,785187,Romero; Erik Anthony,37,0,40,3
1731502921050,CHEM 40B,B05,785190,Romero; Erik Anthony,40,0,40,0
1731502921050,CHEM 40B,B06,785191,Romero; Erik Anthony,0,0,0,0
1731502921050,CHEM 40B,B07,795158,Romero; Erik Anthony,40,0,40,0
1731502921050,CHEM 40B,B08,795161,Romero; Erik Anthony,40,0,40,0
1731502921050,CHEM 40B,C01,785509,Pun; Andrew Brian,31,0,38,7
1731502921050,CHEM 40B,C02,785510,Pun; Andrew Brian,31,0,40,9
1731502921050,CHEM 40B,C03,785512,Pun; Andrew Brian,38,0,40,2
1731502921050,CHEM 40B,C04,785513,Pun; Andrew Brian,37,0,40,3
1731502921050,CHEM 40B,C05,785514,Pun; Andrew Brian,39,0,40,1
1731502921050,CHEM 40B,C06,785515,Pun; Andrew Brian,34,0,40,6
1731502921050,CHEM 40B,C07,795106,Pun; Andrew Brian,29,0,40,11
1731502921050,CHEM 40B,C08,795148,Pun; Andrew Brian,0,0,0,0
1731502922078,CHEM 41A,A01,785193,Yang; Jerry,35,0,36,1
1731502922078,CHEM 41A,A02,785220,Yang; Jerry,31,0,36,5
1731502922078,CHEM 41A,A03,785221,Yang; Jerry,35,0,37,2
1731502922078,CHEM 41A,A04,785222,Yang; Jerry,37,0,37,0
1731502923106,CHEM 41B,A01,785594,Theodorakis; Emmanuel,35,0,40,5
1731502923106,CHEM 41B,A02,785595,Theodorakis; Emmanuel,40,0,40,0
1731502923106,CHEM 41B,A03,785598,Theodorakis; Emmanuel,36,0,40,4
1731502923106,CHEM 41B,A04,785599,Theodorakis; Emmanuel,24,0,24,0
1731502923106,CHEM 41B,A05,785656,Theodorakis; Emmanuel,39,0,40,1
1731502923106,CHEM 41B,A06,785657,Theodorakis; Emmanuel,40,0,40,0
1731502923106,CHEM 41B,A07,785658,Theodorakis; Emmanuel,37,0,40,3
1731502924162,CHEM 43A,A01,734984,Figueroa; Joshua,13,0,24,11
1731502924162,CHEM 43A,A02,734985,Figueroa; Joshua,22,0,24,2
1731502924162,CHEM 43A,A03,734986,Figueroa; Joshua,24,0,24,0
1731502924162,CHEM 43A,A04,734987,Figueroa; Joshua,22,0,24,2
1731502924162,CHEM 43A,A05,734988,Figueroa; Joshua,0,0,0,0
1731502924162,CHEM 43A,A06,735039,Figueroa; Joshua,0,0,0,0
1731502924162,CHEM 43A,A07,735040,Figueroa; Joshua,0,0,0,0
1731502924162,CHEM 43A,A08,735130,Figueroa; Joshua,0,0,0,0
1731502924162,CHEM 43A,B01,735277,Tor; Yitzhak,0,0,24,24
1731502924162,CHEM 43A,B02,735279,Tor; Yitzhak,12,0,24,12
1731502924162,CHEM 43A,B03,735281,Tor; Yitzhak,19,0,24,5
1731502924162,CHEM 43A,B04,735282,Tor; Yitzhak,16,0,24,8
1731502924162,CHEM 43A,B05,735284,Tor; Yitzhak,0,0,0,0
1731502924162,CHEM 43A,B06,735288,Tor; Yitzhak,0,0,0,0
1731502924162,CHEM 43A,B07,735289,Tor; Yitzhak,0,0,0,0
1731502924162,CHEM 43A,B08,735290,Tor; Yitzhak,0,0,0,0
1731502924162,CHEM 43A,C01,735300,Klosterman; Jeremy K,0,0,0,0
1731502924162,CHEM 43A,C02,735304,Klosterman; Jeremy K,0,0,0,0
1731502924162,CHEM 43A,C03,735308,Klosterman; Jeremy K,0,0,0,0
1731502924162,CHEM 43A,C04,735312,Klosterman; Jeremy K,20,0,24,4
1731502924162,CHEM 43A,C05,735317,Klosterman; Jeremy K,23,0,24,1
1731502924162,CHEM 43A,C06,735319,Klosterman; Jeremy K,24,0,24,0
1731502924162,CHEM 43A,C07,735320,Klosterman; Jeremy K,16,0,17,1
1731502924162,CHEM 43A,C08,735331,Klosterman; Jeremy K,24,0,24,0
1731502925191,CHEM 100A,A01,735347,Slade; Jonathan,19,0,23,4
1731502925191,CHEM 100A,A02,735632,Slade; Jonathan,21,0,24,3
1731502925191,CHEM 100A,A03,735636,Slade; Jonathan,19,0,23,4
1731502925191,CHEM 100A,A04,735637,Slade; Jonathan,21,0,24,3
1731502925191,CHEM 100A,A05,735638,Slade; Jonathan,19,0,24,5
1731502925191,CHEM 100A,A06,735639,Slade; Jonathan,22,0,23,1
1731502926217,CHEM 100B,A01,735649,Pomeroy; Robert S.,18,0,26,8
1731502927246,CHEM 105A,A01,735653,Sinha; Amitabha,31,0,42,11
1731502928275,CHEM 108,A01,735655,Jennings; Patricia A.,9,0,20,11
1731502928275,CHEM 108,A02,735658,Jennings; Patricia A.,23,0,24,1
1731502928275,CHEM 108,B01,735663,Jennings; Patricia A.,13,0,20,7
1731502928275,CHEM 108,B02,735666,Jennings; Patricia A.,21,0,24,3
1731502929316,CHEM 109,A01,735680,Piercy; Marc Anthony,6,0,20,14
1731502929316,CHEM 109,A02,735689,Piercy; Marc Anthony,19,0,24,5
1731502929316,CHEM 109,B01,735768,Piercy; Marc Anthony,17,0,20,3
1731502929316,CHEM 109,B02,735769,Piercy; Marc Anthony,23,0,24,1
1731502930343,CHEM 114A,A01,784696,Komor; Alexis C,39,0,40,1
1731502930343,CHEM 114A,A02,784723,Komor; Alexis C,38,0,40,2
1731502930343,CHEM 114A,A03,784725,Komor; Alexis C,38,0,40,2
1731502931383,CHEM 114B,A01,785242,Budin; Itay,26,0,40,14
1731502931383,CHEM 114B,A02,785299,Budin; Itay,40,0,40,0
1731502931383,CHEM 114B,A03,785306,Budin; Itay,37,0,40,3
1731502931383,CHEM 114B,A04,785309,Budin; Itay,39,0,40,1
1731502931383,CHEM 114B,B01,785313,Ghosh; Partho,39,0,40,1
1731502931383,CHEM 114B,B02,785375,Ghosh; Partho,38,0,40,2
1731502931383,CHEM 114B,B03,785407,Ghosh; Partho,40,0,40,0
1731502931383,CHEM 114B,B04,785410,Ghosh; Partho,40,0,40,0
1731502932409,CHEM 115,A00,735864,Komor; Alexis C,1,0,30,29
1731502933441,CHEM 120A,A01,785412,Stauber; Julia Megan,28,0,40,12
1731502933441,CHEM 120A,A02,785415,Stauber; Julia Megan,37,0,40,3
1731502933441,CHEM 120A,A03,785417,Stauber; Julia Megan,39,0,39,0
1731502933441,CHEM 120A,A04,785423,Stauber; Julia Megan,38,0,39,1
1731502934474,CHEM 126A,A01,784731,Yong; Haiwang,39,0,40,1
1731502934474,CHEM 126A,A02,784732,Yong; Haiwang,38,0,40,2
1731502934474,CHEM 126A,A03,784737,Yong; Haiwang,38,0,40,2
1731502935501,CHEM 126B,A01,785659,Tauber; Michael,14,0,40,26
1731502935501,CHEM 126B,A02,785664,Tauber; Michael,32,0,40,8
1731502935501,CHEM 126B,A03,785665,Tauber; Michael,20,0,40,20
1731502935501,CHEM 126B,A04,785668,Tauber; Michael,39,0,40,1
1731502935501,CHEM 126B,A05,785669,Tauber; Michael,35,0,40,5
1731502935501,CHEM 126B,A06,785671,Tauber; Michael,33,0,40,7
1731502936535,CHEM 131,A01,785425,Galperin; Michael,37,0,40,3
1731502936535,CHEM 131,A02,785499,Galperin; Michael,38,0,40,2
1731502936535,CHEM 131,A03,785500,Galperin; Michael,39,0,40,1
1731502937564,CHEM 134,A00,735869,Pokorski; Jonathan Kyle,16,0,18,2
1731502938592,CHEM 143B,A01,735871,Weizman; Haim,21,0,24,3
1731502938592,CHEM 143B,A02,735872,Weizman; Haim,20,0,24,4
1731502938592,CHEM 143B,A03,735914,Weizman; Haim,11,0,24,13
1731502938592,CHEM 143B,A04,735916,Weizman; Haim,0,0,0,0
1731502938592,CHEM 143B,A05,735918,Weizman; Haim,0,0,0,0
1731502939619,CHEM 151,A00,735919,Donoghue; Daniel J.,86,0,100,14
1731502940646,CHEM 154,A00,735922,Romero; Nathan A & Schmidt; Valerie A,29,0,30,1
1731502941673,CHEM 155,A00,735925,Theodorakis; Emmanuel,10,0,10,0
1731502942701,CHEM 168,A01,785516,Devaraj; Neal Krishna,39,0,40,1
1731502942701,CHEM 168,A02,785551,Devaraj; Neal Krishna,39,0,40,1
1731502942701,CHEM 168,A03,785554,Devaraj; Neal Krishna,37,0,40,3
1731502942701,CHEM 168,A04,785557,Devaraj; Neal Krishna,37,0,40,3
1731502942701,CHEM 168,A05,785559,Devaraj; Neal Krishna,34,0,40,6
1731502942701,CHEM 168,A06,785566,Devaraj; Neal Krishna,36,0,40,4
1731502943735,CHEM 169,A00,794456,Jinich; Adrian,48,0,50,2
1731502944767,CHEM 172,A01,785676,Pomeroy; Robert S.,46,0,50,4
1731502945794,CHEM 187,A00,735955,Brydges; Stacey,19,0,20,1
1731502946821,CHEM 194,A00,735956,Newsam; John,13,0,18,5
1731502947847,CHEM 200B,A00,735957,Pomeroy; Robert S.,8,0,20,12
1731502948873,CHEM 212,A00,735958,Budin; Itay,14,0,30,16
1731502949971,CHEM 213B,A00,735990,Debelouchina; Galia T,32,0,50,18
1731502950997,CHEM 215,A00,735991,Komor; Alexis C,12,0,30,18
1731502952024,CHEM 219C,A00,735992,Jennings; Patricia A.,9,0,15,6
1731502953054,CHEM 223,A00,735993,Oconnor; Joseph M.,25,0,30,5
1731502954081,CHEM 227,A00,735994,Stauber; Julia Megan,28,0,30,2
1731502955109,CHEM 229,A00,735995,Cohen; Seth M,15,0,20,5
1731502956139,CHEM 232A,A00,735996,Yuen Zhou; Joel,13,0,15,2
1731502957172,CHEM 254,A00,735997,Romero; Nathan A & Schmidt; Valerie A,27,0,30,3
1731502958198,CHEM 255,A00,735998,Theodorakis; Emmanuel,18,0,20,2
1731502959228,CHEM 269,A00,794455,Jinich; Adrian,8,0,25,17
1731502960257,CHEM 291,A00,735999,Debelouchina; Galia T,30,0,30,0
1731502961283,CHEM 294,A00,736000,Romero; Nathan A,48,0,50,2
1731502962314,CHIN 10BD,A01,736053,Liu; Mingming,16,0,16,0
1731502962314,CHIN 10BD,A02,736054,Liu; Mingming,16,0,16,0
1731502963342,CHIN 10BM,A01,736056,Chen; Pei-Chia,18,0,20,2
1731502963342,CHIN 10BM,A02,736057,Chen; Pei-Chia,14,0,15,1
1731502964380,CHIN 10BN,A01,736063,Xu; Li,13,0,13,0
1731502964380,CHIN 10BN,A02,736064,Xu; Li,11,0,13,2
1731502964380,CHIN 10BN,B01,736084,Xu; Li,10,0,13,3
1731502964380,CHIN 10BN,B02,736097,Xu; Li,12,0,13,1
1731502964380,CHIN 10BN,C01,736345,Xu; Li,9,0,13,4
1731502964380,CHIN 10BN,C02,736346,Xu; Li,0,0,0,0
1731502965407,CHIN 20BD,A01,795569,Liu; Mingming,14,0,14,0
1731502965407,CHIN 20BD,A02,795570,Liu; Mingming,14,0,14,0
1731502966441,CHIN 20BM,A01,736414,Wang; Xiao,15,0,16,1
1731502966441,CHIN 20BM,A02,736421,Wang; Xiao,16,0,16,0
1731502967477,CHIN 20BN,A01,736427,Anderson; Qin-Hong,13,0,14,1
1731502967477,CHIN 20BN,A02,736430,Anderson; Qin-Hong,13,0,14,1
1731502967477,CHIN 20BN,B01,736434,Anderson; Qin-Hong,0,0,0,0
1731502967477,CHIN 20BN,B02,736440,Anderson; Qin-Hong,0,0,0,0
1731502968508,CHIN 100BM,A00,736443,Wang; Xiao,20,0,20,0
1731502969539,CHIN 100BN,A00,736444,Chen; Pei-Chia,20,0,21,1
1731502970577,CHIN 169A,A00,736447,Wang; Xiao,20,0,20,0
1731502971608,CHIN 182A,A00,736468,Liu; Mingming,19,0,20,1
1731502972640,CLAS 87,A00,736801,Herbst; Matthew,20,0,20,0
1731502973667,CLIN 227A,A01,799589,Gold; Jeffrey Joseph,20,0,20,0
1731502974696,CLIN 227B,A00,799590,Gold; Jeffrey Joseph,20,0,20,0
1731502975722,CLIN 228,A01,799594,Gold; Jeffrey Joseph,20,0,20,0
1731502976754,CLIN 294B,A00,799595,Thomas; Kelsey Rae,10,0,10,0
1731502977784,CLIN 296,001,799596,Brookman; Lauren Irene,100,0,100,0
1731502977784,CLIN 296,002,799597,Brookman; Lauren Irene,10,0,10,0
1731502978809,CLRE 236R,A00,736762,Mehta; Ravindra L.,9994,0,9999,5
1731502979841,CLRE 237,A00,736763,Morris; Sheldon,9994,0,9999,5
1731502980869,CLRE 250R,A01,736787,Graves; Jennifer Sharon Ol,9999,0,9999,0
1731502981897,CLRE 251R,A00,795042,Mehta; Ravindra L.,9999,0,9999,0
1731502982923,CLRE 253,A00,736792,Vaida; Florin,9998,0,9999,1
1731502983955,CLRE 259,A00,736793,Patel; Hemal,9996,0,9999,3
1731502984981,CLRE 260,A00,736795,Cuomo; Raphael Eduardo,9996,0,9999,3
1731502984981,CLRE 260,B00,800937,Cuomo; Raphael Eduardo,9999,0,9999,0
1731502986008,CLRE 267,A00,795044,Vaida; Florin,9995,0,9999,4
1731502987033,CLRE 295B,A00,736798,Cuomo; Raphael Eduardo,9999,0,9999,0
1731502988062,CLRE 297,001,736799,Cuomo; Raphael Eduardo,9999,0,9999,0
1731502989099,CMM 246,A00,796595,Gordts; Philip & Lewis; Amanda Lark & Godula; Kamil & Gagneux; Pascal & Esko; Jeffrey D. & Bode; Lars,10,0,10,0
1731502990132,COGR 200B,A00,738801,Cordoba Azcarate; Matilde,5,0,5,0
1731502991159,COGR 200C,A00,738803,Geiger; Richard Stuart,5,0,5,0
1731502992186,COGR 201J,A00,738804,Hallin; Daniel C,8,0,10,2
1731502993212,COGR 225C,A00,738805,McKenzie; Kerry V.,4,0,5,1
1731502994238,COGR 225D,A00,738806,Lampland; Martha,5,0,5,0
1731502995265,COGR 237,A00,738807,Anderson; Patrick W.,3,0,10,7
1731502996292,COGR 275,A00,738808,Dominguez Rubio; Fernando,10,0,10,0
1731502997326,COGS 1,A01,737008,Kiyonaga; Anastasia,55,0,62,7
1731502997326,COGS 1,A02,737010,Kiyonaga; Anastasia,62,0,65,3
1731502997326,COGS 1,A03,737011,Kiyonaga; Anastasia,65,0,66,1
1731502997326,COGS 1,A04,737014,Kiyonaga; Anastasia,56,0,56,0
1731502997326,COGS 1,A05,737015,Kiyonaga; Anastasia,56,0,56,0
1731502997326,COGS 1,A06,737016,Kiyonaga; Anastasia,50,0,56,6
1731502997326,COGS 1,A07,737018,Kiyonaga; Anastasia,55,0,56,1
1731502998351,COGS 9,A01,737025,Staff,55,0,56,1
1731502998351,COGS 9,A02,737028,Staff,54,0,56,2
1731502998351,COGS 9,A03,737029,Staff,55,0,56,1
1731502998351,COGS 9,A04,737030,Staff,53,0,56,3
1731502998351,COGS 9,A05,737031,Staff,54,0,56,2
1731502998351,COGS 9,A06,737033,Staff,45,0,48,3
1731502999380,COGS 10,A01,737044,Morgan; Eric,48,0,56,8
1731502999380,COGS 10,A02,737045,Morgan; Eric,51,0,58,7
1731502999380,COGS 10,A03,737047,Morgan; Eric,52,0,56,4
1731502999380,COGS 10,A04,737049,Morgan; Eric,53,0,56,3
1731502999380,COGS 10,A05,737050,Morgan; Eric,51,0,52,1
1731502999380,COGS 10,A06,737051,Morgan; Eric,48,0,50,2
1731503000407,COGS 11,A01,737077,Boyle; Mary E. T.,46,0,50,4
1731503000407,COGS 11,A02,737078,Boyle; Mary E. T.,50,0,50,0
1731503000407,COGS 11,A03,737135,Boyle; Mary E. T.,44,0,47,3
1731503001439,COGS 13,A01,737138,Staff,63,0,65,2
1731503001439,COGS 13,A02,737139,Staff,53,0,56,3
1731503001439,COGS 13,A03,737142,Staff,54,0,56,2
1731503001439,COGS 13,A04,737144,Staff,56,0,56,0
1731503001439,COGS 13,A05,737145,Staff,53,0,56,3
1731503001439,COGS 13,A06,737148,Staff,56,0,56,0
1731503001439,COGS 13,A07,737149,Staff,65,0,65,0
1731503002470,COGS 14A,A01,737151,Barrera; Steven James,57,0,60,3
1731503002470,COGS 14A,A02,737152,Barrera; Steven James,55,0,60,5
1731503002470,COGS 14A,A03,737153,Barrera; Steven James,59,0,60,1
1731503002470,COGS 14A,A04,737154,Barrera; Steven James,58,0,60,2
1731503002470,COGS 14A,A05,737155,Barrera; Steven James,59,0,60,1
1731503003500,COGS 14B,A01,737157,Hoffman; Drew Ellen,46,0,50,4
1731503003500,COGS 14B,A02,737158,Hoffman; Drew Ellen,48,0,50,2
1731503003500,COGS 14B,A03,737159,Hoffman; Drew Ellen,48,0,50,2
1731503003500,COGS 14B,A04,737160,Hoffman; Drew Ellen,49,0,50,1
1731503003500,COGS 14B,A05,737189,Hoffman; Drew Ellen,50,0,50,0
1731503004526,COGS 17,A01,737193,Johnson; Christine M.,56,0,60,4
1731503004526,COGS 17,A02,737200,Johnson; Christine M.,57,0,60,3
1731503004526,COGS 17,A03,737210,Johnson; Christine M.,57,0,60,3
1731503004526,COGS 17,A04,737211,Johnson; Christine M.,59,0,60,1
1731503004526,COGS 17,A05,737234,Johnson; Christine M.,57,0,60,3
1731503004526,COGS 17,A06,737237,Johnson; Christine M.,58,0,60,2
1731503005557,COGS 18,A01,737254,Morgan; Eric,32,0,35,3
1731503005557,COGS 18,A02,737255,Morgan; Eric,33,0,35,2
1731503005557,COGS 18,A03,737256,Morgan; Eric,31,0,35,4
1731503005557,COGS 18,A04,737257,Morgan; Eric,31,0,35,4
1731503005557,COGS 18,A05,737264,Morgan; Eric,28,0,35,7
1731503005557,COGS 18,A06,737265,Morgan; Eric,32,0,35,3
1731503005557,COGS 18,A07,737288,Morgan; Eric,32,0,35,3
1731503005557,COGS 18,A08,737333,Morgan; Eric,35,0,35,0
1731503005557,COGS 18,A09,737334,Morgan; Eric,33,0,35,2
1731503006583,COGS 87,A00,737335,Deak; Gedeon O.,19,0,20,1
1731503007616,COGS 100,A01,737386,Allen; Michael Gordon,49,0,56,7
1731503007616,COGS 100,A02,737387,Allen; Michael Gordon,56,0,56,0
1731503007616,COGS 100,A03,737390,Allen; Michael Gordon,55,0,56,1
1731503007616,COGS 100,A04,737392,Allen; Michael Gordon,55,0,56,1
1731503007616,COGS 100,A05,737393,Allen; Michael Gordon,58,0,61,3
1731503007616,COGS 100,A06,737394,Allen; Michael Gordon,65,0,65,0
1731503008651,COGS 101A,A01,737396,Barrera; Steven James,57,0,61,4
1731503008651,COGS 101A,A02,737399,Barrera; Steven James,61,0,65,4
1731503008651,COGS 101A,A03,737400,Barrera; Steven James,53,0,56,3
1731503008651,COGS 101A,A04,737401,Barrera; Steven James,53,0,56,3
1731503008651,COGS 101A,A05,737404,Barrera; Steven James,54,0,56,2
1731503008651,COGS 101A,A06,737405,Barrera; Steven James,56,0,56,0
1731503009678,COGS 101B,A01,737408,Allen; Michael Gordon,46,0,50,4
1731503009678,COGS 101B,A02,737412,Allen; Michael Gordon,49,0,50,1
1731503009678,COGS 101B,A03,737413,Allen; Michael Gordon,49,0,50,1
1731503009678,COGS 101B,A04,737414,Allen; Michael Gordon,50,0,50,0
1731503009678,COGS 101B,A05,737415,Allen; Michael Gordon,49,0,50,1
1731503009678,COGS 101B,A06,737417,Allen; Michael Gordon,50,0,50,0
1731503010709,COGS 107A,A01,737419,Boyle; Mary E. T.,51,0,56,5
1731503010709,COGS 107A,A02,737421,Boyle; Mary E. T.,44,0,56,12
1731503010709,COGS 107A,A03,737423,Boyle; Mary E. T.,43,0,56,13
1731503010709,COGS 107A,A04,737424,Boyle; Mary E. T.,49,0,56,7
1731503010709,COGS 107A,A05,737425,Boyle; Mary E. T.,50,0,56,6
1731503010709,COGS 107A,A06,737426,Boyle; Mary E. T.,56,0,65,9
1731503010709,COGS 107A,A07,737429,Boyle; Mary E. T.,51,0,65,14
1731503011735,COGS 107B,A01,737431,Mooshagian; Eric Frederick,49,0,50,1
1731503011735,COGS 107B,A02,737435,Mooshagian; Eric Frederick,49,0,50,1
1731503011735,COGS 107B,A03,737436,Mooshagian; Eric Frederick,55,0,65,10
1731503011735,COGS 107B,A04,737438,Mooshagian; Eric Frederick,61,0,63,2
1731503011735,COGS 107B,A05,737439,Mooshagian; Eric Frederick,47,0,50,3
1731503011735,COGS 107B,A06,737440,Mooshagian; Eric Frederick,50,0,50,0
1731503012766,COGS 108,A01,737442,Ellis; Shannon Elizabeth,46,0,56,10
1731503012766,COGS 108,A02,737447,Ellis; Shannon Elizabeth,52,0,56,4
1731503012766,COGS 108,A03,737450,Ellis; Shannon Elizabeth,54,0,56,2
1731503012766,COGS 108,A04,737451,Ellis; Shannon Elizabeth,52,0,56,4
1731503012766,COGS 108,A05,737452,Ellis; Shannon Elizabeth,52,0,56,4
1731503012766,COGS 108,A06,737454,Ellis; Shannon Elizabeth,59,0,65,6
1731503012766,COGS 108,A07,737455,Ellis; Shannon Elizabeth,61,0,65,4
1731503012766,COGS 108,B01,737457,Ellis; Shannon Elizabeth,47,0,56,9
1731503012766,COGS 108,B02,737459,Ellis; Shannon Elizabeth,48,0,56,8
1731503012766,COGS 108,B03,737460,Ellis; Shannon Elizabeth,47,0,56,9
1731503012766,COGS 108,B04,737461,Ellis; Shannon Elizabeth,41,0,56,15
1731503012766,COGS 108,B05,737462,Ellis; Shannon Elizabeth,35,0,56,21
1731503012766,COGS 108,B06,737471,Ellis; Shannon Elizabeth,62,0,65,3
1731503012766,COGS 108,B07,737472,Ellis; Shannon Elizabeth,64,0,65,1
1731503013792,COGS 109,A01,737475,Staff,34,0,35,1
1731503013792,COGS 109,A02,737476,Staff,33,0,35,2
1731503013792,COGS 109,A03,737477,Staff,35,0,35,0
1731503013792,COGS 109,A04,737478,Staff,31,0,35,4
1731503014823,COGS 111,A01,737480,Hoffman; Drew Ellen,49,0,50,1
1731503014823,COGS 111,A02,737482,Hoffman; Drew Ellen,49,0,50,1
1731503014823,COGS 111,A03,737483,Hoffman; Drew Ellen,49,0,50,1
1731503014823,COGS 111,A04,737485,Hoffman; Drew Ellen,45,0,50,5
1731503015856,COGS 115,A01,737487,Deak; Gedeon O.,52,0,60,8
1731503016882,COGS 116,A01,737490,Greene; Deanna Jacquelyn,42,0,49,7
1731503016882,COGS 116,A02,737491,Greene; Deanna Jacquelyn,45,0,49,4
1731503017909,COGS 118C,A01,737493,Mukamel; Eran A,47,0,75,28
1731503018937,COGS 120,A01,737503,Xia; Haijun,44,0,50,6
1731503018937,COGS 120,A02,737763,Xia; Haijun,40,0,50,10
1731503018937,COGS 120,A03,737765,Xia; Haijun,50,0,50,0
1731503018937,COGS 120,A04,737766,Xia; Haijun,44,0,50,6
1731503018937,COGS 120,A05,737775,Xia; Haijun,50,0,50,0
1731503018937,COGS 120,A06,737781,Xia; Haijun,37,0,50,13
1731503019969,COGS 122,A01,737787,Dow; Steven P,0,0,0,5
1731503020995,COGS 126,A01,737795,Hollan; James D.,47,0,50,3
1731503022022,COGS 127,A01,737801,Guo; Philip J,46,0,50,4
1731503022022,COGS 127,A02,737805,Guo; Philip J,41,0,50,9
1731503022022,COGS 127,A03,737806,Guo; Philip J,44,0,50,6
1731503022022,COGS 127,A04,737811,Guo; Philip J,40,0,50,10
1731503022022,COGS 127,A05,737818,Guo; Philip J,3,0,50,47
1731503023050,COGS 144,A01,737824,Rossano; Federico,48,0,50,2
1731503024075,COGS 153,A00,737829,Staff,139,0,149,10
1731503025102,COGS 155,A01,737836,Cooperrider; Kensy A,48,0,50,2
1731503026128,COGS 156,A01,737841,Creel; Sarah,69,0,75,6
1731503027156,COGS 160,A00,737849,Kirsh; David Joel,25,0,25,0
1731503027156,COGS 160,B00,796034,Beatty-Martinez; Anne,74,0,75,1
1731503027156,COGS 160,C00,796035,Staff,149,0,149,0
1731503028181,COGS 164,A01,737961,Chiba; Andrea,40,0,45,5
1731503028181,COGS 164,A02,796040,Chiba; Andrea,28,0,45,17
1731503029208,COGS 177,A00,737964,Staff,110,0,120,10
1731503030235,COGS 181,A01,796038,Tu; Zhuowen,37,0,50,13
1731503030235,COGS 181,A02,796039,Tu; Zhuowen,31,0,50,19
1731503031260,COGS 187B,A01,737972,Kirsh; David Joel,47,0,50,3
1731503031260,COGS 187B,A02,738380,Kirsh; David Joel,17,0,50,33
1731503032289,COGS 188,A01,738029,Fleischer; Jason G,39,0,60,21
1731503032289,COGS 188,A02,738030,Fleischer; Jason G,56,0,60,4
1731503033318,COGS 189,A00,738031,De Sa; Virginia,165,0,200,35
1731503034350,COGS 190B,:00,796056,Staff,20,0,20,0
1731503034350,COGS 190B,A00,738176,Chiba; Andrea,9999,0,9999,0
1731503034350,COGS 190B,B00,738177,Fleischer; Jason G,20,0,20,0
1731503034350,COGS 190B,C00,738258,Hoffman; Drew Ellen,20,0,20,0
1731503034350,COGS 190B,D00,738259,Voytek; Bradley Thomas,20,0,20,0
1731503034350,COGS 190B,E00,738272,Kirsh; David Joel,20,0,20,0
1731503034350,COGS 190B,F00,738287,Kiyonaga; Anastasia,20,0,20,0
1731503034350,COGS 190B,G00,796051,Beatty-Martinez; Anne,20,0,20,0
1731503034350,COGS 190B,H00,796052,Nitz; Douglas A.,20,0,20,0
1731503034350,COGS 190B,I00,796053,De Sa; Virginia,20,0,20,0
1731503034350,COGS 190B,J00,796054,Rangel; Lara M,20,0,20,0
1731503034350,COGS 190B,K00,796055,Boyle; Mary E. T.,20,0,20,0
1731503034350,COGS 190B,L00,796058,Jernigan; Terry Lynne,20,0,20,0
1731503034350,COGS 190B,M00,796059,Deak; Gedeon O.,20,0,20,0
1731503034350,COGS 190B,N00,796060,Tu; Zhuowen,20,0,20,0
1731503034350,COGS 190B,O00,796061,Creel; Sarah,20,0,20,0
1731503035380,COGS 194,A00,738288,Hill; Seth J,9999,0,9999,0
1731503036408,COGS 198,001,738361,Voytek; Bradley Thomas,20,0,20,0
1731503037433,COGS 205,A00,738365,Chiba; Andrea,17,0,20,3
1731503038465,COGS 210B,001,736818,Nitz; Douglas A.,9998,0,9999,1
1731503038465,COGS 210B,002,736819,Xia; Haijun,9999,0,9999,0
1731503038465,COGS 210B,003,736820,Bergen; Benjamin,9998,0,9999,1
1731503038465,COGS 210B,004,736822,Kirsh; David Joel,9999,0,9999,0
1731503038465,COGS 210B,005,736824,Rangel; Lara M,9998,0,9999,1
1731503038465,COGS 210B,006,736825,Rossano; Federico,9999,0,9999,0
1731503038465,COGS 210B,007,736826,Guo; Philip J,9999,0,9999,0
1731503038465,COGS 210B,008,736829,De Sa; Virginia,9999,0,9999,0
1731503038465,COGS 210B,009,796069,Greene; Deanna Jacquelyn,9999,0,9999,0
1731503038465,COGS 210B,010,796070,Hollan; James D.,9999,0,9999,0
1731503038465,COGS 210B,011,796071,Kiyonaga; Anastasia,9999,0,9999,0
1731503038465,COGS 210B,012,796073,Coulson; Seana M,9999,0,9999,0
1731503038465,COGS 210B,013,796074,Dow; Steven P,9999,0,9999,0
1731503039492,COGS 211B,A00,736830,Coulson; Seana M,17,0,20,3
1731503040525,COGS 219,A01,736835,Zettersten; Martin,0,0,0,17
1731503041551,COGS 223,A00,736836,Dow; Steven P,18,0,25,7
1731503042580,COGS 229,A00,736842,Vaccaro; Kristen Marie,9,0,10,1
1731503043606,COGS 260,A00,736843,Kiyonaga; Anastasia,16,0,25,9
1731503044660,COMM 10,A01,738505,Armenta; John E,21,0,25,4
1731503044660,COMM 10,A02,738683,Armenta; John E,21,0,25,4
1731503044660,COMM 10,A03,738685,Armenta; John E,18,0,25,7
1731503044660,COMM 10,A04,738686,Armenta; John E,23,0,25,2
1731503044660,COMM 10,A05,738687,Armenta; John E,23,0,25,2
1731503044660,COMM 10,A06,738688,Armenta; John E,23,0,25,2
1731503044660,COMM 10,A07,738689,Armenta; John E,25,0,25,0
1731503044660,COMM 10,A08,738690,Armenta; John E,25,0,25,0
1731503044660,COMM 10,A09,738691,Armenta; John E,25,0,25,0
1731503044660,COMM 10,A10,738693,Armenta; John E,25,0,25,0
1731503044660,COMM 10,A11,738694,Armenta; John E,25,0,25,0
1731503044660,COMM 10,A12,738695,Armenta; John E,24,0,25,1
1731503045687,COMM 20,A01,738704,McKenna; Denise,73,0,75,2
1731503046713,COMM 30,A00,738705,Schmidt; Thomas Rainer,72,0,75,3
1731503047741,COMM 50,A00,738706,Armenta; John E,24,0,25,1
1731503048767,COMM 80,A01,738710,Campbell; Robert Harold,79,0,80,1
1731503049794,COMM 87,A00,795241,Serlin; David,20,0,20,0
1731503050821,COMM 100C,A01,738712,Dewaard; Andrew Michael,22,0,25,3
1731503050821,COMM 100C,A02,738713,Dewaard; Andrew Michael,25,0,25,0
1731503050821,COMM 100C,A03,738714,Dewaard; Andrew Michael,22,0,25,3
1731503050821,COMM 100C,A04,738715,Dewaard; Andrew Michael,21,0,25,4
1731503050821,COMM 100C,A05,738716,Dewaard; Andrew Michael,24,0,25,1
1731503050821,COMM 100C,A06,738718,Dewaard; Andrew Michael,23,0,25,2
1731503050821,COMM 100C,A07,738720,Dewaard; Andrew Michael,24,0,25,1
1731503050821,COMM 100C,A09,738724,Dewaard; Andrew Michael,24,0,25,1
1731503050821,COMM 100C,A11,738726,Dewaard; Andrew Michael,24,0,25,1
1731503050821,COMM 100C,A12,738727,Dewaard; Andrew Michael,24,0,25,1
1731503051846,COMM 101,A01,738730,Ahn; Patricia Jeehyun,14,0,15,1
1731503051846,COMM 101,A02,738731,Ahn; Patricia Jeehyun,15,0,15,0
1731503051846,COMM 101,A03,738732,Ahn; Patricia Jeehyun,12,0,15,3
1731503051846,COMM 101,A04,738733,Ahn; Patricia Jeehyun,13,0,15,2
1731503052875,COMM 101D,A00,738737,Martinico; Daniel J,16,0,16,0
1731503053974,COMM 101K,A00,738743,Ahn; Patricia Jeehyun,13,0,16,3
1731503055003,COMM 101N,A00,738746,Martinico; Daniel J,16,0,16,0
1731503056032,COMM 101T,A00,738749,Halm; Gavin Patrick,14,0,18,4
1731503056032,COMM 101T,B00,738752,Halm; Gavin Patrick,18,0,18,0
1731503056032,COMM 101T,C00,795163,Dewey; Matthew D,10,0,10,0
1731503057064,COMM 102B,A01,738754,Peacher; Amanda M,8,0,9,1
1731503057064,COMM 102B,A02,738755,Peacher; Amanda M,9,0,9,0
1731503058089,COMM 102C,A01,738757,Campion; Camille E,3,0,6,3
1731503058089,COMM 102C,A02,738758,Campion; Camille E,6,0,6,0
1731503058089,COMM 102C,A03,738759,Campion; Camille E,6,0,6,0
1731503059121,COMM 103D,A00,799575,Davis; Zeinabu I.,30,0,30,0
1731503060147,COMM 103E,A00,738763,Dewey; Matthew D,29,0,30,1
1731503061172,COMM 106,A00,738764,Kidman; Shawna F,138,0,140,2
1731503062201,COMM 106M,A00,738765,Whitworth-Smith; Andrew C,67,0,75,8
1731503063229,COMM 106N,A00,738766,Schmidt; Thomas Rainer,21,0,30,9
1731503064254,COMM 107,A00,738767,Serlin; David,30,0,30,0
1731503065279,COMM 111A,A00,738769,Pavon Aramburu; Maria Laur,29,0,30,1
1731503066304,COMM 111B,A00,738770,Zilberg; Elana,38,0,40,2
1731503067339,COMM 111P,A00,738771,Ruskiewicz; Eva Marie,29,0,30,1
1731503068371,COMM 113T,A00,738774,Abuelhiga; Soraya Jill,28,0,30,2
1731503068371,COMM 113T,B00,738775,Fields; Gary,30,0,30,0
1731503068371,COMM 113T,C00,738776,McKenna; Denise,29,0,30,1
1731503069401,COMM 114I,A00,738780,Leuning; Grant Maurstad,30,0,30,0
1731503070430,COMM 114T,A00,738781,Walkover; Lillian B,29,0,30,1
1731503071457,COMM 120M,A00,738783,Lazitski Torres; Olga,30,0,30,0
1731503072484,COMM 124A,A00,738784,Irani; Lilly C,73,0,75,2
1731503073511,COMM 134,A00,738785,Kidman; Shawna F,29,0,30,1
1731503075560,COMM 138,A00,738786,Boateng; Boatema,30,0,30,0
1731503076587,COMM 145,A00,738788,Rojo Solis; Juan Jose,29,0,30,1
1731503077613,COMM 146,A00,738789,Ybarra; Megan,28,0,30,2
1731503078638,COMM 156,A00,738791,Staff,30,0,30,0
1731503079664,COMM 159,A00,738792,Cordoba Azcarate; Matilde,23,0,30,7
1731503080691,COMM 164,A00,738793,Dominguez Rubio; Fernando,25,0,25,0
1731503081721,COMM 177,A00,795164,Rojo Solis; Juan Jose,25,0,25,0
1731503082747,COMM 190,A00,738795,Boateng; Boatema,23,0,23,0
1731503082747,COMM 190,B00,738797,Staff,19,0,23,4
1731503082747,COMM 190,C00,738798,Wiering; Liesbeth,21,0,23,2
1731503083773,COMM 194,A00,770727,Hill; Seth J,9999,0,9999,0
1731503084801,COMM 196B,A00,738800,Dewaard; Andrew Michael,10,0,10,0
1731503085833,CSE 8A,A50,738815,Alvarado; Christine J.,39,0,40,1
1731503085833,CSE 8A,A51,738819,Alvarado; Christine J.,40,0,40,0
1731503085833,CSE 8A,A52,738823,Alvarado; Christine J.,40,0,40,0
1731503085833,CSE 8A,A53,738825,Alvarado; Christine J.,35,0,40,5
1731503085833,CSE 8A,A54,738826,Alvarado; Christine J.,37,0,40,3
1731503085833,CSE 8A,A55,799488,Alvarado; Christine J.,0,0,0,0
1731503086859,CSE 8B,A01,788635,Ochoa; Benjamin Lawrence,59,0,70,11
1731503087888,CSE 11,A01,788660,Cao; Yingjun,161,0,175,14
1731503088914,CSE 12,A01,788668,Cao; Yingjun,25,0,50,25
1731503089941,CSE 20,A01,786527,Jones; Miles E,18,0,25,7
1731503089941,CSE 20,A02,786528,Jones; Miles E,19,0,25,6
1731503090972,CSE 21,A01,786539,Jones; Miles E,46,0,50,4
1731503090972,CSE 21,A02,786540,Jones; Miles E,49,0,50,1
1731503092001,CSE 29,A50,738835,Soosai Raj; Adalbert Geral,0,0,5,5
1731503092001,CSE 29,A51,738840,Soosai Raj; Adalbert Geral,4,0,5,1
1731503092001,CSE 29,A52,738842,Soosai Raj; Adalbert Geral,3,0,5,2
1731503092001,CSE 29,A53,738844,Soosai Raj; Adalbert Geral,4,0,4,0
1731503092001,CSE 29,B50,738846,Soosai Raj; Adalbert Geral,0,0,5,5
1731503092001,CSE 29,B51,738847,Soosai Raj; Adalbert Geral,0,0,5,5
1731503092001,CSE 29,B52,738848,Soosai Raj; Adalbert Geral,1,0,5,4
1731503092001,CSE 29,B53,738849,Soosai Raj; Adalbert Geral,3,0,4,1
1731503093027,CSE 30,A01,788669,Chin; Bryan W.,42,0,50,8
1731503094055,CSE 87,A00,738901,Moshiri; Niema,19,0,20,1
1731503094055,CSE 87,B00,739036,Cottrell; Garrison W,20,0,20,0
1731503095082,CSE 95,A00,739094,Minnes Kemp; Mor Mia,100,0,100,0
1731503096113,CSE 100,A01,788682,Moshiri; Niema,21,0,50,29
1731503097140,CSE 100R,A01,739414,Moshiri; Niema,25,0,50,25
1731503098167,CSE 101,A01,788685,Saha; Barna,0,0,20,20
1731503098167,CSE 101,B01,788713,Saha; Barna,0,0,20,20
1731503099191,CSE 105,A01,786574,Minnes Kemp; Mor Mia,113,0,150,37
1731503100217,CSE 107,A01,786529,Heninger; Nadia A,136,0,146,10
1731503101244,CSE 110,A50,739705,Griswold; William G.,58,0,75,17
1731503101244,CSE 110,A51,739706,Griswold; William G.,74,0,75,1
1731503101244,CSE 110,A52,739707,Griswold; William G.,70,0,75,5
1731503102271,CSE 120,A01,786531,Pasquale; Joseph,89,0,146,57
1731503103301,CSE 122,A01,739739,Pannuto; Patrick William,0,0,25,25
1731503104329,CSE 127,A01,788718,Munyaka; Imani N. S.,174,0,192,18
1731503105355,CSE 130,A01,788720,Jhala; Ranjit,172,0,192,20
1731503106383,CSE 132A,A01,788721,Vianu; Victor Dan,163,0,196,33
1731503107408,CSE 134B,A01,788723,Powell; Thomas Allan,172,0,192,20
1731503108438,CSE 140,A01,786577,Rosing; Tajana Simunic,274,0,300,26
1731503109467,CSE 140L,A01,739761,Eldon; John,148,0,196,48
1731503110496,CSE 142,A01,788724,Swanson; Steven James,179,0,196,17
1731503111525,CSE 147,A00,739766,Rosing; Tajana Simunic,0,0,60,60
1731503112551,CSE 148,A01,785688,Tullsen; Dean Michael,13,0,20,7
1731503113578,CSE 150A,A01,788727,Solares; Edwin A,182,0,196,14
1731503114606,CSE 151A,A01,788728,Shang; Jingbo,171,0,250,79
1731503115638,CSE 151B,A01,787804,Cottrell; Garrison W,163,0,192,29
1731503116669,CSE 152A,A01,788729,Chandraker; Manmohan Krishna,163,0,192,29
1731503117697,CSE 156,A01,786532,Qin; Lianhui,133,0,146,13
1731503118724,CSE 160,A01,788730,Kastner; Ryan Charles,195,0,250,55
1731503119751,CSE 167,A01,788731,Chern; Albert Ren-Haur,176,0,192,16
1731503120779,CSE 169,A01,785224,Rotenberg; Steven Paul,0,0,0,0
1731503121807,CSE 181,A01,770733,Pevzner; Pavel Arkadjevich,31,0,35,4
1731503122832,CSE 190,A00,739790,Bandeira; Nuno Filipe Cabrita,45,0,50,5
1731503122832,CSE 190,B00,739791,Shalev; Aaron D,43,0,50,7
1731503122832,CSE 190,C00,739821,Ousterhout; Amy,36,0,50,14
1731503122832,CSE 190,D00,739834,McAuley; Julian John,189,0,196,7
1731503123857,CSE 191,A00,739839,Minnes Kemp; Mor Mia,9999,0,9999,0
1731503124882,CSE 197,001,799832,Minnes Kemp; Mor Mia,9999,0,9999,0
1731503125907,CSE 202,A00,739848,Impagliazzo; Russell,0,0,0,0
1731503126934,CSE 203B,A01,788732,Cheng; Chung Kuan,0,0,0,0
1731503127960,CSE 207A,A00,739858,Bellare; Mihir,0,0,0,0
1731503128992,CSE 209A,A00,739859,Grier; Daniel T,0,0,0,0
1731503130017,CSE 210,A00,739873,Coblenz; Michael J,0,0,0,0
1731503131043,CSE 219,A00,739901,Vaccaro; Kristen Marie,0,0,0,0
1731503132071,CSE 220,A01,796042,Staff,0,0,0,0
1731503133096,CSE 222C,A01,739906,Pannuto; Patrick William,0,0,0,0
1731503134127,CSE 227,A00,739923,Kumar; Deepak,0,0,0,0
1731503135156,CSE 229A,A00,739925,Zhang; Yiying,0,0,0,0
1731503136182,CSE 230,A00,740210,Jhala; Ranjit,0,0,0,0
1731503137211,CSE 232B,A00,740214,Deutsch; Alin Bernard,0,0,0,0
1731503138239,CSE 234,A01,788733,Zhang; Hao,0,0,0,0
1731503139268,CSE 237A,A00,740218,Rosing; Tajana Simunic,0,0,0,0
1731503140295,CSE 239A,A00,740222,Deutsch; Alin Bernard,0,0,0,0
1731503141325,CSE 240A,A00,740228,Tullsen; Dean Michael,0,0,0,0
1731503142356,CSE 240B,A00,740234,Zhao; Jishen,0,0,0,0
1731503143387,CSE 244A,A00,740240,Orailoglu; Alex,0,0,0,0
1731503144415,CSE 251A,A01,788735,Berg-Kirkpatrick; Taylor D,0,0,0,0
1731503145449,CSE 251B,A01,787805,Cottrell; Garrison W,0,0,0,0
1731503146476,CSE 251C,A01,785687,Dasgupta; Sanjoy,0,0,0,0
1731503147502,CSE 252A,A00,740250,Ochoa; Benjamin Lawrence,0,0,0,0
1731503148532,CSE 257,A01,788739,Gao; Sicun,0,0,0,0
1731503149567,CSE 272,A00,740254,Li; Tzumao,0,0,0,0
1731503150593,CSE 280A,A00,740297,Bafna; Vineet,0,0,0,0
1731503151624,CSE 282,A00,740308,Pevzner; Pavel Arkadjevich,0,0,0,0
1731503152654,CSE 290,A00,740312,Chandraker; Manmohan Krishna,0,0,0,0
1731503152654,CSE 290,C00,740327,Christensen; Henrik I,0,0,0,0
1731503152654,CSE 290,D00,740402,Pevzner; Pavel Arkadjevich,0,0,0,0
1731503152654,CSE 290,E00,740403,Munyaka; Imani N. S.,0,0,0,0
1731503152654,CSE 290,G00,740411,Qin; Lianhui,0,0,0,0
1731503152654,CSE 290,H00,740413,Shalev; Aaron D,0,0,0,0
1731503152654,CSE 290,I00,796145,Lovett; Shachar,0,0,0,0
1731503152654,CSE 290,J00,796174,Yu; Qi,0,0,0,0
1731503152654,CSE 290,B00,740325,Orailoglu; Alex,0,0,0,0
1731503153686,CSE 291,A00,740416,Liu; Qipeng,0,0,0,0
1731503153686,CSE 291,B00,740420,Pasquale; Joseph,0,0,0,0
1731503153686,CSE 291,C00,740421,Savage; Stefan & Voelker; Geoffrey M.,0,0,0,0
1731503153686,CSE 291,D00,740441,Ding; Yufei,0,0,0,0
1731503153686,CSE 291,E00,740442,Vaccaro; Kristen Marie,0,0,0,0
1731503153686,CSE 291,F00,740443,Fernandes; Earlence T,0,0,0,0
1731503153686,CSE 291,G00,740447,Paturi; Ramamohan,0,0,0,0
1731503153686,CSE 291,H00,740448,Prithviraj; Ammanabrolu,0,0,0,0
1731503153686,CSE 291,I00,740468,Zhang; Yiying,0,0,0,0
1731503153686,CSE 291,J00,740469,McAuley; Julian John,0,0,0,0
1731503154723,CSE 293,001,796628,Bafna; Vineet,9999,0,9999,0
1731503154723,CSE 293,002,796638,Bellare; Mihir,9999,0,9999,0
1731503154723,CSE 293,003,796645,Berg-Kirkpatrick; Taylor D,9999,0,9999,0
1731503154723,CSE 293,004,796646,Chandraker; Manmohan Krishna,9999,0,9999,0
1731503154723,CSE 293,005,796647,Cheng; Chung Kuan,9999,0,9999,0
1731503154723,CSE 293,006,796648,Christensen; Henrik I,9998,0,9999,1
1731503154723,CSE 293,007,796649,Coblenz; Michael J,9999,0,9999,0
1731503154723,CSE 293,008,796650,Cottrell; Garrison W,9999,0,9999,0
1731503154723,CSE 293,009,796651,Deutsch; Alin Bernard,9999,0,9999,0
1731503154723,CSE 293,010,796652,Esmaeilzadeh; Hadi,9999,0,9999,0
1731503154723,CSE 293,011,796653,Freund; Yoav,9999,0,9999,0
1731503154723,CSE 293,012,796654,Griswold; William G.,9999,0,9999,0
1731503154723,CSE 293,013,796655,Gymrek; Melissa Ann,9999,0,9999,0
1731503154723,CSE 293,014,796656,Heninger; Nadia A,9999,0,9999,0
1731503154723,CSE 293,015,796657,Impagliazzo; Russell,9999,0,9999,0
1731503154723,CSE 293,016,796658,Jhala; Ranjit,9999,0,9999,0
1731503154723,CSE 293,017,796659,Kahng; Andrew Byun,9999,0,9999,0
1731503154723,CSE 293,018,796660,Kane; Daniel Mertz,9999,0,9999,0
1731503154723,CSE 293,019,796661,Kriegman; David J,9999,0,9999,0
1731503154723,CSE 293,020,796662,Kumar; Arun Kumar,9999,0,9999,0
1731503154723,CSE 293,021,796663,Lerner; Sorin,9999,0,9999,0
1731503154723,CSE 293,022,796664,Lovett; Shachar,9999,0,9999,0
1731503154723,CSE 293,023,796665,McAuley; Julian John,9998,0,9999,1
1731503154723,CSE 293,024,796666,Micciancio; Daniele,9999,0,9999,0
1731503154723,CSE 293,025,796667,Orailoglu; Alex,9999,0,9999,0
1731503154723,CSE 293,026,796668,Pannuto; Patrick William,9999,0,9999,0
1731503154723,CSE 293,027,796669,Paturi; Ramamohan,9999,0,9999,0
1731503154723,CSE 293,028,796670,Polikarpova; Nadezhda,9999,0,9999,0
1731503154723,CSE 293,029,796671,Politz; Joseph Gibbs,9999,0,9999,0
1731503154723,CSE 293,030,796672,Porter; George M,9998,0,9999,1
1731503154723,CSE 293,031,796673,Porter; Leonard Emerson,9999,0,9999,0
1731503154723,CSE 293,032,796674,Ramamoorthi; Ravi,9999,0,9999,0
1731503154723,CSE 293,033,796675,Riek; Laurel D,9999,0,9999,0
1731503154723,CSE 293,034,796676,Sahoo; Debashis,9999,0,9999,0
1731503154723,CSE 293,035,796677,Saul; Lawrence,9999,0,9999,0
1731503154723,CSE 293,036,796678,Savage; Stefan,9999,0,9999,0
1731503154723,CSE 293,037,796679,Schulze; Jurgen P.,9999,0,9999,0
1731503154723,CSE 293,038,796680,Snoeren; Alex C.,9999,0,9999,0
1731503154723,CSE 293,039,796681,Shang; Jingbo,9997,0,9999,2
1731503154723,CSE 293,040,796682,Stefan; Deian,9999,0,9999,0
1731503154723,CSE 293,041,796683,Su; Hao,9999,0,9999,0
1731503154723,CSE 293,042,796684,Swanson; Steven James,9999,0,9999,0
1731503154723,CSE 293,043,796685,Tullsen; Dean Michael,9999,0,9999,0
1731503154723,CSE 293,044,796686,Vaccaro; Kristen Marie,9999,0,9999,0
1731503154723,CSE 293,045,796687,Voelker; Geoffrey M.,9999,0,9999,0
1731503154723,CSE 293,046,796688,Zhao; Jishen,9999,0,9999,0
1731503154723,CSE 293,047,796689,Zhou; Yuan-Yuan,9999,0,9999,0
1731503154723,CSE 293,048,796690,Gao; Sicun,9999,0,9999,0
1731503154723,CSE 293,049,796691,Weibel; Nadir,9998,0,9999,1
1731503154723,CSE 293,050,796692,Gupta; Rajesh K.,9999,0,9999,0
1731503154723,CSE 293,051,796693,Soosai Raj; Adalbert Geral,9999,0,9999,0
1731503154723,CSE 293,052,800753,Wang; Xiaolong,9999,0,9999,0
1731503155749,CSE 294,A00,740471,Snoeren; Alex C.,0,0,0,0
1731503156783,CSS 2,A01,785225,Mignozzetti; Umberto,42,0,45,3
1731503156783,CSS 2,A02,785226,Mignozzetti; Umberto,42,0,45,3
1731503157868,CSS 205,A00,738810,Ahlquist; John S.,4,0,24,20
1731503158896,CSS 209,A00,738811,Mignozzetti; Umberto,17,0,40,23
1731503159943,CSS 296,001,796149,Mignozzetti; Umberto,0,0,0,5
1731503159943,CSS 296,002,796150,Mignozzetti; Umberto,0,0,0,2
1731503159943,CSS 296,003,796157,Leas; Eric Craig,0,0,0,0
1731503159943,CSS 296,004,796158,Okonkwo; Holly,0,0,0,1
1731503159943,CSS 296,005,796159,Fleischer; Jason G,0,0,0,1
1731503159943,CSS 296,006,796162,Creel; Sarah,0,0,0,1
1731503159943,CSS 296,007,796165,Patel; Hemal,0,0,0,1
1731503159943,CSS 296,008,796168,Martin; Isaac,0,0,0,1
1731503159943,CSS 296,009,796169,Styler; William Francis,0,0,0,1
1731503159943,CSS 296,010,796171,Grigoryan; Aram,0,0,0,3
1731503159943,CSS 296,011,796172,Bonjour; Trevor,0,0,0,1
1731503159943,CSS 296,012,796173,Martin; Isaac,0,0,0,0
1731503160975,DDPM 204,A00,742646,Ma; Joseph David,30,0,35,5
1731503162004,DDPM 208,A00,742647,Ma; Joseph David,30,0,35,5
1731503163030,DDPM 213,A00,742648,Cuomo; Raphael Eduardo,30,0,35,5
1731503164058,DERM 296,001,791572,Hightower; George Kimet,9,0,10,1
1731503164058,DERM 296,002,791573,Eichenfield; Dawn Zhang,9,0,10,1
1731503164058,DERM 296,003,791575,Staff,10,0,10,0
1731503165106,DOC 2,A01,741984,Strom; Megan C.,0,0,0,0
1731503165106,DOC 2,A02,741987,Strom; Megan C.,0,0,0,0
1731503165106,DOC 2,A03,741989,Strom; Megan C.,0,0,0,0
1731503165106,DOC 2,A04,741990,Strom; Megan C.,0,0,0,0
1731503165106,DOC 2,A05,741993,Strom; Megan C.,0,0,0,0
1731503165106,DOC 2,A06,741994,Strom; Megan C.,0,0,0,0
1731503165106,DOC 2,A07,741995,Strom; Megan C.,0,0,0,0
1731503165106,DOC 2,A08,741996,Strom; Megan C.,0,0,0,0
1731503165106,DOC 2,A09,741999,Strom; Megan C.,0,0,0,0
1731503165106,DOC 2,A10,742000,Strom; Megan C.,0,0,0,0
1731503165106,DOC 2,A11,742002,Strom; Megan C.,0,0,0,0
1731503165106,DOC 2,A12,742005,Strom; Megan C.,0,0,0,0
1731503165106,DOC 2,A13,742007,Strom; Megan C.,0,0,0,0
1731503165106,DOC 2,A14,742009,Strom; Megan C.,0,0,0,0
1731503165106,DOC 2,A15,742010,Strom; Megan C.,0,0,0,0
1731503165106,DOC 2,A16,742153,Strom; Megan C.,0,0,0,0
1731503165106,DOC 2,B01,742170,Strom; Megan C.,0,0,0,0
1731503165106,DOC 2,B02,742175,Strom; Megan C.,0,0,0,0
1731503165106,DOC 2,B03,742192,Strom; Megan C.,0,0,0,0
1731503165106,DOC 2,B04,742193,Strom; Megan C.,0,0,0,0
1731503165106,DOC 2,B05,742197,Strom; Megan C.,0,0,0,0
1731503165106,DOC 2,B06,742198,Strom; Megan C.,0,0,0,0
1731503165106,DOC 2,B07,742201,Strom; Megan C.,0,0,0,0
1731503165106,DOC 2,B08,742204,Strom; Megan C.,0,0,0,0
1731503165106,DOC 2,B09,742206,Strom; Megan C.,0,0,0,0
1731503165106,DOC 2,B10,742211,Strom; Megan C.,0,0,0,0
1731503165106,DOC 2,B11,742214,Strom; Megan C.,0,0,0,0
1731503165106,DOC 2,B12,742215,Strom; Megan C.,0,0,0,0
1731503165106,DOC 2,B13,742224,Strom; Megan C.,0,0,0,0
1731503165106,DOC 2,B14,742230,Strom; Megan C.,0,0,0,0
1731503165106,DOC 2,B15,742290,Strom; Megan C.,0,0,0,0
1731503165106,DOC 2,B16,742292,Strom; Megan C.,0,0,0,0
1731503165106,DOC 2,C01,742295,Solomon; Amanda Lee Albaniel,0,0,0,0
1731503165106,DOC 2,C02,742296,Solomon; Amanda Lee Albaniel,0,0,0,0
1731503165106,DOC 2,C03,742297,Solomon; Amanda Lee Albaniel,0,0,0,0
1731503165106,DOC 2,C04,742303,Solomon; Amanda Lee Albaniel,0,0,0,0
1731503165106,DOC 2,C05,742304,Solomon; Amanda Lee Albaniel,0,0,0,0
1731503165106,DOC 2,C06,742306,Solomon; Amanda Lee Albaniel,0,0,0,0
1731503165106,DOC 2,C07,742309,Solomon; Amanda Lee Albaniel,0,0,0,0
1731503165106,DOC 2,C08,742310,Solomon; Amanda Lee Albaniel,0,0,0,0
1731503165106,DOC 2,C09,742352,Solomon; Amanda Lee Albaniel,0,0,0,0
1731503165106,DOC 2,C10,742363,Solomon; Amanda Lee Albaniel,0,0,0,0
1731503165106,DOC 2,C11,742372,Solomon; Amanda Lee Albaniel,0,0,0,0
1731503165106,DOC 2,C12,742381,Solomon; Amanda Lee Albaniel,0,0,0,0
1731503165106,DOC 2,C13,742382,Solomon; Amanda Lee Albaniel,0,0,0,0
1731503165106,DOC 2,C14,742383,Solomon; Amanda Lee Albaniel,0,0,0,0
1731503165106,DOC 2,C15,798384,Solomon; Amanda Lee Albaniel,0,0,0,0
1731503165106,DOC 2,C16,798386,Solomon; Amanda Lee Albaniel,0,0,0,0
1731503165106,DOC 2,D01,742489,Villegas; Karen Eliza,0,0,0,0
1731503165106,DOC 2,D02,742493,Villegas; Karen Eliza,0,0,0,0
1731503165106,DOC 2,D03,742551,Villegas; Karen Eliza,0,0,0,0
1731503165106,DOC 2,D04,742552,Villegas; Karen Eliza,0,0,0,0
1731503165106,DOC 2,D05,742553,Villegas; Karen Eliza,0,0,0,0
1731503165106,DOC 2,D06,742556,Villegas; Karen Eliza,0,0,0,0
1731503165106,DOC 2,D07,742559,Villegas; Karen Eliza,0,0,0,0
1731503165106,DOC 2,D08,742560,Villegas; Karen Eliza,0,0,0,0
1731503165106,DOC 2,D09,742608,Villegas; Karen Eliza,0,0,0,0
1731503165106,DOC 2,D10,742635,Villegas; Karen Eliza,0,0,0,0
1731503165106,DOC 2,D11,742636,Villegas; Karen Eliza,0,0,0,0
1731503165106,DOC 2,D12,742637,Villegas; Karen Eliza,0,0,0,0
1731503165106,DOC 2,D13,742638,Villegas; Karen Eliza,0,0,0,0
1731503165106,DOC 2,D14,742639,Villegas; Karen Eliza,0,0,0,0
1731503165106,DOC 2,D15,742640,Villegas; Karen Eliza,0,0,0,0
1731503165106,DOC 2,D16,742641,Villegas; Karen Eliza,0,0,0,0
1731503165106,DOC 2,D17,742642,Villegas; Karen Eliza,0,0,0,0
1731503166133,DOC 100D,A00,742643,Pass; Natalye,25,0,25,0
1731503166133,DOC 100D,B00,742644,Pass; Natalye,24,0,25,1
1731503167162,DSC 10,A01,741312,Tiefenbruck; Janine LoBue,136,0,145,9
1731503167162,DSC 10,B01,741322,Tiefenbruck; Janine LoBue,143,0,145,2
1731503168195,DSC 20,A01,741392,Langlois; Marina,192,0,192,0
1731503168195,DSC 20,B01,741530,Langlois; Marina,192,0,192,0
1731503169225,DSC 30,A01,741532,Liao; Soohyun Nam,70,0,70,0
1731503169225,DSC 30,B01,741538,Liao; Soohyun Nam,69,0,70,1
1731503170253,DSC 40A,A01,741544,Shannon; Kyle Michael,187,0,192,5
1731503171279,DSC 40B,A01,741549,Wang; Yusu,143,0,145,2
1731503172309,DSC 80,A01,741553,Watson-Parris; Duncan,149,0,149,0
1731503173336,DSC 95,A01,741617,Langlois; Marina,35,0,35,0
1731503174366,DSC 96,A00,741618,Quer; Giorgio,39,0,40,1
1731503175398,DSC 100,A01,741627,Salimi; Babak,141,0,145,4
1731503176434,DSC 106,A01,741636,Lau; Samuel Ethan,144,0,146,2
1731503176434,DSC 106,B01,741638,Lau; Samuel Ethan,144,0,146,2
1731503177468,DSC 140A,A01,741642,Eldridge; Justin Matthew,136,0,145,9
1731503177468,DSC 140A,B01,741646,Eldridge; Justin Matthew,143,0,145,2
1731503178504,DSC 140B,A01,741682,Huang; Biwei,137,0,145,8
1731503179531,DSC 148,A01,794521,Shang; Jingbo,122,0,125,3
1731503180559,DSC 170,A01,741684,Zaslavsky; Ilya,28,0,40,12
1731503181590,DSC 180B,A01,741686,Bellur; Umesh,8,0,8,0
1731503181590,DSC 180B,A02,741687,Bellur; Umesh,4,0,4,0
1731503181590,DSC 180B,A03,741688,Bellur; Umesh,8,0,8,0
1731503181590,DSC 180B,A04,741707,Bellur; Umesh,6,0,6,0
1731503181590,DSC 180B,A05,741708,Bellur; Umesh,6,0,6,0
1731503181590,DSC 180B,A06,741709,Bellur; Umesh,8,0,8,0
1731503181590,DSC 180B,A07,741710,Bellur; Umesh,6,0,6,0
1731503181590,DSC 180B,A08,741711,Bellur; Umesh,4,0,4,0
1731503181590,DSC 180B,A09,741712,Bellur; Umesh,10,0,10,0
1731503181590,DSC 180B,A10,741713,Bellur; Umesh,10,0,10,0
1731503181590,DSC 180B,A11,741714,Bellur; Umesh,6,0,6,0
1731503181590,DSC 180B,A12,741715,Bellur; Umesh,4,0,4,0
1731503181590,DSC 180B,A13,741716,Bellur; Umesh,6,0,6,0
1731503181590,DSC 180B,A14,741717,Bellur; Umesh,6,0,6,0
1731503181590,DSC 180B,A15,741718,Bellur; Umesh,8,0,8,0
1731503181590,DSC 180B,A16,741719,Bellur; Umesh,10,0,10,0
1731503181590,DSC 180B,A17,741720,Bellur; Umesh,4,0,4,0
1731503181590,DSC 180B,B01,741724,Bellur; Umesh,8,0,8,0
1731503181590,DSC 180B,B02,741725,Bellur; Umesh,10,0,10,0
1731503181590,DSC 180B,B03,741733,Bellur; Umesh,6,0,6,0
1731503181590,DSC 180B,B04,741734,Bellur; Umesh,6,0,6,0
1731503181590,DSC 180B,B05,741736,Bellur; Umesh,4,0,4,0
1731503181590,DSC 180B,B06,741778,Bellur; Umesh,6,0,6,0
1731503181590,DSC 180B,B07,741780,Bellur; Umesh,8,0,8,0
1731503181590,DSC 180B,B08,741782,Bellur; Umesh,6,0,6,0
1731503181590,DSC 180B,B09,741785,Bellur; Umesh,6,0,6,0
1731503181590,DSC 180B,B10,741786,Bellur; Umesh,6,0,6,0
1731503181590,DSC 180B,B11,741788,Bellur; Umesh,4,0,4,0
1731503181590,DSC 180B,B12,741789,Bellur; Umesh,10,0,10,0
1731503181590,DSC 180B,B13,741791,Bellur; Umesh,6,0,6,0
1731503181590,DSC 180B,B14,741793,Bellur; Umesh,8,0,8,0
1731503181590,DSC 180B,B15,741794,Bellur; Umesh,8,0,8,0
1731503181590,DSC 180B,B16,741797,Bellur; Umesh,8,0,8,0
1731503181590,DSC 180B,B17,741855,Bellur; Umesh,4,0,4,0
1731503181590,DSC 180B,B18,741857,Bellur; Umesh,4,0,4,0
1731503182618,DSC 190,A01,741874,Silberman; Jack,19,0,20,1
1731503182618,DSC 190,B01,741877,Smarr; Benjamin,36,0,40,4
1731503182618,DSC 190,C01,741879,Mishne; Gal,18,0,20,2
1731503183643,DSC 197,001,741880,Eldridge; Justin Matthew,9999,0,9999,0
1731503184679,DSC 202,A00,741881,Gupta; Amarnath,0,0,70,70
1731503185705,DSC 206,A00,741883,Mazumdar; Arya,16,0,100,84
1731503186731,DSC 207R,A01,741885,Staff,77,0,80,3
1731503187758,DSC 208R,A01,741887,Salimi; Babak,36,0,80,44
1731503188788,DSC 211,A00,741888,Wang; Jun-Kun,16,0,70,54
1731503189815,DSC 215R,A01,741890,Staff,77,0,80,3
1731503190842,DSC 240,A00,741892,Wang; Yuxiang,33,0,100,67
1731503191871,DSC 244,A00,741893,Schwartzman; Armin,76,0,90,14
1731503192896,DSC 250,A00,741894,Hu; Zhiting,0,0,90,90
1731503193923,DSC 255R,A01,741898,Dasgupta; Sanjoy,39,0,80,41
1731503194952,DSC 266R,A01,741900,Weibel; Nadir,39,0,60,21
1731503195980,DSC 288R,A01,741902,Bellur; Umesh,38,0,60,22
1731503197015,DSC 291,A00,741904,Smarr; Benjamin,0,0,30,30
1731503197015,DSC 291,B00,741905,Freund; Yoav,47,0,60,13
1731503197015,DSC 291,C00,741906,Belkin; Mikhail,59,0,80,21
1731503197015,DSC 291,D00,741907,Li; Aobo,31,0,40,9
1731503197015,DSC 291,E00,741908,Ma; Yian,39,0,60,21
1731503197015,DSC 291,F00,794449,Jin; Haojian,55,0,60,5
1731503197015,DSC 291,G00,797963,Mishne; Gal,0,0,20,20
1731503197015,DSC 291,H00,797964,Zhang; Hao,32,0,80,48
1731503198047,DSC 293,A00,741911,Ustun; Tevfik Berk,9990,0,9999,9
1731503199076,DSE 201,A00,741279,Deutsch; Alin Bernard,25,0,25,0
1731503200103,DSE 210,A00,741281,Staff,25,0,25,0
1731503201131,DSE 241,A00,741286,Staff,25,0,25,0
1731503202158,DSE 260A,A00,741290,Altintas De Callaf; Ilkay,25,0,25,0
1731503203192,DSGN 1,A01,737377,Meyer; Michael Wayne,47,0,50,3
1731503203192,DSGN 1,A02,737382,Meyer; Michael Wayne,35,0,50,15
1731503204220,DSGN 100,A01,736806,Rill; Bryan,24,0,25,1
1731503204220,DSGN 100,A02,736809,Rill; Bryan,24,0,25,1
1731503204220,DSGN 100,A03,736810,Rill; Bryan,23,0,25,2
1731503204220,DSGN 100,A04,736812,Rill; Bryan,18,0,25,7
1731503205244,DSGN 119,A00,736813,Vaccaro; Kristen Marie,85,0,100,15
1731503206272,DSGN 219,A00,736817,Vaccaro; Kristen Marie,14,0,15,1
1731503207307,ECE 5,A01,744925,Morris; Karcher William,22,0,26,4
1731503207307,ECE 5,A02,744926,Morris; Karcher William,23,0,26,3
1731503207307,ECE 5,A03,744927,Morris; Karcher William,26,0,26,0
1731503207307,ECE 5,A04,744929,Morris; Karcher William,26,0,26,0
1731503208335,ECE 15,A01,744931,Sahay; Rajeev,188,0,192,4
1731503209365,ECE 16,A01,744935,Khoshabeh; Ramsin,25,0,30,5
1731503210406,ECE 25,A50,744939,Morris; Karcher William,26,0,30,4
1731503210406,ECE 25,A51,744940,Morris; Karcher William,29,0,30,1
1731503210406,ECE 25,A52,744941,Morris; Karcher William,27,0,30,3
1731503210406,ECE 25,A53,744942,Morris; Karcher William,28,0,30,2
1731503210406,ECE 25,A54,744944,Morris; Karcher William,30,0,30,0
1731503211442,ECE 35,A50,744954,Schurgers; Curt,27,0,30,3
1731503211442,ECE 35,A51,744955,Schurgers; Curt,30,0,30,0
1731503211442,ECE 35,A52,745033,Schurgers; Curt,30,0,30,0
1731503211442,ECE 35,A53,745037,Schurgers; Curt,25,0,30,5
1731503211442,ECE 35,A54,745046,Schurgers; Curt,30,0,30,0
1731503211442,ECE 35,A55,745047,Schurgers; Curt,30,0,30,0
1731503212469,ECE 45,A01,745170,Heath Jr.; Robert Wendell,90,0,98,8
1731503212469,ECE 45,A02,745252,Heath Jr.; Robert Wendell,94,0,98,4
1731503213497,ECE 65,A50,745256,Baghdadchi; Saharnaz,28,0,30,2
1731503213497,ECE 65,A51,745257,Baghdadchi; Saharnaz,29,0,30,1
1731503213497,ECE 65,A52,745258,Baghdadchi; Saharnaz,26,0,30,4
1731503213497,ECE 65,A53,745259,Baghdadchi; Saharnaz,29,0,30,1
1731503213497,ECE 65,A54,745260,Baghdadchi; Saharnaz,29,0,30,1
1731503213497,ECE 65,A55,745261,Baghdadchi; Saharnaz,29,0,30,1
1731503214530,ECE 101,A01,745263,Gonzalez Prelcic; Nuria,83,0,90,7
1731503214530,ECE 101,A02,745264,Gonzalez Prelcic; Nuria,88,0,90,2
1731503215573,ECE 102,A00,745265,Le; Hanh-Phuc,91,0,100,9
1731503216600,ECE 103,A01,745273,Lo; Yu-Hwa,51,0,60,9
1731503217637,ECE 107,A01,745309,Fullerton; Eric E,93,0,100,7
1731503218664,ECE 109,A01,745315,Poveda Fonseca; Jorge,169,0,180,11
1731503219696,ECE 111,A01,745319,Eldon; John,201,0,220,19
1731503220727,ECE 115,A01,745321,Yip; Michael,22,0,28,6
1731503221762,ECE 121B,A50,745324,Esmaili; Gholamreza,11,0,12,1
1731503221762,ECE 121B,A51,745326,Esmaili; Gholamreza,12,0,12,0
1731503221762,ECE 121B,A52,745327,Esmaili; Gholamreza,9,0,12,3
1731503221762,ECE 121B,A53,745328,Esmaili; Gholamreza,12,0,12,0
1731503222799,ECE 125A,A50,745332,Le; Hanh-Phuc,9,0,12,3
1731503222799,ECE 125A,A51,745333,Le; Hanh-Phuc,11,0,12,1
1731503222799,ECE 125A,A52,745334,Le; Hanh-Phuc,9,0,12,3
1731503222799,ECE 125A,A53,745336,Le; Hanh-Phuc,11,0,12,1
1731503223834,ECE 128B,A00,745337,Esmaili; Gholamreza,70,0,75,5
1731503224862,ECE 135B,A00,745339,Dayeh; Shadi Ahmad,19,0,25,6
1731503225894,ECE 140A,A01,745345,Khoshabeh; Ramsin,0,0,0,0
1731503225894,ECE 140A,A02,745346,Khoshabeh; Ramsin,0,0,0,0
1731503225894,ECE 140A,A03,745347,Khoshabeh; Ramsin,0,0,0,0
1731503225894,ECE 140A,A04,745348,Khoshabeh; Ramsin,0,0,0,0
1731503226929,ECE 141A,A01,745351,Gessner; Richard K.,64,0,75,11
1731503227957,ECE 143,A00,745352,Unpingco; Jose H.,0,0,0,3
1731503228985,ECE 148,A01,745355,Silberman; Jack,22,0,24,2
1731503230019,ECE 158B,A01,745357,Zhang; Xinyu,19,0,25,6
1731503231053,ECE 161B,A00,745361,Nguyen; Truong Quang,62,0,65,3
1731503232079,ECE 172A,A01,745372,Parhi; Rahul,115,0,120,5
1731503233113,ECE 175A,A01,745378,Vasconcelos; Nuno,82,0,90,8
1731503234138,ECE 176,A00,745379,Wang; Xiaolong,158,0,196,38
1731503235172,ECE 181,A01,745381,Antipa; Nicholas A,18,0,25,7
1731503236203,ECE 184,A00,745382,Fainman; Yeshaiahu,10,0,15,5
1731503237235,ECE 191,A00,745387,Zhang; Xinyu,39,0,40,1
1731503238262,ECE 197,001,745394,Mercier; Patrick Philip,9999,0,9999,0
1731503239289,ECE 198,001,745395,Nguyen; Truong Quang,9999,0,9999,0
1731503239289,ECE 198,002,800722,Fullerton; Eric E,9999,0,9999,0
1731503240320,ECE 212BN,A00,745419,Ng; Tse Nga,0,0,0,0
1731503241352,ECE 222B,A00,745501,Lomakin; Vitaliy,0,0,0,0
1731503242378,ECE 226,A00,745504,Koushanfar; Farinaz,0,0,0,0
1731503243410,ECE 230B,A00,745505,Taur; Yuan,0,0,0,0
1731503244441,ECE 238A,A00,745507,Luo; Jian,0,0,0,0
1731503245469,ECE 240B,A00,745510,Rubin; Noah,0,0,0,0
1731503246498,ECE 247B,A00,745512,Wang; Joseph,0,0,0,0
1731503247526,ECE 250,A00,745515,Siegel; Paul H.,0,0,0,0
1731503248557,ECE 251A,A00,745518,Meyer; Florian,0,0,0,0
1731503249583,ECE 257B,A00,745519,Bharadia; Dinesh,0,0,0,0
1731503250614,ECE 258A,A00,745524,Milstein; Laurence B.,0,0,0,0
1731503251645,ECE 260B,A00,745525,Kang; Mingu,0,0,0,0
1731503252672,ECE 264A,A00,745526,Galton; Ian A,0,0,0,0
1731503253704,ECE 265A,A00,745530,Gudem; Prasad S.S.,0,0,0,0
1731503254733,ECE 265D,A00,745531,Gudem; Prasad S.S.,0,0,0,0
1731503255767,ECE 269,A01,745540,Pal; Piya,0,0,0,0
1731503256793,ECE 271B,A00,745541,Vasconcelos; Manuela,0,0,0,0
1731503257826,ECE 276A,A00,745543,Atanasov; Nikolay A.,0,0,0,0
1731503258853,ECE 277,A00,745544,An; Cheolhong,0,0,0,0
1731503259880,ECE 283,A00,745547,Hsueh; Tzu-Chien,0,0,0,0
1731503260907,ECE 285,A00,745548,Zheng; Yang,0,0,0,0
1731503261936,ECE 286,B00,795641,Poveda Fonseca; Jorge,0,0,0,0
1731503262968,ECON 1,A01,742650,Crane; Meredith Helen,143,0,150,7
1731503262968,ECON 1,B01,742652,Crane; Meredith Helen,149,0,150,1
1731503262968,ECON 1,C01,742655,Newhouse; Herbert S,71,0,75,4
1731503262968,ECON 1,C02,742656,Newhouse; Herbert S,75,0,75,0
1731503264001,ECON 2,A01,742660,Crane; Meredith Helen,78,0,78,0
1731503264001,ECON 2,A02,742661,Crane; Meredith Helen,80,0,80,0
1731503265029,ECON 3,A01,742663,Rondina; Giacomo,113,0,125,12
1731503265029,ECON 3,A02,742664,Rondina; Giacomo,125,0,125,0
1731503265029,ECON 3,B01,742667,Rondina; Giacomo,121,0,125,4
1731503265029,ECON 3,B02,742669,Rondina; Giacomo,125,0,125,0
1731503266058,ECON 4,A01,742672,Levkoff; Steven B.,73,0,75,2
1731503266058,ECON 4,A02,742673,Levkoff; Steven B.,71,0,75,4
1731503266058,ECON 4,A03,742674,Levkoff; Steven B.,73,0,75,2
1731503266058,ECON 4,B01,798340,Brooks; Marcus Raymond,2,0,3,1
1731503267091,ECON 5,A01,742676,Dai; Yinlin,51,0,54,3
1731503267091,ECON 5,A02,742677,Dai; Yinlin,53,0,54,1
1731503267091,ECON 5,A03,742678,Dai; Yinlin,51,0,54,3
1731503267091,ECON 5,A04,742679,Dai; Yinlin,54,0,54,0
1731503267091,ECON 5,A05,742680,Dai; Yinlin,54,0,54,0
1731503267091,ECON 5,B01,742682,Dai; Yinlin,53,0,54,1
1731503267091,ECON 5,B02,742684,Dai; Yinlin,52,0,54,2
1731503267091,ECON 5,B03,742686,Dai; Yinlin,53,0,54,1
1731503267091,ECON 5,B04,742687,Dai; Yinlin,50,0,54,4
1731503267091,ECON 5,B05,742723,Dai; Yinlin,51,0,54,3
1731503268126,ECON 86,A00,795622,Muendler; Marc,98,0,100,2
1731503269155,ECON 100A,A01,742728,Grigoryan; Aram,98,0,100,2
1731503269155,ECON 100A,A02,742730,Grigoryan; Aram,94,0,100,6
1731503269155,ECON 100A,A03,742733,Grigoryan; Aram,93,0,100,7
1731503269155,ECON 100A,A04,742735,Grigoryan; Aram,97,0,100,3
1731503270182,ECON 100B,A01,742738,Levkoff; Steven B.,90,0,96,6
1731503270182,ECON 100B,A02,742742,Levkoff; Steven B.,102,0,104,2
1731503270182,ECON 100B,A03,742744,Levkoff; Steven B.,99,0,100,1
1731503270182,ECON 100B,A04,742745,Levkoff; Steven B.,98,0,100,2
1731503271214,ECON 100C,A01,742757,Newhouse; Herbert S,100,0,100,0
1731503271214,ECON 100C,B01,742768,Newhouse; Herbert S,92,0,100,8
1731503272241,ECON 102,A01,742785,Muendler; Marc,110,0,120,10
1731503273322,ECON 105,A00,742834,Vespa; Emanuel Ignacio,97,0,100,3
1731503274353,ECON 109,A01,742838,Watson; Joel Christopher,107,0,120,13
1731503274353,ECON 109,A02,742841,Watson; Joel Christopher,118,0,120,2
1731503274353,ECON 109,A03,742843,Watson; Joel Christopher,0,0,0,0
1731503275381,ECON 109T,A00,742844,Watson; Joel Christopher,18,0,20,2
1731503276410,ECON 110A,A01,742847,Jaimovich; Nir,95,0,100,5
1731503276410,ECON 110A,B01,742852,Jaimovich; Nir,99,0,100,1
1731503277437,ECON 110B,A01,742854,Hamilton; James D.,93,0,98,5
1731503277437,ECON 110B,A02,742858,Hamilton; James D.,98,0,98,0
1731503277437,ECON 110B,B01,742861,Hamilton; James D.,90,0,98,8
1731503277437,ECON 110B,B02,742863,Hamilton; James D.,98,0,98,0
1731503278469,ECON 110BH,A00,742865,Hamilton; James D.,20,0,20,0
1731503279497,ECON 116,A00,742866,Lowes; Sara Rachel,69,0,70,1
1731503279497,ECON 116,B00,742868,Lowes; Sara Rachel,43,0,44,1
1731503280538,ECON 120A,A01,742871,Idoux; Clemence Marie,97,0,100,3
1731503280538,ECON 120A,B01,742873,Candido; Maria Teresa,91,0,95,4
1731503280538,ECON 120A,B02,742877,Candido; Maria Teresa,88,0,90,2
1731503280538,ECON 120A,C01,742879,Candido; Maria Teresa,109,0,115,6
1731503281575,ECON 120B,A01,742884,Berman; Eli,26,0,30,4
1731503281575,ECON 120B,B01,742889,Dahl; Gordon B.,18,0,30,12
1731503281575,ECON 120B,C01,742892,Dahl; Gordon B.,109,0,120,11
1731503281575,ECON 120B,C02,742893,Dahl; Gordon B.,116,0,120,4
1731503282602,ECON 120BH,A00,742895,Dahl; Gordon B.,20,0,20,0
1731503283639,ECON 120C,A01,742902,Candido; Maria Teresa,66,0,70,4
1731503283639,ECON 120C,A02,742905,Candido; Maria Teresa,69,0,70,1
1731503284666,ECON 138,A00,742908,Bharadwaj; Prashant,188,0,200,12
1731503285693,ECON 145,A00,742909,Squires; Dale E,144,0,150,6
1731503286721,ECON 149,A00,742910,Grigoryan; Aram,98,0,100,2
1731503287750,ECON 175,A00,742911,Wu; Pak Yeung,44,0,50,6
1731503287750,ECON 175,B00,742912,Wu; Pak Yeung,42,0,44,2
1731503288780,ECON 178,A01,742915,Zhu; Ying,48,0,60,12
1731503289808,ECON 181,A00,742916,Staff,99,0,100,1
1731503290835,ECON 185,A01,742919,Bharadwaj; Prashant,13,0,18,5
1731503291863,ECON 186,A00,742966,Ross; Stephen Geoffrey,93,0,100,7
1731503292888,ECON 190,A00,742967,Vespa; Emanuel Ignacio,47,0,50,3
1731503292888,ECON 190,B00,742968,Vespa; Emanuel Ignacio,50,0,50,0
1731503293920,ECON 200B,A00,742971,Watson; Joel Christopher,33,0,35,2
1731503294952,ECON 208,A00,742972,Vespa; Emanuel Ignacio & Watson; Joel Christopher,17,0,20,3
1731503295980,ECON 210B,A00,742979,Rondina; Giacomo,34,0,35,1
1731503297013,ECON 220B,A00,743008,Ma; Xinwei,32,0,35,3
1731503298037,ECON 220E,A00,743012,Ma; Xinwei,24,0,30,6
1731503299064,ECON 231,A00,743013,Cullen; Julie,8,0,12,4
1731503300092,ECON 237,A00,743015,Lowes; Sara Rachel & Bazzi; Samuel A,16,0,20,4
1731503301119,ECON 250B,A00,743043,Dahl; Gordon B.,24,0,25,1
1731503302150,ECON 267,A00,743122,Graff Zivin; Joshua,21,0,25,4
1731503303178,ECON 284,A00,743123,Niehaus; Paul,21,0,25,4
1731503304205,ECON 286,A00,743124,Wu; Pak Yeung,19,0,20,1
1731503305233,EDS 23,A01,743187,Staff,0,0,0,0
1731503305233,EDS 23,B01,743239,Staff,0,0,0,0
1731503306263,EDS 39,A01,743242,Heinzman; Erica M.,24,0,25,1
1731503307293,EDS 103,A01,743244,Halter; Christopher P.,33,0,35,2
1731503308320,EDS 111,A00,743245,Staff,58,0,60,2
1731503309351,EDS 112,A01,743247,Chapman; Thandeka K,22,0,30,8
1731503309351,EDS 112,A02,743248,Chapman; Thandeka K,30,0,30,0
1731503310378,EDS 114,A01,743280,Eguchi; Emi,17,0,18,1
1731503310378,EDS 114,A02,743307,Eguchi; Emi,17,0,17,0
1731503311410,EDS 115,A00,743316,Mamas; Christoforos,52,0,60,8
1731503312441,EDS 117,A01,743398,Jones; Gabrielle Anastasia,20,0,23,3
1731503312441,EDS 117,A02,743402,Jones; Gabrielle Anastasia,23,0,23,0
1731503312441,EDS 117,A03,743403,Jones; Gabrielle Anastasia,22,0,22,0
1731503312441,EDS 117,A04,743404,Jones; Gabrielle Anastasia,22,0,22,0
1731503312441,EDS 117,B01,743428,Aragon; Maria Jose,23,0,25,2
1731503312441,EDS 117,B02,743429,Aragon; Maria Jose,25,0,25,0
1731503313469,EDS 122,A00,743489,Brydges; Stacey,10,0,10,0
1731503314499,EDS 124AR,A00,743510,Simon; Elizabeth A,86,0,100,14
1731503314499,EDS 124AR,B00,743511,Simon; Elizabeth A,195,0,200,5
1731503314499,EDS 124AR,C00,794870,Simon; Elizabeth A,40,0,40,0
1731503315530,EDS 124BR,A00,743513,Eguchi; Emi,65,0,75,10
1731503315530,EDS 124BR,B00,795833,Eguchi; Emi,25,0,25,0
1731503316556,EDS 125,A00,743515,Jones; Gabrielle Anastasia,49,0,60,11
1731503317590,EDS 126,A01,743522,Jones; Makeba,30,0,33,3
1731503317590,EDS 126,A02,743617,Jones; Makeba,33,0,33,0
1731503317590,EDS 126,A03,743688,Jones; Makeba,34,0,34,0
1731503318619,EDS 128A,A01,743693,Fargason; Sharon Gayle,11,0,15,4
1731503318619,EDS 128A,A02,743694,Fargason; Sharon Gayle,14,0,15,1
1731503318619,EDS 128A,A03,743695,Fargason; Sharon Gayle,18,0,20,2
1731503319646,EDS 129B,A01,743702,Black; Alison Michelle,42,0,45,3
1731503320675,EDS 130,A01,743709,Choi; Bailey Miyeon,17,0,20,3
1731503320675,EDS 130,A02,743710,Choi; Bailey Miyeon,20,0,20,0
1731503320675,EDS 130,A03,743711,Choi; Bailey Miyeon,19,0,20,1
1731503321703,EDS 131,A01,743718,Cohen; Shana R,20,0,20,0
1731503321703,EDS 131,A02,743722,Cohen; Shana R,20,0,20,0
1731503322731,EDS 133,A01,743741,Bintliff; Amy S.V.,23,0,25,2
1731503322731,EDS 133,A02,743748,Bintliff; Amy S.V.,20,0,20,0
1731503323768,EDS 139,A00,743749,Fargason; Sharon Gayle,43,0,50,7
1731503323768,EDS 139,B00,743825,Black; Alison Michelle,41,0,45,4
1731503323768,EDS 139,C00,743847,Choi; Bailey Miyeon,56,0,60,4
1731503323768,EDS 139,D00,743848,Cohen; Shana R,40,0,40,0
1731503323768,EDS 139,E00,743849,Bintliff; Amy S.V.,43,0,45,2
1731503323768,EDS 139,F00,743851,Bintliff; Amy S.V.,19,0,20,1
1731503323768,EDS 139,G00,743853,Hemans; Patricia Ann Benitez,31,0,35,4
1731503323768,EDS 139,H00,743854,Hemans; Patricia Ann Benitez,20,0,20,0
1731503324802,EDS 140,A00,743898,Hemans; Patricia Ann Benitez,30,0,35,5
1731503325840,EDS 146,A01,743953,Hemans; Patricia Ann Benitez,24,0,25,1
1731503325840,EDS 146,A02,794684,Hemans; Patricia Ann Benitez,0,0,0,0
1731503326870,EDS 149,A00,799976,Millstone; Rachel Diana,20,0,20,0
1731503326870,EDS 149,B00,799977,Heinzman; Erica M.,20,0,20,0
1731503327900,EDS 162,A01,797962,Phuong; Andrew,19,0,20,1
1731503328926,EDS 205A,A00,743983,Halter; Christopher P.,33,0,40,7
1731503329968,EDS 205B,A00,744003,Halter; Christopher P.,32,0,45,13
1731503331000,EDS 232,A00,744009,Clarke; Sherice Nicole,14,0,15,1
1731503332026,EDS 256,A00,744012,Mamas; Christoforos,15,0,15,0
1731503333055,EDS 259A,A00,744013,Aragon; Maria Jose,14,0,15,1
1731503334087,EDS 259B,A00,744014,Aragon; Maria Jose,14,0,15,1
1731503335114,EDS 264,A00,744016,Clarke; Sherice Nicole,14,0,15,1
1731503336141,EDS 280,A00,744017,Datnow; Amanda Lee,11,0,18,7
1731503337172,EDS 287A,A00,744018,Daly; Alan J.,9,0,15,6
1731503338202,EDS 287C,A00,744019,Daly; Alan J.,15,0,15,0
1731503339231,EDS 288B,A00,744020,Fine; Sarah,15,0,15,0
1731503340258,EDS 289A,A01,744022,Hofstetter; Carolyn,15,0,15,0
1731503341285,EDS 291A,A01,744024,Daly; Alan J.,9,0,15,6
1731503342315,EDS 293A,A01,744026,Burrell; Sade Renee,15,0,15,0
1731503343345,EDS 294A,A00,744027,Meyerott; Theresa Ann,15,0,15,0
1731503344382,EDS 296,001,773835,Aragon; Maria Jose,10,0,10,0
1731503344382,EDS 296,002,773846,Bintliff; Amy S.V.,10,0,10,0
1731503344382,EDS 296,003,773906,Clarke; Sherice Nicole,10,0,10,0
1731503344382,EDS 296,004,773907,Chapman; Thandeka K,10,0,10,0
1731503344382,EDS 296,005,773910,Cohen; Shana R,10,0,10,0
1731503344382,EDS 296,006,773911,Datnow; Amanda Lee,10,0,10,0
1731503344382,EDS 296,007,773913,Halter; Christopher P.,10,0,10,0
1731503344382,EDS 296,008,773916,Hopkins; Megan Beth,9,0,10,1
1731503344382,EDS 296,009,773922,Jones; Makeba,10,0,10,0
1731503344382,EDS 296,010,773923,Jones; Gabrielle Anastasia,10,0,10,0
1731503344382,EDS 296,011,773924,Daly; Alan J.,10,0,10,0
1731503344382,EDS 296,012,773925,Simon; Elizabeth A,10,0,10,0
1731503344382,EDS 296,013,773933,Eguchi; Emi,10,0,10,0
1731503344382,EDS 296,014,773977,Hofstetter; Carolyn,10,0,10,0
1731503344382,EDS 296,015,800629,Wishard Guerra; Alison G.,10,0,10,0
1731503344382,EDS 296,016,800644,Mamas; Christoforos,10,0,10,0
1731503344382,EDS 296,017,800654,Fine; Sarah,10,0,10,0
1731503344382,EDS 296,018,800656,Pollock; Mica,10,0,10,0
1731503344382,EDS 296,019,800657,Cohen; Shana R,10,0,10,0
1731503345410,EMED 296,001,791584,Staff,10,0,10,0
1731503345410,EMED 296,002,791585,Staff,10,0,10,0
1731503345410,EMED 296,003,791586,Staff,10,0,10,0
1731503346439,ENG 10,A00,741913,Evdokimenko; Ekaterina,59,0,60,1
1731503347465,ENG 100D,A00,741921,Ngo; Anh-Thu T.,36,0,40,4
1731503347465,ENG 100D,B00,794892,Ngo; Anh-Thu T.,38,0,40,2
1731503348495,ENG 100L,A00,741969,Kleissl; Jan,6,0,6,0
1731503348495,ENG 100L,B00,741970,Bratton; Maryann,6,0,6,0
1731503348495,ENG 100L,C00,741972,Yu; Paul K L,8,0,8,0
1731503348495,ENG 100L,D00,741973,Bratton; Maryann,6,0,6,0
1731503348495,ENG 100L,E00,741974,de Oliveira; Mauricio,6,0,6,0
1731503348495,ENG 100L,F00,741975,Bratton; Maryann,6,0,6,0
1731503348495,ENG 100L,G00,741976,Boyle; Mary E. T.,19,0,20,1
1731503348495,ENG 100L,H00,795155,Boyle; Mary E. T.,14,0,15,1
1731503349522,ENVR 102,A00,744170,Staff,25,0,25,0
1731503349522,ENVR 102,C00,744214,Staff,24,0,25,1
1731503350550,ENVR 120,A00,744215,Uyeda; Kellie Ann,13,0,16,3
1731503351581,ENVR 141,A00,744320,Siapno; Jacqueline A,10,0,10,0
1731503351581,ENVR 141,B00,744328,Siapno; Jacqueline A,15,0,15,0
1731503352607,ENVR 144,A01,744490,Herbst; Matthew,10,0,10,0
1731503354674,ERC 20,A00,744169,Evans; Ivan T,39,0,40,1
1731503355712,ESYS 10,A01,799973,Staff,35,0,35,0
1731503355712,ESYS 10,A02,799974,Staff,35,0,35,0
1731503356741,ESYS 102,A01,744506,Haase; Jennifer Susan,29,0,30,1
1731503356741,ESYS 102,A02,744507,Haase; Jennifer Susan,28,0,30,2
1731503356741,ESYS 102,A03,744520,Haase; Jennifer Susan,27,0,30,3
1731503356741,ESYS 102,A04,744534,Haase; Jennifer Susan,29,0,30,1
1731503357773,ESYS 187B,A01,744536,Hetherington; Elizabeth Dorsey,42,0,45,3
1731503357773,ESYS 187B,B01,794869,Hetherington; Elizabeth Dorsey,41,0,45,4
1731503358814,ETHN 2R,A01,744558,Perreira; Christopher Michael,21,0,25,4
1731503358814,ETHN 2R,A02,744559,Perreira; Christopher Michael,24,0,25,1
1731503358814,ETHN 2R,A03,744560,Perreira; Christopher Michael,22,0,25,3
1731503358814,ETHN 2R,A04,744561,Perreira; Christopher Michael,25,0,25,0
1731503358814,ETHN 2R,A05,744562,Perreira; Christopher Michael,25,0,25,0
1731503358814,ETHN 2R,A06,744563,Perreira; Christopher Michael,24,0,25,1
1731503358814,ETHN 2R,A07,744639,Perreira; Christopher Michael,24,0,25,1
1731503358814,ETHN 2R,A08,744644,Perreira; Christopher Michael,21,0,25,4
1731503358814,ETHN 2R,A09,744646,Perreira; Christopher Michael,24,0,25,1
1731503358814,ETHN 2R,A10,744651,Perreira; Christopher Michael,25,0,25,0
1731503358814,ETHN 2R,A11,744657,Perreira; Christopher Michael,25,0,25,0
1731503358814,ETHN 2R,A12,744664,Perreira; Christopher Michael,25,0,25,0
1731503358814,ETHN 2R,A13,744665,Perreira; Christopher Michael,24,0,25,1
1731503358814,ETHN 2R,A14,744673,Perreira; Christopher Michael,24,0,25,1
1731503358814,ETHN 2R,A15,744749,Perreira; Christopher Michael,24,0,25,1
1731503358814,ETHN 2R,A16,744751,Perreira; Christopher Michael,23,0,25,2
1731503359848,ETHN 100B,A00,744761,Streeby; Shelley,29,0,32,3
1731503360880,ETHN 100H,A00,744765,Frank; Ross H.,0,0,0,0
1731503361912,ETHN 101TV,A01,744838,Marez; Curtis F.,21,0,23,2
1731503361912,ETHN 101TV,A02,744842,Marez; Curtis F.,23,0,23,0
1731503361912,ETHN 101TV,A03,796142,Marez; Curtis F.,23,0,23,0
1731503361912,ETHN 101TV,A04,796143,Marez; Curtis F.,22,0,23,1
1731503362942,ETHN 102,A00,744846,Okonkwo; Holly,38,0,40,2
1731503363971,ETHN 112B,A00,744847,Klann; Mary Cameron,22,0,30,8
1731503365003,ETHN 119,A00,744849,Fuste; Jose Ignacio,31,0,35,4
1731503366034,ETHN 122,A00,744853,Tran; Ly Thi Hai,32,0,35,3
1731503367063,ETHN 125R,A00,744875,Sasaki; Christen T,31,0,50,19
1731503368091,ETHN 133,A00,744880,Power; Jade Yukana,3,0,5,2
1731503369119,ETHN 134,A00,744905,Gosin; Monika N.,19,0,20,1
1731503370148,ETHN 137,A00,744906,Martin Sandino; Amanda Maria Yoland,19,0,20,1
1731503371180,ETHN 138,A00,744907,Gosin; Monika N.,35,0,35,0
1731503372209,ETHN 139,A00,744908,Ruiz; Ariana,20,0,20,0
1731503373242,ETHN 143,A00,744909,Marez; Curtis F.,29,0,30,1
1731503374269,ETHN 163F,A00,744911,Burelle; Julie Sara Veronique,15,0,15,0
1731503375296,ETHN 165,A00,744912,Browne; Errol Tsekani,11,0,15,4
1731503376322,ETHN 167A,A00,744913,Patel; Shaista,11,0,12,1
1731503377407,ETHN 174,A00,744915,Childs; Dennis R.,20,0,20,0
1731503378433,ETHN 179,A00,744916,Dresser; Mark Stuart,24,0,25,1
1731503379464,ETHN 187,A00,744917,Cuong; Marisol,15,0,15,0
1731503380491,ETHN 200B,A00,744918,Patel; Shaista,11,0,15,4
1731503381520,ETHN 230,A00,744919,Perreira; Christopher Michael,10,0,15,5
1731503382546,ETHN 268,A00,744920,Fuste; Jose Ignacio,4,0,10,6
1731503383576,ETIM 289,A00,744923,Sasaki; Christen T,11,0,15,4
1731503384603,EXPR 100,A00,794937,Staff,9999,0,9999,0
1731503385629,EXPR 105,A00,794941,Staff,9999,0,9999,0
1731503386657,EXPR 201,A00,794944,Staff,9999,0,9999,0
1731503387683,EXPR 205,A00,794948,Staff,9999,0,9999,0
1731503388713,FILM 87,A00,745666,Rahimi; Babak,20,0,20,0
1731503388713,FILM 87,B00,745671,Rahimi; Babak,19,0,20,1
1731503388713,FILM 87,C00,745673,Adler; Steven,20,0,20,0
1731503389749,FMPH 277,A00,745558,Gilmer; Todd,9,0,15,6
1731503390777,FMPH 291,A00,745561,Silverstein; Donna K & Wynn; Adriane Michelle,9,0,15,6
1731503391804,FPM 278,A00,745585,Strong; David R,10,0,15,5
1731503392832,FPM 286,A00,791598,Johnson; Michelle Lee,120,0,120,0
1731503393865,FPM 288,A00,799968,Hurst; Samantha,4,0,5,1
1731503394893,FPM 296,001,791599,Allison; Matthew,8,0,10,2
1731503394893,FPM 296,002,791600,Staff,10,0,10,0
1731503394893,FPM 296,003,791601,Staff,10,0,10,0
1731503395918,FPM 297,001,745665,Strong; David R,99,0,99,0
1731503396945,GLBH 20,A00,745680,Walkover; Lillian B,146,0,146,0
1731503397972,GLBH 100,A00,745702,Staff,40,0,40,0
1731503397972,GLBH 100,B00,745703,Schonberg; Jeffrey,40,0,40,0
1731503398999,GLBH 109,A00,745704,Olivas Hernandez; Olga Lid,47,0,48,1
1731503400027,GLBH 111,A01,745712,Burgos; Jose L.,0,0,0,0
1731503400027,GLBH 111,B01,745771,Burgos; Jose L.,0,0,0,0
1731503401056,GLBH 113,A00,745821,Wilson; Brenda K,63,0,70,7
1731503402084,GLBH 139,A00,745834,Csordas; Thomas J.,19,0,20,1
1731503403116,GLBH 141,A00,745835,Sanghvi; Reema I,6,0,11,5
1731503404142,GLBH 146,A00,745836,Kang; Byung Chu,68,0,70,2
1731503405170,GLBH 148,A00,745837,Schonberg; Jeffrey,90,0,100,10
1731503406198,GLBH 150,A00,745838,Sloane; Julia Kathryn,35,0,35,0
1731503407223,GLBH 150A,A00,745839,Kaiser; Bronwyn Nicole,0,0,0,0
1731503408248,GLBH 160,A00,745840,Mackey; Timothy Ken,61,0,68,7
1731503409280,GLBH 171R,A00,745841,Jenkins; Janis A.,17,0,25,8
1731503409280,GLBH 171R,B00,795776,Jenkins; Janis A.,15,0,15,0
1731503410306,GLBH 181,A00,745842,Burgos; Jose L.,213,0,216,3
1731503411332,GLBH 214,A00,745843,Bhavsar; Radhika,4,0,19,15
1731503412361,GLBH 241,A00,745877,Sanghvi; Reema I,7,0,21,14
1731503413391,GLBH 249,A00,745948,Villarino; Margarita,5,0,20,15
1731503414422,GPEC 244,A00,765594,Levy; Morgan,20,0,20,0
1731503415453,GSS 22,A00,746032,Kokinis; Troy Andreas,26,0,30,4
1731503416478,GSS 27,A00,746039,Siapno; Jacqueline A,27,0,30,3
1731503417519,HDS 60,A01,747848,Warstadt; Melissa Fawn,34,0,35,1
1731503417519,HDS 60,A02,747849,Warstadt; Melissa Fawn,34,0,35,1
1731503418548,HDS 95,A00,747852,Staff,31,0,35,4
1731503419574,HDS 110,A00,747853,Wilder; Linnea Lorene,93,0,100,7
1731503420605,HDS 133,A00,747854,Stewart; Alexander B,86,0,100,14
1731503421637,HDS 150,A00,747856,Warstadt; Melissa Fawn,20,0,20,0
1731503422663,HDS 175,A00,747859,Bjorklund; Peter,35,0,35,0
1731503423689,HDS 181,A01,747863,Delgado; Tania,30,0,30,0
1731503424721,HDS 191,A01,747865,Reese; Clarissa Jane,20,0,20,0
1731503424721,HDS 191,B01,747867,Reese; Clarissa Jane,20,0,20,0
1731503425752,HIAF 113,A00,747574,Prestholdt; Jeremy,74,0,75,1
1731503426779,HIAF 114,A00,747576,Gyamfi; Bright,55,0,56,1
1731503427809,HIEA 140R,A00,747577,Gerth; Karl G.,23,0,30,7
1731503428840,HIEA 150,A00,747578,Henry; Todd A.,54,0,56,2
1731503429866,HIEU 103,A00,747579,Watts; Edward J.,108,0,115,7
1731503430899,HIEU 116B,A00,795104,Gallant; Thomas W.,50,0,50,0
1731503431929,HIEU 123,A00,747580,Demetriou; Denise,47,0,50,3
1731503432956,HIEU 147,A00,747616,Biess; Frank Peter,96,0,100,4
1731503433984,HIEU 149,A00,747617,Devereux; Andrew W,49,0,50,1
1731503435011,HIGR 203,A00,747836,Edington; Claire Ellen,4,0,5,1
1731503436036,HIGR 215B,A00,747837,Muscolino; Micah S,10,0,10,0
1731503437063,HIGR 217B,A00,747838,Schneewind; Sarah,15,0,15,0
1731503438089,HIGR 240,A00,747842,McKenzie; Kerry V.,4,0,5,1
1731503439119,HIGR 241,A00,747843,Lampland; Martha,5,0,5,0
1731503440151,HILA 100,A00,747621,Murillo; Dana V.,50,0,50,0
1731503441177,HILA 102,A00,747623,Cowan; Benjamin A,55,0,56,1
1731503442203,HILA 121B,A00,747633,Cowan; Benjamin A,56,0,56,0
1731503443232,HILA 167,A00,794866,Murillo; Dana V.,0,0,0,0
1731503444262,HILA 267,A00,794867,Murillo; Dana V.,12,0,15,3
1731503445301,HILD 2B,A01,746966,Plant; Rebecca Jo,27,0,32,5
1731503445301,HILD 2B,A02,746988,Plant; Rebecca Jo,30,0,32,2
1731503445301,HILD 2B,A03,747023,Plant; Rebecca Jo,32,0,32,0
1731503445301,HILD 2B,A04,747029,Plant; Rebecca Jo,32,0,32,0
1731503445301,HILD 2B,A05,747030,Plant; Rebecca Jo,31,0,32,1
1731503445301,HILD 2B,A06,747031,Plant; Rebecca Jo,32,0,32,0
1731503446337,HILD 7A,A01,747252,Graham; Jessica Lynn,30,0,32,2
1731503446337,HILD 7A,A02,747337,Graham; Jessica Lynn,30,0,32,2
1731503446337,HILD 7A,A03,747338,Graham; Jessica Lynn,32,0,32,0
1731503446337,HILD 7A,A04,747352,Graham; Jessica Lynn,30,0,32,2
1731503446337,HILD 7A,A05,747375,Graham; Jessica Lynn,30,0,32,2
1731503446337,HILD 7A,A06,747385,Graham; Jessica Lynn,29,0,32,3
1731503446337,HILD 7A,A07,747442,Graham; Jessica Lynn,32,0,32,0
1731503446337,HILD 7A,A08,747444,Graham; Jessica Lynn,32,0,32,0
1731503446337,HILD 7A,A09,747447,Graham; Jessica Lynn,32,0,32,0
1731503446337,HILD 7A,A10,747449,Graham; Jessica Lynn,32,0,32,0
1731503446337,HILD 7A,A11,747450,Graham; Jessica Lynn,32,0,32,0
1731503446337,HILD 7A,A12,747487,Graham; Jessica Lynn,32,0,32,0
1731503447368,HILD 11,A01,747512,Lu; Weijing,30,0,32,2
1731503447368,HILD 11,A02,747513,Lu; Weijing,32,0,32,0
1731503447368,HILD 11,A03,747538,Lu; Weijing,32,0,32,0
1731503447368,HILD 11,A04,747546,Lu; Weijing,32,0,32,0
1731503447368,HILD 11,A05,747558,Lu; Weijing,32,0,32,0
1731503447368,HILD 11,A06,747559,Lu; Weijing,32,0,32,0
1731503448400,HILD 41,A01,747562,Devereux; Andrew W,32,0,32,0
1731503448400,HILD 41,A02,747563,Devereux; Andrew W,32,0,32,0
1731503449425,HINE 109,A00,799584,Staff,0,0,0,0
1731503450451,HINE 118,A00,799585,Staff,0,0,0,0
1731503451479,HINE 125,A00,747822,Balberg; Mira,48,0,50,2
1731503452507,HINE 186,A00,794522,Hertz; Deborah & Kayali; Hasan,15,0,15,0
1731503453533,HISA 144,A00,794454,De; Aniket,48,0,50,2
1731503454559,HISC 109,A00,747823,Edington; Claire Ellen,44,0,50,6
1731503455587,HISC 115,A00,747824,Gere; Catherina M.,118,0,120,2
1731503456614,HISC 180,A00,747825,Golan; Tal,15,0,15,0
1731503457644,HITO 87,A00,747567,Hanna; Mark G.,15,0,15,0
1731503457644,HITO 87,B00,747569,Patterson; Patrick H.,14,0,15,1
1731503457644,HITO 87,C00,747570,Patterson; Patrick H.,15,0,15,0
1731503457644,HITO 87,D00,747571,Edington; Claire Ellen,14,0,15,1
1731503457644,HITO 87,E00,747573,Schneewind; Sarah,15,0,15,0
1731503458670,HITO 100,B00,747827,Strasser; Ulrike,20,0,22,2
1731503459696,HITO 133,A00,747828,Hansen; Jan Eric,54,0,56,2
1731503460726,HITO 178,A00,747829,Hanna; Mark G.,19,0,20,1
1731503461757,HITO 193,A00,770732,Hill; Seth J,9999,0,9999,0
1731503462790,HIUS 108B,A00,794492,Daly; Heather Marie,34,0,40,6
1731503463819,HIUS 133,A00,747831,Hanna; Mark G.,136,0,146,10
1731503464850,HIUS 146,A00,747834,Alvarez; Luis A,48,0,50,2
1731503465882,HIUS 152B,A00,794678,Daly; Heather Marie,36,0,40,4
1731503466910,HIUS 180,A00,747835,Gosin; Monika N.,20,0,20,0
1731503467953,HUM 1,A01,767622,Demetriou; Denise,15,0,15,0
1731503467953,HUM 1,A02,767623,Demetriou; Denise,14,0,15,1
1731503467953,HUM 1,A03,767624,Demetriou; Denise,12,0,15,3
1731503467953,HUM 1,A04,767625,Demetriou; Denise,11,0,15,4
1731503467953,HUM 1,A05,767626,Demetriou; Denise,12,0,15,3
1731503467953,HUM 1,A06,767627,Demetriou; Denise,15,0,15,0
1731503467953,HUM 1,A07,767628,Demetriou; Denise,15,0,15,0
1731503467953,HUM 1,A08,767629,Demetriou; Denise,15,0,15,0
1731503467953,HUM 1,A09,767687,Demetriou; Denise,14,0,15,1
1731503467953,HUM 1,A10,767695,Demetriou; Denise,14,0,15,1
1731503467953,HUM 1,A11,767696,Demetriou; Denise,15,0,15,0
1731503467953,HUM 1,A12,767698,Demetriou; Denise,15,0,15,0
1731503467953,HUM 1,B01,767771,West; Geoffrey Scott,14,0,15,1
1731503467953,HUM 1,B02,767815,West; Geoffrey Scott,14,0,15,1
1731503467953,HUM 1,B03,767837,West; Geoffrey Scott,14,0,15,1
1731503467953,HUM 1,B04,767843,West; Geoffrey Scott,13,0,15,2
1731503467953,HUM 1,B05,767853,West; Geoffrey Scott,15,0,15,0
1731503467953,HUM 1,B06,767861,West; Geoffrey Scott,15,0,15,0
1731503467953,HUM 1,B07,767884,West; Geoffrey Scott,15,0,15,0
1731503467953,HUM 1,B08,767903,West; Geoffrey Scott,15,0,15,0
1731503467953,HUM 1,B09,767945,West; Geoffrey Scott,15,0,15,0
1731503467953,HUM 1,B10,767986,West; Geoffrey Scott,15,0,15,0
1731503467953,HUM 1,B11,768004,West; Geoffrey Scott,14,0,15,1
1731503467953,HUM 1,B12,768005,West; Geoffrey Scott,12,0,15,3
1731503467953,HUM 1,B13,768015,West; Geoffrey Scott,15,0,15,0
1731503467953,HUM 1,B14,768019,West; Geoffrey Scott,15,0,15,0
1731503467953,HUM 1,C01,768080,Rodriguez; Bretton Sigfred,0,0,0,0
1731503467953,HUM 1,C02,768081,Rodriguez; Bretton Sigfred,0,0,0,0
1731503467953,HUM 1,C03,768082,Rodriguez; Bretton Sigfred,13,0,15,2
1731503467953,HUM 1,C04,768083,Rodriguez; Bretton Sigfred,13,0,15,2
1731503467953,HUM 1,C05,768084,Rodriguez; Bretton Sigfred,14,0,15,1
1731503467953,HUM 1,C06,768085,Rodriguez; Bretton Sigfred,13,0,15,2
1731503467953,HUM 1,C07,768086,Rodriguez; Bretton Sigfred,15,0,15,0
1731503467953,HUM 1,C08,768087,Rodriguez; Bretton Sigfred,15,0,15,0
1731503467953,HUM 1,C09,768088,Rodriguez; Bretton Sigfred,15,0,15,0
1731503467953,HUM 1,C10,768089,Rodriguez; Bretton Sigfred,15,0,15,0
1731503467953,HUM 1,C11,768090,Rodriguez; Bretton Sigfred,13,0,15,2
1731503467953,HUM 1,C12,768091,Rodriguez; Bretton Sigfred,15,0,15,0
1731503467953,HUM 1,C13,768157,Rodriguez; Bretton Sigfred,14,0,15,1
1731503467953,HUM 1,C14,768158,Rodriguez; Bretton Sigfred,14,0,15,1
1731503468991,HUM 2,A01,768160,Lyon; Antony J.,13,0,15,2
1731503468991,HUM 2,A02,768165,Lyon; Antony J.,13,0,15,2
1731503468991,HUM 2,A03,768166,Lyon; Antony J.,0,0,0,0
1731503468991,HUM 2,A04,768167,Lyon; Antony J.,0,0,0,0
1731503468991,HUM 2,A05,768169,Lyon; Antony J.,14,0,15,1
1731503468991,HUM 2,A06,768193,Lyon; Antony J.,15,0,15,0
1731503468991,HUM 2,A07,768200,Lyon; Antony J.,14,0,15,1
1731503468991,HUM 2,A08,768260,Lyon; Antony J.,15,0,15,0
1731503468991,HUM 2,A09,768299,Lyon; Antony J.,13,0,15,2
1731503468991,HUM 2,A10,768323,Lyon; Antony J.,12,0,15,3
1731503468991,HUM 2,A11,768330,Lyon; Antony J.,15,0,15,0
1731503468991,HUM 2,A12,768338,Lyon; Antony J.,14,0,15,1
1731503468991,HUM 2,A13,768344,Lyon; Antony J.,0,0,0,0
1731503468991,HUM 2,A14,768388,Lyon; Antony J.,0,0,0,0
1731503470033,HUM 4,A01,768408,Watkins; Eric,27,0,28,1
1731503470033,HUM 4,A02,768409,Watkins; Eric,26,0,28,2
1731503470033,HUM 4,A03,768410,Watkins; Eric,27,0,28,1
1731503470033,HUM 4,A04,768411,Watkins; Eric,28,0,28,0
1731503470033,HUM 4,A05,768412,Watkins; Eric,27,0,28,1
1731503470033,HUM 4,A06,768413,Watkins; Eric,27,0,28,1
1731503470033,HUM 4,B01,768415,Caldwell; Michael Alan,20,0,28,8
1731503470033,HUM 4,B02,768416,Caldwell; Michael Alan,27,0,28,1
1731503470033,HUM 4,B03,768417,Caldwell; Michael Alan,21,0,28,7
1731503470033,HUM 4,B04,768418,Caldwell; Michael Alan,26,0,28,2
1731503470033,HUM 4,B05,768419,Caldwell; Michael Alan,28,0,28,0
1731503470033,HUM 4,B06,768420,Caldwell; Michael Alan,27,0,28,1
1731503470033,HUM 4,B07,768421,Caldwell; Michael Alan,28,0,28,0
1731503470033,HUM 4,B08,768422,Caldwell; Michael Alan,28,0,28,0
1731503470033,HUM 4,C01,768424,Markman; Kristina,27,0,28,1
1731503470033,HUM 4,C02,768425,Markman; Kristina,23,0,28,5
1731503470033,HUM 4,C03,768426,Markman; Kristina,24,0,28,4
1731503470033,HUM 4,C04,768427,Markman; Kristina,23,0,28,5
1731503470033,HUM 4,C05,768428,Markman; Kristina,24,0,28,4
1731503470033,HUM 4,C06,768429,Markman; Kristina,26,0,28,2
1731503470033,HUM 4,C07,768430,Markman; Kristina,25,0,28,3
1731503470033,HUM 4,C08,768431,Markman; Kristina,26,0,28,2
1731503471072,HUM 100,001,768432,Zavodny; Tatiana Sophia,18,0,18,0
1731503471072,HUM 100,002,768433,Zavodny; Tatiana Sophia,17,0,18,1
1731503471072,HUM 100,003,768434,Zavodny; Tatiana Sophia,17,0,18,1
1731503471072,HUM 100,004,768435,West; Geoffrey Scott,18,0,18,0
1731503471072,HUM 100,005,768436,Crum; Matthew Stephen,18,0,18,0
1731503471072,HUM 100,006,768437,Crum; Matthew Stephen,17,0,18,1
1731503471072,HUM 100,007,768438,Crum; Matthew Stephen,18,0,18,0
1731503471072,HUM 100,008,768439,Shenoy; Niyati,17,0,18,1
1731503471072,HUM 100,009,768440,Shenoy; Niyati,18,0,18,0
1731503471072,HUM 100,010,768441,Shenoy; Niyati,18,0,18,0
1731503472099,INTL 100,A01,747870,Feuer; Anna Stagg,23,0,25,2
1731503472099,INTL 100,A02,747872,Feuer; Anna Stagg,24,0,25,1
1731503472099,INTL 100,A03,747874,Feuer; Anna Stagg,22,0,25,3
1731503472099,INTL 100,A04,747881,Feuer; Anna Stagg,25,0,25,0
1731503472099,INTL 100,A05,747891,Feuer; Anna Stagg,22,0,25,3
1731503472099,INTL 100,A06,747893,Feuer; Anna Stagg,25,0,25,0
1731503473126,INTL 101,A01,747898,McIntosh; Justin Daniel,30,0,35,5
1731503473126,INTL 101,A02,747900,McIntosh; Justin Daniel,27,0,35,8
1731503474158,INTL 102,A01,747903,Broz; James Lawrence,28,0,35,7
1731503474158,INTL 102,A02,747909,Broz; James Lawrence,33,0,35,2
1731503475191,INTL 190,A00,747910,Appel; Benjamin Jay,0,0,0,0
1731503475191,INTL 190,B00,747912,Feeley; Maureen Catherine,0,0,0,2
1731503475191,INTL 190,C00,747914,Fortier; Jana,0,0,0,2
1731503475191,INTL 190,D00,747915,Lettieri; Michael Joseph,0,0,0,0
1731503476310,JAPN 10B,A01,747919,Maruyama; Rie,20,0,20,0
1731503476310,JAPN 10B,B01,747925,Sato; Kyoko,20,0,20,0
1731503476310,JAPN 10B,C01,747929,Ross; Kayoko F,17,0,20,3
1731503476310,JAPN 10B,D01,747932,McKee; Mayumi Mochizuki,22,0,25,3
1731503476310,JAPN 10B,E01,747936,Kamioka; Sachiko,21,0,25,4
1731503476310,JAPN 10B,F01,747941,Inada; Minori,23,0,25,2
1731503476310,JAPN 10B,G01,747944,Tipton; Yuko,25,0,25,0
1731503476310,JAPN 10B,H01,747951,Homma; Kunihiko,22,0,25,3
1731503476310,JAPN 10B,I01,747955,Maruyama; Rie,23,0,25,2
1731503476310,JAPN 10B,J01,747960,Tipton; Yuko,21,0,25,4
1731503476310,JAPN 10B,K01,747965,Sato; Kyoko,24,0,25,1
1731503476310,JAPN 10B,L01,747968,Ross; Kayoko F,25,0,25,0
1731503476310,JAPN 10B,M01,747971,Homma; Kunihiko,18,0,20,2
1731503477348,JAPN 10BR,A01,747974,Inada; Minori,20,0,20,0
1731503477348,JAPN 10BR,B01,747978,McKee; Mayumi Mochizuki,19,0,20,1
1731503477348,JAPN 10BR,C01,796045,Inada; Minori,4,0,4,0
1731503477348,JAPN 10BR,D01,796047,McKee; Mayumi Mochizuki,4,0,4,0
1731503478381,JAPN 20B,A01,747981,Takeda; Izumi,20,0,20,0
1731503478381,JAPN 20B,B01,747984,Homma; Kunihiko,16,0,20,4
1731503478381,JAPN 20B,C01,747988,Iwamoto; Naoki,18,0,20,2
1731503478381,JAPN 20B,D01,747991,Simpson; Junko Tokuda,20,0,20,0
1731503478381,JAPN 20B,E01,747993,Takeda; Izumi,20,0,20,0
1731503479411,JAPN 130B,A01,747998,Maruyama; Rie,19,0,20,1
1731503479411,JAPN 130B,B01,748001,Kamioka; Sachiko,19,0,20,1
1731503480439,JAPN 135B,A00,748002,Ross; Kayoko F,18,0,20,2
1731503480439,JAPN 135B,B00,748003,Iwamoto; Naoki,18,0,20,2
1731503481542,JAPN 137B,A00,748004,Simpson; Junko Tokuda,16,0,20,4
1731503482569,JAPN 140B,A00,748005,Takeda; Izumi,14,0,15,1
1731503483598,JAPN 150A,A00,748009,Sato; Kyoko,14,0,15,1
1731503484627,JAPN 190,A00,748010,Turner; Christena L.,19,0,20,1
1731503485655,JWSP 2,A01,748014,Shuster; Alana,14,0,15,1
1731503486684,LATI 10,A01,748018,Kennemore; Amy Michelle,27,0,30,3
1731503486684,LATI 10,A02,748020,Kennemore; Amy Michelle,30,0,30,0
1731503486684,LATI 10,A03,748021,Kennemore; Amy Michelle,28,0,30,2
1731503486684,LATI 10,A04,748023,Kennemore; Amy Michelle,28,0,30,2
1731503486684,LATI 10,A05,748025,Kennemore; Amy Michelle,30,0,30,0
1731503487711,LATI 50,A01,794604,Kokinis; Troy Andreas,28,0,30,2
1731503487711,LATI 50,A02,794839,Kokinis; Troy Andreas,29,0,30,1
1731503487711,LATI 50,A03,794840,Kokinis; Troy Andreas,30,0,30,0
1731503487711,LATI 50,A04,794841,Kokinis; Troy Andreas,27,0,30,3
1731503488738,LATI 140,A01,748028,Kokinis; Troy Andreas,30,0,30,0
1731503489766,LATI 170,A00,796289,Kennemore; Amy Michelle,28,0,30,2
1731503490792,LATI 180,B00,748041,Vasquez Cortes; Mateo,29,0,30,1
1731503491821,LATI 190,A00,748043,Carvajal Regidor; Jose,30,0,30,0
1731503492851,LAWS 101,A00,748047,Golan; Tal,48,0,60,12
1731503493879,LIAB 1B,A00,748070,Saab; Dima,12,0,14,2
1731503493879,LIAB 1B,B00,748075,Saab; Dima,11,0,14,3
1731503494917,LIAB 1BX,A00,748076,El Cheddadi; Youniss,24,0,28,4
1731503495943,LIAB 1E,A00,748082,El Cheddadi; Youniss,14,0,14,0
1731503496971,LIFR 1B,A00,748098,Van Moer; Vinciane G,12,0,14,2
1731503496971,LIFR 1B,B00,748099,Van Moer; Vinciane G,12,0,14,2
1731503496971,LIFR 1B,C00,748341,Van Moer; Vinciane G,12,0,14,2
1731503497999,LIFR 1BX,A00,748356,Van Moer; Vinciane G,21,0,21,0
1731503497999,LIFR 1BX,B00,748357,Van Moer; Vinciane G,15,0,21,6
1731503499025,LIFR 1C,A00,748361,Van Moer; Vinciane G,13,0,14,1
1731503499025,LIFR 1C,B00,748362,Van Moer; Vinciane G,10,0,14,4
1731503499025,LIFR 1C,C00,748363,Van Moer; Vinciane G,13,0,14,1
1731503500057,LIFR 1CX,A00,748366,Van Moer; Vinciane G,20,0,21,1
1731503500057,LIFR 1CX,B00,748367,Van Moer; Vinciane G,19,0,21,2
1731503501084,LIFR 11,A00,748368,Goodall; Grant Todd,9999,0,9999,0
1731503502115,LIGM 1B,A00,748371,Fischer-Grunski; Eva K,12,0,14,2
1731503502115,LIGM 1B,B00,748372,Fischer-Grunski; Eva K,12,0,14,2
1731503502115,LIGM 1B,C00,748374,Fischer-Grunski; Eva K,13,0,14,1
1731503503149,LIGM 1BX,A00,748376,Fischer-Grunski; Eva K,19,0,21,2
1731503503149,LIGM 1BX,B00,748378,Fischer-Grunski; Eva K,20,0,21,1
1731503504175,LIGM 11,A00,748379,Goodall; Grant Todd,9999,0,9999,0
1731503505209,LIGN 8,A00,748997,McIntosh; Justin Daniel,245,0,250,5
1731503506238,LIGN 17,A00,749008,Kehler; Andrew Scott,247,0,250,3
1731503507266,LIGN 101,A01,749010,Staff,27,0,29,2
1731503507266,LIGN 101,A02,749011,Staff,29,0,29,0
1731503507266,LIGN 101,A03,749149,Staff,27,0,29,2
1731503507266,LIGN 101,A04,749176,Staff,29,0,29,0
1731503507266,LIGN 101,A05,749186,Staff,29,0,30,1
1731503508294,LIGN 111,A01,749192,Bakovic; Eric John,29,0,30,1
1731503508294,LIGN 111,A02,749193,Bakovic; Eric John,27,0,30,3
1731503508294,LIGN 111,A03,749194,Bakovic; Eric John,24,0,30,6
1731503509325,LIGN 112,A00,749205,Garellek; Marc,69,0,70,1
1731503510354,LIGN 121,A01,749209,Rodriguez Aispuro; Alejandro,20,0,25,5
1731503510354,LIGN 121,A02,749211,Rodriguez Aispuro; Alejandro,24,0,25,1
1731503510354,LIGN 121,A03,749214,Rodriguez Aispuro; Alejandro,24,0,25,1
1731503511384,LIGN 148,A00,749215,Mayberry; Rachel,72,0,75,3
1731503512411,LIGN 150,A00,749218,Garellek; Marc,42,0,50,8
1731503513443,LIGN 172,A01,794611,Dudley; Rachel,30,0,30,0
1731503514470,LIGN 178,A00,749223,Munoz Sanchez; Alicia,69,0,70,1
1731503515497,LIGN 187,A00,749226,Staff,30,0,30,0
1731503515497,LIGN 187,B00,749227,Warstadt; Alexander Scott,30,0,30,0
1731503516522,LIGN 188R,A00,749228,Clem; Emily,40,0,40,0
1731503517547,LIGN 214,A00,749229,Styler; William Francis,29,0,30,1
1731503518576,LIGN 225,A00,749230,Clem; Emily,30,0,30,0
1731503519601,LIGN 251,A00,749287,Bergen; Leon,28,0,30,2
1731503520636,LIGN 296,001,774625,Ackerman; Farrell,10,0,10,0
1731503520636,LIGN 296,002,774626,Bakovic; Eric John,10,0,10,0
1731503520636,LIGN 296,003,774627,Bergen; Leon,10,0,10,0
1731503520636,LIGN 296,004,774638,Caballero; Gabriela Hernandez,10,0,10,0
1731503520636,LIGN 296,005,774639,Caponigro; Ivano,10,0,10,0
1731503520636,LIGN 296,006,774683,Clem; Emily,10,0,10,0
1731503520636,LIGN 296,007,774684,Dudley; Rachel,10,0,10,0
1731503520636,LIGN 296,008,774685,Garellek; Marc,10,0,10,0
1731503520636,LIGN 296,009,774691,Goodall; Grant Todd,10,0,10,0
1731503520636,LIGN 296,010,774692,Kehler; Andrew Scott,10,0,10,0
1731503520636,LIGN 296,011,774694,Kluender; Robert,10,0,10,0
1731503520636,LIGN 296,012,774697,Rose; Sharon,10,0,10,0
1731503520636,LIGN 296,013,774700,Styler; William Francis,10,0,10,0
1731503520636,LIGN 296,014,774820,Caponigro; Ivano,10,0,10,0
1731503521662,LIHL 112W,A00,748052,Pagkalinawan; Leticia Cant,27,0,28,1
1731503522694,LIHL 114W,A00,748054,Nguyen; Hoan Thi,25,0,28,3
1731503523725,LIHL 117W,A00,748057,Sadegholvad; Elham,28,0,28,0
1731503524754,LIHL 118,A00,748059,Chen; Areana Yen,28,0,28,0
1731503525783,LIHL 124W,A00,748061,Nguyen; Hoan Thi,26,0,28,2
1731503526809,LIHL 132W,A00,748062,Pagkalinawan; Leticia Cant,28,0,28,0
1731503527839,LIHL 134W,A00,748064,Nguyen; Hoan Thi,28,0,28,0
1731503528865,LIHL 138,A00,748068,Chen; Areana Yen,28,0,28,0
1731503529895,LIIT 1B,A00,748409,Carnelos; Chiara,13,0,14,1
1731503529895,LIIT 1B,B00,748418,Carnelos; Chiara,12,0,14,2
1731503529895,LIIT 1B,C00,748424,Carnelos; Chiara,12,0,14,2
1731503530921,LIIT 1BX,A00,748428,Carnelos; Chiara,21,0,21,0
1731503530921,LIIT 1BX,B00,748430,Carnelos; Chiara,17,0,21,4
1731503531951,LIPO 1B,A00,748436,Paladini; Denise,12,0,14,2
1731503531951,LIPO 1B,B00,748437,Paladini; Denise,0,0,0,0
1731503532977,LIPO 1BX,A00,748438,De Abreu; Cassia,27,0,28,1
1731503534004,LIPO 17,A00,798404,Paladini; Denise,0,0,0,0
1731503535036,LISL 1B,A00,748478,Lott; Margaret S.,14,0,14,0
1731503535036,LISL 1B,B00,748482,Lott; Margaret S.,14,0,14,0
1731503535036,LISL 1B,C00,748484,Lott; Margaret S.,13,0,14,1
1731503535036,LISL 1B,D00,748485,Lott; Margaret S.,12,0,14,2
1731503535036,LISL 1B,E00,748487,Lott; Margaret S.,14,0,14,0
1731503535036,LISL 1B,F00,748490,Lott; Margaret S.,12,0,14,2
1731503535036,LISL 1B,G00,748491,Lott; Margaret S.,13,0,14,1
1731503535036,LISL 1B,H00,748492,Lott; Margaret S.,14,0,14,0
1731503536064,LISL 1BX,A00,748594,Lott; Margaret S.,28,0,28,0
1731503536064,LISL 1BX,B00,748595,Lott; Margaret S.,27,0,28,1
1731503536064,LISL 1BX,C00,748596,Lott; Margaret S.,25,0,28,3
1731503536064,LISL 1BX,D00,748597,Lott; Margaret S.,27,0,28,1
1731503537093,LISL 1C,A00,748614,Lott; Margaret S.,11,0,14,3
1731503537093,LISL 1C,B00,748616,Lott; Margaret S.,13,0,14,1
1731503537093,LISL 1C,C00,748678,Lott; Margaret S.,11,0,14,3
1731503537093,LISL 1C,D00,748686,Lott; Margaret S.,14,0,14,0
1731503538118,LISL 1CX,A00,748698,Lott; Margaret S.,21,0,28,7
1731503538118,LISL 1CX,B00,748699,Lott; Margaret S.,25,0,28,3
1731503539147,LISL 1E,A00,748700,Lott; Margaret S.,11,0,14,3
1731503540177,LISP 1B,A00,748737,Munoz Sanchez; Alicia,12,0,14,2
1731503540177,LISP 1B,B00,748755,Munoz Sanchez; Alicia,14,0,14,0
1731503540177,LISP 1B,C00,748761,Munoz Sanchez; Alicia,14,0,14,0
1731503540177,LISP 1B,D00,748763,Munoz Sanchez; Alicia,12,0,14,2
1731503540177,LISP 1B,E00,748764,Munoz Sanchez; Alicia,14,0,14,0
1731503540177,LISP 1B,F00,748790,Munoz Sanchez; Alicia,11,0,14,3
1731503540177,LISP 1B,G00,748791,Munoz Sanchez; Alicia,14,0,14,0
1731503540177,LISP 1B,H00,748792,Munoz Sanchez; Alicia,9,0,14,5
1731503540177,LISP 1B,I00,748793,Munoz Sanchez; Alicia,12,0,14,2
1731503540177,LISP 1B,J00,748794,Munoz Sanchez; Alicia,11,0,14,3
1731503541208,LISP 1BX,A00,748795,Munoz Sanchez; Alicia,26,0,28,2
1731503541208,LISP 1BX,B00,748796,Munoz Sanchez; Alicia,25,0,28,3
1731503541208,LISP 1BX,C00,748797,Munoz Sanchez; Alicia,26,0,28,2
1731503541208,LISP 1BX,D00,748798,Munoz Sanchez; Alicia,25,0,28,3
1731503541208,LISP 1BX,E00,748799,Munoz Sanchez; Alicia,24,0,28,4
1731503542239,LISP 1C,001,748834,Munoz Sanchez; Alicia,13,0,14,1
1731503542239,LISP 1C,002,748835,Munoz Sanchez; Alicia,14,0,14,0
1731503542239,LISP 1C,003,748847,Munoz Sanchez; Alicia,13,0,14,1
1731503542239,LISP 1C,004,748848,Munoz Sanchez; Alicia,13,0,14,1
1731503542239,LISP 1C,005,748863,Munoz Sanchez; Alicia,13,0,14,1
1731503542239,LISP 1C,006,748866,Munoz Sanchez; Alicia,13,0,14,1
1731503542239,LISP 1C,007,748867,Munoz Sanchez; Alicia,12,0,14,2
1731503542239,LISP 1C,008,748868,Munoz Sanchez; Alicia,14,0,14,0
1731503542239,LISP 1C,009,748869,Munoz Sanchez; Alicia,14,0,14,0
1731503542239,LISP 1C,010,748870,Munoz Sanchez; Alicia,13,0,14,1
1731503542239,LISP 1C,011,748871,Munoz Sanchez; Alicia,12,0,14,2
1731503542239,LISP 1C,012,748872,Munoz Sanchez; Alicia,12,0,14,2
1731503542239,LISP 1C,013,748873,Munoz Sanchez; Alicia,12,0,14,2
1731503542239,LISP 1C,014,748879,Munoz Sanchez; Alicia,13,0,14,1
1731503542239,LISP 1C,015,748895,Munoz Sanchez; Alicia,12,0,14,2
1731503542239,LISP 1C,016,748896,Munoz Sanchez; Alicia,14,0,14,0
1731503542239,LISP 1C,017,748901,Munoz Sanchez; Alicia,14,0,14,0
1731503542239,LISP 1C,018,748902,Munoz Sanchez; Alicia,13,0,14,1
1731503542239,LISP 1C,020,748904,Munoz Sanchez; Alicia,14,0,14,0
1731503543268,LISP 1CX,B00,748913,Munoz Sanchez; Alicia,27,0,30,3
1731503543268,LISP 1CX,C00,748914,Munoz Sanchez; Alicia,26,0,30,4
1731503543268,LISP 1CX,D00,748926,Munoz Sanchez; Alicia,27,0,30,3
1731503543268,LISP 1CX,E00,748937,Munoz Sanchez; Alicia,30,0,30,0
1731503543268,LISP 1CX,F00,748938,Munoz Sanchez; Alicia,27,0,30,3
1731503543268,LISP 1CX,G00,748950,Munoz Sanchez; Alicia,28,0,30,2
1731503543268,LISP 1CX,H00,748951,Munoz Sanchez; Alicia,28,0,30,2
1731503543268,LISP 1CX,I00,748956,Munoz Sanchez; Alicia,30,0,30,0
1731503543268,LISP 1CX,J00,748957,Munoz Sanchez; Alicia,29,0,30,1
1731503544293,LISP 16,A00,748994,Munoz Sanchez; Alicia,20,0,22,2
1731503544293,LISP 16,B00,748995,Munoz Sanchez; Alicia,21,0,22,1
1731503545320,LISP 18,A00,748996,Munoz Sanchez; Alicia,21,0,22,1
1731503546346,LTAM 105,A00,749877,Ruiz; Ariana,35,0,40,5
1731503547379,LTAM 110,A00,749882,Chacon; Gloria Elizabeth,40,0,40,0
1731503548407,LTAM 120,A00,749915,Martin-Cabrera; Luis,39,0,40,1
1731503549437,LTCO 281,A00,750740,Mukherjee; Silpa,15,0,15,0
1731503550467,LTCO 282,A00,750741,Cohen; Alain J. J.,12,0,15,3
1731503551493,LTCS 11,A00,749294,Lampert-Weissig; Lisa,39,0,40,1
1731503552520,LTCS 87,A00,795238,Nguyen; Hoang Tan,19,0,20,1
1731503552520,LTCS 87,B00,795239,Nguyen; Hoang Tan,20,0,20,0
1731503553549,LTCS 108,A00,749916,Lu; Lillian,19,0,20,1
1731503554577,LTCS 111,A00,749940,Vitkus; Daniel J.,25,0,25,0
1731503555604,LTCS 131,A00,749942,Sanchez Cruz; Jorge,39,0,40,1
1731503556630,LTEA 100A,A00,749944,Liao; Ping H,39,0,40,1
1731503557656,LTEA 132,A00,749945,Mendoza; Andrea,55,0,60,5
1731503558688,LTEA 138,A00,749946,Miyao; Daisuke,347,0,360,13
1731503559716,LTEN 23,A01,749297,Vijay; Ameeth Varma,28,0,28,0
1731503559716,LTEN 23,A02,749321,Vijay; Ameeth Varma,27,0,28,1
1731503559716,LTEN 23,A03,749322,Vijay; Ameeth Varma,28,0,28,0
1731503559716,LTEN 23,A04,749324,Vijay; Ameeth Varma,27,0,28,1
1731503560748,LTEN 26,A01,749326,Wesling; Megan E.,27,0,28,1
1731503560748,LTEN 26,A02,749327,Wesling; Megan E.,26,0,28,2
1731503560748,LTEN 26,A03,749328,Wesling; Megan E.,25,0,28,3
1731503560748,LTEN 26,A04,749329,Wesling; Megan E.,25,0,28,3
1731503561782,LTEN 27,A01,749339,Childs; Dennis R.,27,0,28,1
1731503561782,LTEN 27,A02,749348,Childs; Dennis R.,27,0,28,1
1731503561782,LTEN 27,A03,749360,Childs; Dennis R.,26,0,28,2
1731503561782,LTEN 27,A04,749362,Childs; Dennis R.,27,0,28,1
1731503562813,LTEN 112,A00,749947,Vitkus; Daniel J.,38,0,40,2
1731503563840,LTEN 140,A00,749948,Lu; Lillian,23,0,25,2
1731503564869,LTEN 142,A00,749949,Garofalo; Devin,38,0,40,2
1731503565895,LTEN 180,A00,749950,Ruiz; Ariana,17,0,20,3
1731503566926,LTEN 181,A00,749951,Kim; Joo Ok,36,0,40,4
1731503567951,LTEN 185,A00,749961,Childs; Dennis R.,17,0,20,3
1731503568981,LTEN 189,A00,749962,Vijay; Ameeth Varma,24,0,25,1
1731503570013,LTEN 252,A00,750742,Wesling; Megan E.,12,0,15,3
1731503571043,LTEN 272,A00,750744,Lampert-Weissig; Lisa,11,0,15,4
1731503572070,LTEU 105,A00,749963,De Marchi Gherini; Adriana,28,0,35,7
1731503573102,LTEU 141,A00,749977,Cohen; Alain J. J.,40,0,40,0
1731503574132,LTEU 150C,B00,750299,Morse; Ainsley,30,0,30,0
1731503575160,LTFR 2B,A01,749381,Ploye; Catherine,28,0,28,0
1731503576186,LTFR 2C,A00,749383,Ploye; Catherine,25,0,25,0
1731503577214,LTFR 104,A00,750301,Zhiri; Oumelbanine,25,0,25,0
1731503578245,LTFR 115,A00,750302,Zhiri; Oumelbanine,25,0,25,0
1731503579277,LTGK 2,A00,749384,Murray; Kourtney Kristine,30,0,31,1
1731503580303,LTGK 104,A00,795231,Murray; Kourtney Kristine,25,0,25,0
1731503581335,LTGM 2B,A01,749413,Fischer-Grunski; Eva K,25,0,25,0
1731503582364,LTIT 2B,A01,749459,De Marchi Gherini; Adriana,24,0,25,1
1731503583392,LTIT 115,A00,750314,De Marchi Gherini; Adriana,5,0,5,0
1731503584425,LTKO 1B,A01,749486,Cho; Hye Jin,26,0,28,2
1731503584425,LTKO 1B,B01,749543,Cho; Hye Jin,26,0,28,2
1731503584425,LTKO 1B,C01,749573,Tark; Eun Sun,26,0,28,2
1731503584425,LTKO 1B,D01,749575,Tark; Eun Sun,27,0,28,1
1731503584425,LTKO 1B,E01,749590,Yim; Nancy,28,0,28,0
1731503584425,LTKO 1B,F01,749632,Yim; Nancy,28,0,28,0
1731503585515,LTKO 2B,A01,749700,Lee; Jeyseon,23,0,28,5
1731503586541,LTKO 130W,A00,750479,Lee; Jeyseon,25,0,25,0
1731503587567,LTLA 2,A00,749738,Murray; Kourtney Kristine,44,0,45,1
1731503588597,LTLA 105,A00,750480,Kelting; Edward William,24,0,25,1
1731503589627,LTRU 1B,A01,749758,Wells; Patricia Rebecca,26,0,28,2
1731503590656,LTRU 2B,A01,749788,Wells; Patricia Rebecca,25,0,25,0
1731503591683,LTRU 104C,A01,750482,Wells; Patricia Rebecca,20,0,20,0
1731503592711,LTRU 110C,B00,750484,Morse; Ainsley,10,0,10,0
1731503593738,LTSP 2A,A01,749790,Lampell; Toni,23,0,28,5
1731503594767,LTSP 2B,A01,749855,Mastromartino; Alexandra L,26,0,28,2
1731503594767,LTSP 2B,B01,749857,Mastromartino; Alexandra L,26,0,28,2
1731503595793,LTSP 2C,A01,749859,Lampell; Toni,25,0,28,3
1731503596819,LTSP 2F,A00,749860,Mastromartino; Alexandra L,25,0,25,0
1731503597846,LTSP 3F,A00,749861,Dominguez; Noelia,25,0,25,0
1731503597846,LTSP 3F,B00,749862,Dominguez; Noelia,23,0,25,2
1731503598879,LTSP 100F,A00,750494,Arcos Herrera; Carol,25,0,25,0
1731503598879,LTSP 100F,B00,750495,Dominguez; Noelia,24,0,25,1
1731503598879,LTSP 100F,C00,750547,Villafuerte Vazquez; Nadia,25,0,25,0
1731503599910,LTSP 116,A00,750557,Arcos Herrera; Carol,40,0,40,0
1731503600937,LTSP 135B,A00,750560,Sanchez Cruz; Jorge,39,0,40,1
1731503601967,LTSP 145,A00,750561,Martin-Cabrera; Luis,24,0,25,1
1731503602997,LTSP 155,A00,798249,Blanco; John D,40,0,40,0
1731503604021,LTSP 166,A00,750562,Carvajal Regidor; Jose,39,0,40,1
1731503605050,LTSP 172,A00,750563,Chacon; Gloria Elizabeth,40,0,40,0
1731503606080,LTTH 210B,A00,750769,Blanco; John D,15,0,15,0
1731503607111,LTWL 11,A00,749863,Dhar; Amrita,40,0,40,0
1731503608144,LTWL 19B,A00,749864,Myerston Santana; Jacobo,38,0,40,2
1731503609172,LTWL 102,A00,750565,Myerston Santana; Jacobo,23,0,25,2
1731503610200,LTWL 120,A00,750578,Mendoza; Andrea,38,0,40,2
1731503611230,LTWL 124,A00,750579,Garofalo; Devin,39,0,40,1
1731503612258,LTWL 165,A00,750587,Kim; Joo Ok,40,0,40,0
1731503613284,LTWL 180,A00,750613,Nguyen; Hoang Tan,39,0,40,1
1731503614315,LTWL 184,A00,750625,Mukherjee; Silpa,38,0,40,2
1731503615343,LTWR 8A,A01,749866,Hoang; Lily Kim,26,0,28,2
1731503615343,LTWR 8A,A02,749867,Hoang; Lily Kim,28,0,28,0
1731503615343,LTWR 8A,A03,749868,Hoang; Lily Kim,25,0,28,3
1731503615343,LTWR 8A,A04,749869,Hoang; Lily Kim,24,0,28,4
1731503616368,LTWR 8B,A01,749872,Som; Brandon D,28,0,28,0
1731503616368,LTWR 8B,A02,749873,Som; Brandon D,27,0,28,1
1731503616368,LTWR 8B,A03,749874,Som; Brandon D,27,0,28,1
1731503616368,LTWR 8B,A04,749875,Som; Brandon D,28,0,28,0
1731503617395,LTWR 101C,A00,750638,Villafuerte Vazquez; Nadia,30,0,30,0
1731503618426,LTWR 109C,A00,795232,Terry; Christopher,24,0,30,6
1731503619455,LTWR 110C,A00,795236,Terry; Christopher,25,0,30,5
1731503620482,LTWR 113C,A00,750640,Carroll; Amy Sara,29,0,30,1
1731503621509,LTWR 114W,A00,750675,Springer; Anna Joy,14,0,15,1
1731503622539,LTWR 115C,A00,750677,Lopez; Casandra,28,0,30,2
1731503623567,LTWR 120C,A00,750678,Wilkinson; Marco,29,0,30,1
1731503624593,LTWR 121C,A00,795237,Terry; Christopher,26,0,30,4
1731503625623,LTWR 126W,A00,750739,Lopez; Casandra,13,0,15,2
1731503626651,LTWR 144,A00,795207,Hoang; Lily Kim,23,0,25,2
1731503627684,LTWR 215,A00,750771,Wilkinson; Marco,14,0,20,6
1731503628713,LTWR 220,A00,750778,Som; Brandon D,9,0,15,6
1731503629743,MAE 8,A01,754809,Arefiev; Alexey,136,0,140,4
1731503630776,MAE 20,A00,754810,Evdokimenko; Ekaterina,57,0,60,3
1731503631807,MAE 30A,A00,754811,Qi; Huihui,100,0,100,0
1731503631807,MAE 30A,B00,754812,Qi; Huihui,78,0,100,22
1731503632838,MAE 30B,A00,754813,Delson; Nathan Joseph,63,0,65,2
1731503633866,MAE 40,A00,754814,Cortes; Jorge,90,0,104,14
1731503634897,MAE 101A,A00,754815,Nomura; Keiko K.,140,0,150,10
1731503635922,MAE 101B,A00,754816,Pham; Hieu Tan,110,0,120,10
1731503636954,MAE 114,A00,754817,Krasheninnikov; Sergei,49,0,50,1
1731503637982,MAE 118,A00,754818,Marinoni; Alessandro,40,0,45,5
1731503639009,MAE 120,A00,754819,Krasheninnikov; Sergei,53,0,60,7
1731503640039,MAE 125,A00,754820,Kleissl; Jan,56,0,75,19
1731503641067,MAE 130,A00,754821,Frazier; Michael,59,0,60,1
1731503642101,MAE 131B,A00,754822,Scholtes Acevedo; Claire,99,0,100,1
1731503643131,MAE 142,A00,754823,Anderson; Mark Ronald,31,0,60,29
1731503644162,MAE 143A,A00,754824,Diagne; Mamadou Lamine,58,0,75,17
1731503644162,MAE 143A,B00,754825,Kramer; Boris,66,0,75,9
1731503645192,MAE 143B,A00,754826,Morimoto; Tania,83,0,100,17
1731503646219,MAE 148,A01,754828,Silberman; Jack,21,0,24,3
1731503647253,MAE 155A,A01,754830,Anderson; Mark Ronald,14,0,50,36
1731503647253,MAE 155A,B01,754832,Hwang; John T,35,0,50,15
1731503648291,MAE 156A,A01,754834,Gravish; Nicholas G & Tustaniwskyj; Jerry I & Mullin; Jennifer S & Lubarda; Marko & Delson; Nathan Joseph,0,0,12,12
1731503648291,MAE 156A,A02,754835,Gravish; Nicholas G & Tustaniwskyj; Jerry I & Delson; Nathan Joseph & Mullin; Jennifer S & Lubarda; Marko,7,0,12,5
1731503648291,MAE 156A,A03,754874,Gravish; Nicholas G & Tustaniwskyj; Jerry I & Mullin; Jennifer S & Lubarda; Marko & Delson; Nathan Joseph,0,0,12,12
1731503648291,MAE 156A,A04,754891,Gravish; Nicholas G & Tustaniwskyj; Jerry I & Mullin; Jennifer S & Lubarda; Marko & Delson; Nathan Joseph,12,0,12,0
1731503648291,MAE 156A,A05,754898,Gravish; Nicholas G & Tustaniwskyj; Jerry I & Mullin; Jennifer S & Lubarda; Marko & Delson; Nathan Joseph,0,0,12,12
1731503648291,MAE 156A,A06,754899,Gravish; Nicholas G & Tustaniwskyj; Jerry I & Delson; Nathan Joseph & Mullin; Jennifer S & Lubarda; Marko,10,0,12,2
1731503648291,MAE 156A,A07,754900,Gravish; Nicholas G & Tustaniwskyj; Jerry I & Mullin; Jennifer S & Lubarda; Marko & Delson; Nathan Joseph,8,0,12,4
1731503648291,MAE 156A,A08,754933,Gravish; Nicholas G & Tustaniwskyj; Jerry I & Mullin; Jennifer S & Lubarda; Marko & Delson; Nathan Joseph,10,0,12,2
1731503648291,MAE 156A,A09,754937,Gravish; Nicholas G & Tustaniwskyj; Jerry I & Mullin; Jennifer S & Lubarda; Marko & Delson; Nathan Joseph,8,0,14,6
1731503648291,MAE 156A,A10,754970,Gravish; Nicholas G & Tustaniwskyj; Jerry I & Delson; Nathan Joseph & Mullin; Jennifer S & Lubarda; Marko,1,0,8,7
1731503648291,MAE 156A,A11,754971,Gravish; Nicholas G & Tustaniwskyj; Jerry I & Mullin; Jennifer S & Lubarda; Marko & Delson; Nathan Joseph,3,0,8,5
1731503648291,MAE 156A,A12,754972,Gravish; Nicholas G & Tustaniwskyj; Jerry I & Mullin; Jennifer S & Lubarda; Marko & Delson; Nathan Joseph,4,0,8,4
1731503648291,MAE 156A,A13,754973,Gravish; Nicholas G & Tustaniwskyj; Jerry I & Mullin; Jennifer S & Lubarda; Marko & Delson; Nathan Joseph,5,0,8,3
1731503648291,MAE 156A,A14,754974,Gravish; Nicholas G & Tustaniwskyj; Jerry I & Delson; Nathan Joseph & Mullin; Jennifer S & Lubarda; Marko,6,0,8,2
1731503648291,MAE 156A,A15,754975,Gravish; Nicholas G & Tustaniwskyj; Jerry I & Mullin; Jennifer S & Lubarda; Marko & Delson; Nathan Joseph,4,0,8,4
1731503648291,MAE 156A,A16,754976,Gravish; Nicholas G & Tustaniwskyj; Jerry I & Mullin; Jennifer S & Lubarda; Marko & Delson; Nathan Joseph,6,0,8,2
1731503648291,MAE 156A,A17,754977,Gravish; Nicholas G & Tustaniwskyj; Jerry I & Mullin; Jennifer S & Lubarda; Marko & Delson; Nathan Joseph,7,0,8,1
1731503648291,MAE 156A,A18,754978,Gravish; Nicholas G & Tustaniwskyj; Jerry I & Delson; Nathan Joseph & Mullin; Jennifer S & Lubarda; Marko,6,0,6,0
1731503649318,MAE 156B,A01,754980,Staff,30,0,36,6
1731503649318,MAE 156B,B01,754982,Tustaniwskyj; Jerry I,25,0,36,11
1731503650345,MAE 160,A00,754983,Evdokimenko; Ekaterina,151,0,165,14
1731503651372,MAE 171A,A01,754985,Kleissl; Jan,24,0,32,8
1731503651372,MAE 171A,A02,754986,Kleissl; Jan,23,0,32,9
1731503651372,MAE 171A,A03,754987,Kleissl; Jan,2,0,32,30
1731503651372,MAE 171A,A04,754988,Kleissl; Jan,0,0,32,32
1731503651372,MAE 171A,A05,754989,Kleissl; Jan,30,0,32,2
1731503651372,MAE 171A,A06,754990,Kleissl; Jan,20,0,32,12
1731503651372,MAE 171A,A07,754991,Kleissl; Jan,25,0,32,7
1731503651372,MAE 171A,A08,754992,Kleissl; Jan,15,0,32,17
1731503651372,MAE 171A,A09,754993,Kleissl; Jan,20,0,24,4
1731503652400,MAE 175A,A01,754995,de Callafon; Raymond A,13,0,16,3
1731503652400,MAE 175A,A02,754996,de Callafon; Raymond A,5,0,16,11
1731503652400,MAE 175A,A03,754997,de Callafon; Raymond A,16,0,16,0
1731503652400,MAE 175A,A04,754998,de Callafon; Raymond A,13,0,16,3
1731503652400,MAE 175A,A05,754999,de Callafon; Raymond A,7,0,16,9
1731503652400,MAE 175A,A06,755052,de Callafon; Raymond A,14,0,15,1
1731503653446,MAE 180,A00,755116,Rosengren; Aaron,53,0,60,7
1731503654476,MAE 200,A00,755117,Diagne; Mamadou Lamine,0,0,50,50
1731503655513,MAE 204,A00,755186,Tolley; Michael Thomas,21,0,100,79
1731503656541,MAE 205,A00,755187,Diagne; Mamadou Lamine & Tynan; George Robert & Scholtes Acevedo; Claire & Qi; Huihui & Hao; Xuanting & Garay; Javier,9990,0,9999,9
1731503657571,MAE 206,A00,755188,Tynan; George Robert,23,0,80,57
1731503658605,MAE 207,A00,755193,Poulikakos; Lisa Voula,17,0,30,13
1731503658605,MAE 207,B00,755199,Staff,51,0,60,9
1731503659636,MAE 208,A00,755212,Saintillan; David,6,0,30,24
1731503660669,MAE 210B,A00,755213,Sanchez; Antonio Luis,13,0,30,17
1731503661700,MAE 210C,A00,755214,Becker; Janet Maria,11,0,15,4
1731503662732,MAE 212,A00,755215,Sanchez; Antonio Luis,18,0,40,22
1731503663764,MAE 217B,A00,755216,Arefiev; Alexey,6,0,10,4
1731503664792,MAE 221B,A00,755217,Coimbra; Carlos F.,7,0,15,8
1731503665822,MAE 221C,A00,755218,Saha; Abhishek,3,0,10,7
1731503666850,MAE 231C,A00,755220,Jandaghi Semnani; Shabnam,4,0,5,1
1731503667881,MAE 232B,A00,755221,Chen; Jiun-Shyan,0,0,10,10
1731503668909,MAE 248,A00,755222,Herbert; Sylvia Lee,15,0,15,0
1731503669940,MAE 261,A00,755223,Lindsey; Stephanie,10,0,10,0
1731503670968,MAE 270,A00,755224,Hwang; John T,0,0,15,15
1731503672002,MAE 271A,A00,755226,Luo; Jian,2,0,5,3
1731503673030,MAE 274,A00,755299,Kramer; Boris,0,0,0,0
1731503674062,MAE 276,A00,755300,Cai; Shengqiang,0,0,20,20
1731503675103,MAE 281A,A00,755301,Krstic; Miroslav,19,0,42,23
1731503676135,MAE 289B,A00,755302,Martinez; Sonia,10,0,10,0
1731503677164,MAE 290B,A00,755303,Sarkar; Sutanu,20,0,40,20
1731503678192,MAE 294B,A00,755304,Llewellyn Smith; Stefan G.,7,0,10,3
1731503679222,MATH 2,A01,751732,Cheng; Hsiao-Bing,193,0,200,7
1731503679222,MATH 2,B01,751734,Cheng; Hsiao-Bing,196,0,200,4
1731503680254,MATH 3B,A01,751736,Hammock; Frances H,33,0,33,0
1731503680254,MATH 3B,A02,751737,Hammock; Frances H,24,0,33,9
1731503680254,MATH 3B,A03,751738,Hammock; Frances H,33,0,33,0
1731503680254,MATH 3B,A04,751739,Hammock; Frances H,30,0,33,3
1731503680254,MATH 3B,A05,751740,Hammock; Frances H,30,0,31,1
1731503680254,MATH 3B,A06,751741,Hammock; Frances H,31,0,33,2
1731503680254,MATH 3B,B01,751743,Staff,27,0,32,5
1731503680254,MATH 3B,B02,751744,Staff,32,0,32,0
1731503680254,MATH 3B,B03,751745,Staff,29,0,32,3
1731503680254,MATH 3B,B04,751746,Staff,31,0,32,1
1731503680254,MATH 3B,B05,751765,Staff,32,0,32,0
1731503680254,MATH 3B,B06,751766,Staff,32,0,32,0
1731503681294,MATH 3C,A01,751774,Hammock; Frances H,29,0,30,1
1731503681294,MATH 3C,A02,751775,Hammock; Frances H,26,0,30,4
1731503681294,MATH 3C,A03,751776,Hammock; Frances H,30,0,30,0
1731503681294,MATH 3C,A04,751781,Hammock; Frances H,25,0,30,5
1731503681294,MATH 3C,A05,751782,Hammock; Frances H,20,0,30,10
1731503681294,MATH 3C,A06,751952,Hammock; Frances H,30,0,30,0
1731503681294,MATH 3C,B01,752043,Staff,32,0,35,3
1731503681294,MATH 3C,B02,752094,Staff,35,0,35,0
1731503681294,MATH 3C,B03,752188,Staff,35,0,35,0
1731503681294,MATH 3C,B04,752210,Staff,33,0,35,2
1731503681294,MATH 3C,C01,752281,Yin; Wei,31,0,32,1
1731503681294,MATH 3C,C02,752282,Yin; Wei,31,0,32,1
1731503681294,MATH 3C,C03,752283,Yin; Wei,32,0,32,0
1731503681294,MATH 3C,C04,752284,Yin; Wei,32,0,32,0
1731503682324,MATH 4C,A01,752286,Aliabadi Sr.; Mohsen,31,0,35,4
1731503682324,MATH 4C,A02,752287,Aliabadi Sr.; Mohsen,35,0,35,0
1731503682324,MATH 4C,A03,752290,Aliabadi Sr.; Mohsen,35,0,35,0
1731503682324,MATH 4C,A04,752291,Aliabadi Sr.; Mohsen,35,0,35,0
1731503683367,MATH 10A,A01,752293,Hiatt; Patrick John,20,0,32,12
1731503683367,MATH 10A,A02,752294,Hiatt; Patrick John,28,0,32,4
1731503683367,MATH 10A,A03,752296,Hiatt; Patrick John,31,0,32,1
1731503683367,MATH 10A,A04,752297,Hiatt; Patrick John,30,0,32,2
1731503683367,MATH 10A,B01,752306,Hiatt; Patrick John,23,0,32,9
1731503683367,MATH 10A,B02,752362,Hiatt; Patrick John,31,0,32,1
1731503683367,MATH 10A,B03,752366,Hiatt; Patrick John,32,0,32,0
1731503683367,MATH 10A,B04,752372,Hiatt; Patrick John,30,0,32,2
1731503683367,MATH 10A,B05,752415,Hiatt; Patrick John,32,0,32,0
1731503683367,MATH 10A,B06,752463,Hiatt; Patrick John,32,0,32,0
1731503683367,MATH 10A,C01,752582,Hardiman; Liam,53,0,58,5
1731503683367,MATH 10A,C02,752589,Hardiman; Liam,57,0,60,3
1731503683367,MATH 10A,C03,752591,Hardiman; Liam,31,0,32,1
1731503683367,MATH 10A,C04,752592,Hardiman; Liam,32,0,32,0
1731503683367,MATH 10A,C05,796290,Hardiman; Liam,59,0,60,1
1731503683367,MATH 10A,C06,796293,Hardiman; Liam,60,0,60,0
1731503683367,MATH 10A,D01,752596,Briones; Jor-el Thomas Caparas,84,0,100,16
1731503683367,MATH 10A,D02,752597,Briones; Jor-el Thomas Caparas,99,0,100,1
1731503684404,MATH 10B,A01,752608,Zhao; Yizhen,0,0,0,0
1731503684404,MATH 10B,A02,752609,Zhao; Yizhen,0,0,0,0
1731503684404,MATH 10B,A03,752620,Zhao; Yizhen,0,0,0,0
1731503684404,MATH 10B,A04,752621,Zhao; Yizhen,0,0,0,0
1731503684404,MATH 10B,A05,752622,Zhao; Yizhen,0,0,0,0
1731503684404,MATH 10B,A06,752626,Zhao; Yizhen,0,0,0,0
1731503684404,MATH 10B,B01,752730,Zhao; Yizhen,0,0,0,0
1731503684404,MATH 10B,B02,752731,Zhao; Yizhen,0,0,0,0
1731503684404,MATH 10B,B03,752733,Zhao; Yizhen,0,0,0,0
1731503684404,MATH 10B,B04,752736,Zhao; Yizhen,0,0,0,0
1731503684404,MATH 10B,B05,796263,Zhao; Yizhen,0,0,0,0
1731503684404,MATH 10B,B06,796264,Zhao; Yizhen,0,0,0,0
1731503684404,MATH 10B,C01,752739,Goffer; Gil,0,0,0,0
1731503684404,MATH 10B,C02,752740,Goffer; Gil,0,0,0,0
1731503684404,MATH 10B,C03,752771,Goffer; Gil,0,0,0,0
1731503684404,MATH 10B,C04,752779,Goffer; Gil,0,0,0,0
1731503684404,MATH 10B,D01,752787,Buzaglo; Lucas,0,0,0,0
1731503684404,MATH 10B,D02,752793,Buzaglo; Lucas,0,0,0,0
1731503684404,MATH 10B,D03,752794,Buzaglo; Lucas,0,0,0,0
1731503684404,MATH 10B,D04,752800,Buzaglo; Lucas,0,0,0,0
1731503684404,MATH 10B,E01,752805,Bach; Quang Tran,0,0,0,0
1731503684404,MATH 10B,E02,752810,Bach; Quang Tran,0,0,0,0
1731503685432,MATH 10C,A01,752869,Nag; Panchali,32,0,32,0
1731503685432,MATH 10C,A02,752899,Nag; Panchali,29,0,32,3
1731503685432,MATH 10C,A03,752901,Nag; Panchali,32,0,32,0
1731503685432,MATH 10C,A04,752902,Nag; Panchali,32,0,32,0
1731503685432,MATH 10C,A05,752903,Nag; Panchali,32,0,32,0
1731503685432,MATH 10C,A06,752904,Nag; Panchali,31,0,32,1
1731503685432,MATH 10C,B01,752908,Nag; Panchali,11,0,27,16
1731503685432,MATH 10C,B02,752913,Nag; Panchali,28,0,30,2
1731503685432,MATH 10C,B03,752914,Nag; Panchali,28,0,30,2
1731503685432,MATH 10C,B04,752916,Nag; Panchali,28,0,30,2
1731503686469,MATH 11,A01,752921,Rava; Denise,35,0,36,1
1731503686469,MATH 11,A02,752922,Rava; Denise,29,0,36,7
1731503686469,MATH 11,A03,752924,Rava; Denise,34,0,36,2
1731503686469,MATH 11,A04,752932,Rava; Denise,36,0,36,0
1731503686469,MATH 11,A05,752936,Rava; Denise,35,0,36,1
1731503686469,MATH 11,A06,752984,Rava; Denise,35,0,36,1
1731503686469,MATH 11,B01,752988,Staff,29,0,35,6
1731503686469,MATH 11,B02,752991,Staff,33,0,35,2
1731503686469,MATH 11,B03,752994,Staff,54,0,56,2
1731503686469,MATH 11,B04,752998,Staff,60,0,60,0
1731503687510,MATH 18,A01,753003,Anzaldo; Leesa B,27,0,60,33
1731503687510,MATH 18,A02,753004,Anzaldo; Leesa B,53,0,60,7
1731503687510,MATH 18,A03,753005,Anzaldo; Leesa B,58,0,60,2
1731503687510,MATH 18,A04,753006,Anzaldo; Leesa B,59,0,60,1
1731503687510,MATH 18,A05,753009,Anzaldo; Leesa B,59,0,60,1
1731503687510,MATH 18,A06,753010,Anzaldo; Leesa B,60,0,60,0
1731503687510,MATH 18,A07,753011,Anzaldo; Leesa B,28,0,32,4
1731503687510,MATH 18,A08,753013,Anzaldo; Leesa B,20,0,22,2
1731503687510,MATH 18,A09,753014,Anzaldo; Leesa B,30,0,32,2
1731503687510,MATH 18,A10,753041,Anzaldo; Leesa B,32,0,32,0
1731503687510,MATH 18,A11,753066,Anzaldo; Leesa B,32,0,32,0
1731503687510,MATH 18,A12,753067,Anzaldo; Leesa B,30,0,32,2
1731503687510,MATH 18,B01,753070,Ganesan; Priyanga,96,0,100,4
1731503687510,MATH 18,B02,753071,Ganesan; Priyanga,99,0,100,1
1731503687510,MATH 18,C01,753074,Ganesan; Priyanga,39,0,45,6
1731503687510,MATH 18,C02,753075,Ganesan; Priyanga,44,0,45,1
1731503687510,MATH 18,C03,753076,Ganesan; Priyanga,44,0,45,1
1731503687510,MATH 18,C04,753077,Ganesan; Priyanga,45,0,45,0
1731503688540,MATH 20A,A01,753159,Ho; Ching Wei,29,0,30,1
1731503688540,MATH 20A,A02,753160,Ho; Ching Wei,10,0,26,16
1731503688540,MATH 20A,A03,753161,Ho; Ching Wei,27,0,30,3
1731503688540,MATH 20A,A04,753162,Ho; Ching Wei,29,0,30,1
1731503688540,MATH 20A,B01,753169,Ho; Ching Wei,55,0,60,5
1731503688540,MATH 20A,B02,753170,Ho; Ching Wei,56,0,60,4
1731503688540,MATH 20A,B03,753171,Ho; Ching Wei,34,0,35,1
1731503688540,MATH 20A,B04,753172,Ho; Ching Wei,35,0,35,0
1731503689661,MATH 20B,A01,753174,Habib; Yousaf,34,0,34,0
1731503689661,MATH 20B,A02,753175,Habib; Yousaf,33,0,34,1
1731503689661,MATH 20B,A03,753176,Habib; Yousaf,34,0,34,0
1731503689661,MATH 20B,A04,753177,Habib; Yousaf,34,0,34,0
1731503689661,MATH 20B,B01,753179,Habib; Yousaf,31,0,33,2
1731503689661,MATH 20B,B02,753180,Habib; Yousaf,33,0,33,0
1731503689661,MATH 20B,B03,753181,Habib; Yousaf,33,0,33,0
1731503689661,MATH 20B,B04,753188,Habib; Yousaf,33,0,33,0
1731503689661,MATH 20B,B05,753194,Habib; Yousaf,33,0,33,0
1731503689661,MATH 20B,B06,753195,Habib; Yousaf,33,0,33,0
1731503689661,MATH 20B,C01,753260,Upadrashta; Pranav Kumar,69,0,75,6
1731503689661,MATH 20B,C02,753261,Upadrashta; Pranav Kumar,75,0,75,0
1731503689661,MATH 20B,D01,753352,Upadrashta; Pranav Kumar,65,0,65,0
1731503689661,MATH 20B,D02,753356,Upadrashta; Pranav Kumar,65,0,65,0
1731503689661,MATH 20B,D03,753357,Upadrashta; Pranav Kumar,25,0,32,7
1731503689661,MATH 20B,D04,753361,Upadrashta; Pranav Kumar,31,0,32,1
1731503689661,MATH 20B,E01,753380,Xu; Fengmin,20,0,26,6
1731503689661,MATH 20B,E02,753384,Xu; Fengmin,30,0,32,2
1731503689661,MATH 20B,E03,753385,Xu; Fengmin,32,0,32,0
1731503689661,MATH 20B,E04,753388,Xu; Fengmin,31,0,32,1
1731503689661,MATH 20B,E05,753392,Xu; Fengmin,32,0,32,0
1731503689661,MATH 20B,E06,753393,Xu; Fengmin,32,0,32,0
1731503690701,MATH 20C,A01,753398,Ohm; Ko Woon,77,0,94,17
1731503690701,MATH 20C,A02,753402,Ohm; Ko Woon,98,0,100,2
1731503690701,MATH 20C,A03,753409,Ohm; Ko Woon,98,0,100,2
1731503690701,MATH 20C,A04,753412,Ohm; Ko Woon,100,0,100,0
1731503690701,MATH 20C,A05,753503,Ohm; Ko Woon,25,0,40,15
1731503690701,MATH 20C,A06,753504,Ohm; Ko Woon,35,0,40,5
1731503690701,MATH 20C,A07,753509,Ohm; Ko Woon,39,0,40,1
1731503690701,MATH 20C,A08,753510,Ohm; Ko Woon,40,0,40,0
1731503690701,MATH 20C,B01,753513,Staff,58,0,60,2
1731503690701,MATH 20C,B02,753514,Staff,60,0,60,0
1731503690701,MATH 20C,B03,753516,Staff,60,0,60,0
1731503690701,MATH 20C,C01,753518,Yin; Wei,59,0,60,1
1731503690701,MATH 20C,C02,753519,Yin; Wei,32,0,32,0
1731503690701,MATH 20C,C03,753520,Yin; Wei,24,0,32,8
1731503690701,MATH 20C,C04,753521,Yin; Wei,32,0,32,0
1731503690701,MATH 20C,C05,753524,Yin; Wei,32,0,32,0
1731503691742,MATH 20D,A01,753531,Staff,28,0,35,7
1731503691742,MATH 20D,A02,753532,Staff,28,0,29,1
1731503691742,MATH 20D,A03,753533,Staff,35,0,35,0
1731503691742,MATH 20D,A04,753535,Staff,35,0,35,0
1731503691742,MATH 20D,B01,753549,Hardiman; Liam,31,0,35,4
1731503691742,MATH 20D,B02,753592,Hardiman; Liam,35,0,35,0
1731503691742,MATH 20D,B03,753594,Hardiman; Liam,35,0,35,0
1731503691742,MATH 20D,B04,753595,Hardiman; Liam,34,0,35,1
1731503691742,MATH 20D,C01,753600,Gartland; Christopher John,96,0,100,4
1731503691742,MATH 20D,C02,753622,Gartland; Christopher John,98,0,100,2
1731503691742,MATH 20D,D01,753628,Gartland; Christopher John,35,0,35,0
1731503691742,MATH 20D,D02,753635,Gartland; Christopher John,35,0,35,0
1731503691742,MATH 20D,D03,753636,Gartland; Christopher John,60,0,60,0
1731503691742,MATH 20D,D04,753643,Gartland; Christopher John,60,0,60,0
1731503692774,MATH 20E,A01,753646,Bach; Quang Tran,24,0,32,8
1731503692774,MATH 20E,A02,753668,Bach; Quang Tran,33,0,35,2
1731503692774,MATH 20E,A03,753669,Bach; Quang Tran,35,0,35,0
1731503692774,MATH 20E,A04,753670,Bach; Quang Tran,35,0,35,0
1731503692774,MATH 20E,A05,753671,Bach; Quang Tran,30,0,30,0
1731503692774,MATH 20E,A06,753672,Bach; Quang Tran,30,0,30,0
1731503692774,MATH 20E,A07,796295,Bach; Quang Tran,60,0,60,0
1731503692774,MATH 20E,A08,796317,Bach; Quang Tran,60,0,60,0
1731503692774,MATH 20E,B01,753699,Sanchez; Anthony,30,0,35,5
1731503692774,MATH 20E,B02,753700,Sanchez; Anthony,35,0,35,0
1731503692774,MATH 20E,B03,753701,Sanchez; Anthony,64,0,65,1
1731503692774,MATH 20E,B04,753702,Sanchez; Anthony,65,0,65,0
1731503693802,MATH 31BH,A01,753704,De Vleming; Kristin Elizab,35,0,35,0
1731503693802,MATH 31BH,A02,753705,De Vleming; Kristin Elizab,35,0,35,0
1731503694831,MATH 87,A00,795962,Rabin; Jeffrey Mark,18,0,20,2
1731503695864,MATH 95,A00,753706,Stevens; Laura Jeanne,31,0,35,4
1731503696899,MATH 100A,A01,753708,Aycock; Jon Merrill,31,0,35,4
1731503696899,MATH 100A,A02,753709,Aycock; Jon Merrill,35,0,35,0
1731503697931,MATH 100B,A01,753711,Rogalski; Daniel,23,0,35,12
1731503697931,MATH 100B,A02,753712,Rogalski; Daniel,32,0,35,3
1731503698959,MATH 102,A01,753714,Harel; Guershon,34,0,35,1
1731503698959,MATH 102,A02,753740,Harel; Guershon,35,0,35,0
1731503698959,MATH 102,B01,753742,Ophir; Amit,32,0,35,3
1731503698959,MATH 102,B02,753743,Ophir; Amit,35,0,35,0
1731503699985,MATH 103A,A01,753745,Buzaglo; Lucas,26,0,30,4
1731503699985,MATH 103A,A02,753746,Buzaglo; Lucas,29,0,30,1
1731503699985,MATH 103A,B01,753748,Goffer; Gil,35,0,35,0
1731503699985,MATH 103A,B02,753749,Goffer; Gil,35,0,35,0
1731503699985,MATH 103A,C01,753751,Wenzl; Hans G,35,0,35,0
1731503699985,MATH 103A,C02,753798,Wenzl; Hans G,34,0,35,1
1731503701018,MATH 103B,A01,753805,Klevdal; Christian Sleek,29,0,30,1
1731503701018,MATH 103B,A02,753806,Klevdal; Christian Sleek,29,0,30,1
1731503701018,MATH 103B,A03,796050,Klevdal; Christian Sleek,26,0,30,4
1731503701018,MATH 103B,B01,753841,Wesley; William J,27,0,35,8
1731503701018,MATH 103B,B02,753842,Wesley; William J,34,0,35,1
1731503701018,MATH 103B,C01,753872,Chou; Raymond Oliver,20,0,35,15
1731503701018,MATH 103B,C02,753873,Chou; Raymond Oliver,31,0,35,4
1731503702050,MATH 104B,A01,753875,Kane; Daniel Mertz,35,0,35,0
1731503703092,MATH 109,A01,753883,Ganapathy; Karthik,7,0,10,3
1731503703092,MATH 109,A02,753884,Ganapathy; Karthik,9,0,10,1
1731503703092,MATH 109,B01,753886,Ganapathy; Karthik,9,0,10,1
1731503703092,MATH 109,B02,753887,Ganapathy; Karthik,10,0,10,0
1731503703092,MATH 109,C01,753901,Lu; Yunze,4,0,10,6
1731503703092,MATH 109,C02,753902,Lu; Yunze,10,0,10,0
1731503703092,MATH 109,D01,753912,Nandi; Achinta Kumar,10,0,10,0
1731503703092,MATH 109,D02,753928,Nandi; Achinta Kumar,9,0,10,1
1731503703092,MATH 109,E01,753935,Xiao; Ming,7,0,10,3
1731503703092,MATH 109,E02,753958,Xiao; Ming,0,0,10,10
1731503704125,MATH 111B,A01,753960,Meyer; David A.,28,0,35,7
1731503705154,MATH 112A,A01,754063,Komarova; Natalia,24,0,27,3
1731503706180,MATH 120A,A01,754070,Treuer; John N,30,0,35,5
1731503706180,MATH 120A,A02,754116,Treuer; John N,35,0,35,0
1731503707207,MATH 121A,A01,754119,Stevens; Laura Jeanne,32,0,35,3
1731503708240,MATH 140A,A01,754121,Sanchez; Anthony,30,0,35,5
1731503708240,MATH 140A,A02,754122,Sanchez; Anthony,32,0,35,3
1731503709270,MATH 140B,A01,754126,Zlatos; Andrej,34,0,35,1
1731503709270,MATH 140B,A02,754127,Zlatos; Andrej,35,0,35,0
1731503709270,MATH 140B,B01,754130,Lu; Yunze,33,0,35,2
1731503709270,MATH 140B,B02,754132,Lu; Yunze,33,0,35,2
1731503710297,MATH 142A,A01,754205,Parise; Davide,31,0,35,4
1731503710297,MATH 142A,A02,754206,Parise; Davide,33,0,35,2
1731503710297,MATH 142A,B01,754232,Kunnawalkam Elayavalli; Sr,33,0,35,2
1731503710297,MATH 142A,B02,754233,Kunnawalkam Elayavalli; Sr,35,0,35,0
1731503710297,MATH 142A,C01,754236,Nandi; Achinta Kumar,32,0,35,3
1731503710297,MATH 142A,C02,754238,Nandi; Achinta Kumar,33,0,35,2
1731503711325,MATH 142B,A01,754240,Bejenaru; Ioan,20,0,35,15
1731503711325,MATH 142B,A02,754241,Bejenaru; Ioan,30,0,35,5
1731503711325,MATH 142B,B01,754243,Sarkar; Pratyush,33,0,35,2
1731503711325,MATH 142B,B02,754244,Sarkar; Pratyush,34,0,35,1
1731503711325,MATH 142B,C01,754246,Sarkar; Pratyush,34,0,35,1
1731503711325,MATH 142B,C02,754247,Sarkar; Pratyush,35,0,35,0
1731503712357,MATH 150A,A01,754249,Rabin; Jeffrey Mark,27,0,35,8
1731503713385,MATH 154,A01,754252,Grier; Daniel T,32,0,35,3
1731503713385,MATH 154,A02,754254,Grier; Daniel T,34,0,35,1
1731503713385,MATH 154,A03,754255,Grier; Daniel T,35,0,35,0
1731503713385,MATH 154,A04,754256,Grier; Daniel T,35,0,35,0
1731503713385,MATH 154,B01,754258,Tesler; Glenn,30,0,35,5
1731503713385,MATH 154,B02,754259,Tesler; Glenn,35,0,35,0
1731503713385,MATH 154,B03,754261,Tesler; Glenn,33,0,35,2
1731503713385,MATH 154,B04,754262,Tesler; Glenn,35,0,35,0
1731503714418,MATH 170A,A01,754266,Dumitriu; Ioana,26,0,35,9
1731503714418,MATH 170A,A02,754267,Dumitriu; Ioana,33,0,35,2
1731503714418,MATH 170A,A03,754268,Dumitriu; Ioana,34,0,35,1
1731503714418,MATH 170A,A04,754269,Dumitriu; Ioana,35,0,35,0
1731503714418,MATH 170A,B01,754271,Dumitriu; Ioana,35,0,35,0
1731503714418,MATH 170A,B02,754273,Dumitriu; Ioana,34,0,35,1
1731503714418,MATH 170A,B03,754275,Dumitriu; Ioana,32,0,35,3
1731503714418,MATH 170A,B04,754276,Dumitriu; Ioana,34,0,35,1
1731503715450,MATH 170B,A01,754278,Dixit; Rishabh,25,0,35,10
1731503715450,MATH 170B,A02,754336,Dixit; Rishabh,34,0,35,1
1731503715450,MATH 170B,A03,754337,Dixit; Rishabh,34,0,35,1
1731503715450,MATH 170B,A04,754339,Dixit; Rishabh,35,0,35,0
1731503716478,MATH 171A,A01,754341,Huang; Lei,21,0,35,14
1731503716478,MATH 171A,A02,754342,Huang; Lei,27,0,35,8
1731503716478,MATH 171A,A03,754343,Huang; Lei,33,0,35,2
1731503716478,MATH 171A,A04,754345,Huang; Lei,32,0,35,3
1731503717511,MATH 173B,A01,754350,Saab; Rayan,24,0,35,11
1731503717511,MATH 173B,A02,754351,Saab; Rayan,22,0,35,13
1731503717511,MATH 173B,A03,754352,Saab; Rayan,34,0,35,1
1731503717511,MATH 173B,A04,754354,Saab; Rayan,34,0,35,1
1731503718539,MATH 175,A01,754357,Briones; Jor-el Thomas Caparas,23,0,25,2
1731503719569,MATH 180A,A01,754360,Peca-Medlin; John Michael,27,0,30,3
1731503719569,MATH 180A,A02,754362,Peca-Medlin; John Michael,30,0,30,0
1731503719569,MATH 180A,A03,754363,Peca-Medlin; John Michael,35,0,35,0
1731503719569,MATH 180A,A04,754367,Peca-Medlin; John Michael,35,0,35,0
1731503719569,MATH 180A,B01,754372,Schweinsberg; Jason,29,0,30,1
1731503719569,MATH 180A,B02,754374,Schweinsberg; Jason,30,0,30,0
1731503719569,MATH 180A,B03,754376,Schweinsberg; Jason,28,0,30,2
1731503719569,MATH 180A,B04,754377,Schweinsberg; Jason,28,0,30,2
1731503719569,MATH 180A,B05,754380,Schweinsberg; Jason,29,0,30,1
1731503719569,MATH 180A,B06,754421,Schweinsberg; Jason,30,0,30,0
1731503720601,MATH 180B,A01,754423,Zheng; Tianyi,27,0,30,3
1731503720601,MATH 180B,A02,754424,Zheng; Tianyi,29,0,30,1
1731503720601,MATH 180B,A03,754425,Zheng; Tianyi,29,0,30,1
1731503720601,MATH 180B,A04,754426,Zheng; Tianyi,30,0,30,0
1731503720601,MATH 180B,B01,754428,Zheng; Tianyi,32,0,35,3
1731503720601,MATH 180B,B02,754429,Zheng; Tianyi,35,0,35,0
1731503720601,MATH 180B,B03,754438,Zheng; Tianyi,35,0,35,0
1731503720601,MATH 180B,B04,754452,Zheng; Tianyi,34,0,35,1
1731503721636,MATH 181A,A01,754454,Quarfoot; David James,27,0,30,3
1731503721636,MATH 181A,A02,754455,Quarfoot; David James,30,0,30,0
1731503721636,MATH 181A,A03,754456,Quarfoot; David James,28,0,30,2
1731503721636,MATH 181A,A04,754457,Quarfoot; David James,29,0,30,1
1731503721636,MATH 181A,B01,754459,Quarfoot; David James,23,0,30,7
1731503721636,MATH 181A,B02,754460,Quarfoot; David James,29,0,30,1
1731503721636,MATH 181A,B03,754461,Quarfoot; David James,26,0,30,4
1731503721636,MATH 181A,B04,754462,Quarfoot; David James,30,0,30,0
1731503722664,MATH 181E,A01,754465,Politis; Dimitris,23,0,35,12
1731503722664,MATH 181E,A02,754466,Politis; Dimitris,32,0,35,3
1731503723693,MATH 183,A01,754468,Vishwanath; Siddharth,9,0,10,1
1731503723693,MATH 183,A02,754469,Vishwanath; Siddharth,3,0,10,7
1731503723693,MATH 183,A03,754470,Vishwanath; Siddharth,0,0,10,10
1731503723693,MATH 183,A04,754473,Vishwanath; Siddharth,8,0,10,2
1731503724724,MATH 184,A01,754527,Chou; Raymond Oliver,28,0,35,7
1731503724724,MATH 184,A02,754529,Chou; Raymond Oliver,33,0,35,2
1731503724724,MATH 184,A03,754532,Chou; Raymond Oliver,35,0,35,0
1731503724724,MATH 184,A04,754534,Chou; Raymond Oliver,35,0,35,0
1731503725756,MATH 185,A01,754537,Rava; Denise,29,0,35,6
1731503725756,MATH 185,A02,754559,Rava; Denise,29,0,35,6
1731503726785,MATH 186,A01,754624,Tesler; Glenn,21,0,33,12
1731503726785,MATH 186,A02,754625,Tesler; Glenn,26,0,33,7
1731503726785,MATH 186,A03,754626,Tesler; Glenn,18,0,33,15
1731503727828,MATH 187A,A01,754628,Bucur; Alina Ioana,11,0,30,19
1731503727828,MATH 187A,A02,754641,Bucur; Alina Ioana,29,0,30,1
1731503727828,MATH 187A,A03,754650,Bucur; Alina Ioana,25,0,30,5
1731503727828,MATH 187A,A04,754654,Bucur; Alina Ioana,28,0,30,2
1731503727828,MATH 187A,A05,754658,Bucur; Alina Ioana,26,0,30,4
1731503727828,MATH 187A,A06,754664,Bucur; Alina Ioana,29,0,30,1
1731503728860,MATH 189,A01,754672,Vishwanath; Siddharth,0,0,10,10
1731503728860,MATH 189,A02,754679,Vishwanath; Siddharth,0,0,10,10
1731503728860,MATH 189,A03,754681,Vishwanath; Siddharth,0,0,10,10
1731503728860,MATH 189,A04,754690,Vishwanath; Siddharth,0,0,10,10
1731503728860,MATH 189,A05,754694,Vishwanath; Siddharth,0,0,10,10
1731503728860,MATH 189,A06,754696,Vishwanath; Siddharth,0,0,10,10
1731503729888,MATH 190A,A01,754709,McKernan; James,25,0,35,10
1731503730915,MATH 196,A00,795968,Sorensen; Claus M,34,0,40,6
1731503731947,MATH 200B,A00,754711,Salehi Golsefidy; Alireza,18,0,20,2
1731503732974,MATH 202B,A00,754712,Novak; Jonathan I,16,0,20,4
1731503734005,MATH 203B,A00,754713,Oprea; Dragos N.,20,0,20,0
1731503735032,MATH 204B,A00,754715,Kedlaya; Kiran S.,20,0,20,0
1731503736058,MATH 207A,A00,754716,Mohammadi; Amir,17,0,20,3
1731503737083,MATH 208,A00,754718,Oprea; Dragos N.,10,0,10,0
1731503738108,MATH 209,A00,754719,Bucur; Alina Ioana,10,0,10,0
1731503739132,MATH 211A,A00,754720,Salehi Golsefidy; Alireza,9,0,10,1
1731503740157,MATH 211B,A00,754722,Sanchez; Anthony,10,0,10,0
1731503741183,MATH 212A,A01,754725,Komarova; Natalia,0,0,5,5
1731503742208,MATH 216B,A00,754727,Saab; Rayan,14,0,20,6
1731503743238,MATH 218,A00,754729,Komarova; Natalia,10,0,10,0
1731503744265,MATH 220B,A00,754730,Xiao; Ming,16,0,20,4
1731503745297,MATH 231B,A00,754731,Zlatos; Andrej,20,0,20,0
1731503746323,MATH 240B,A00,754733,Spolaor; Luca,18,0,20,2
1731503747350,MATH 243,A00,754734,Kunnawalkam Elayavalli; Sr,10,0,10,0
1731503748378,MATH 247A,A00,754736,Frisch; Joshua R,25,0,25,0
1731503749409,MATH 248,A00,754738,Bejenaru; Ioan,10,0,10,0
1731503750439,MATH 250B,A00,754740,Ni; Lei,17,0,20,3
1731503751474,MATH 257A,A00,754741,Spolaor; Luca,18,0,20,2
1731503751474,MATH 257A,B00,754742,Roberts; Justin Deritter,18,0,20,2
1731503765564,MATH 258,A00,754743,Ni; Lei,10,0,10,0
1731503766590,MATH 264B,A00,754745,Rhoades; Brendon Patrick,19,0,20,1
1731503767621,MATH 269,A00,754749,Warnke; Lutz Peter,10,0,10,0
1731503768652,MATH 270B,A00,754750,Leok; Melvin,13,0,20,7
1731503769681,MATH 271B,A00,754752,Nie; Jiawang,15,0,20,5
1731503770709,MATH 272B,A00,754754,Miller; Pearson,19,0,20,1
1731503771738,MATH 275,A01,754757,Briones; Jor-el Thomas Caparas,8,0,10,2
1731503772767,MATH 277A,A00,754763,Ding; Lijun,24,0,25,1
1731503772767,MATH 277A,B00,795972,Patil; Vishal Prakash,16,0,20,4
1731503773800,MATH 278A,A00,754765,Cheng; Li-Tien,10,0,10,0
1731503774826,MATH 278B,A00,754768,Cloninger; Alexander,9,0,10,1
1731503788384,MATH 278C,A00,754770,Nie; Jiawang,10,0,10,0
1731503789414,MATH 280B,A00,754780,Kemp; Todd Aahron,15,0,20,5
1731503790444,MATH 281B,A00,754788,Bradic; Jelena,1,0,20,19
1731503791473,MATH 282B,A00,754796,Arias-Castro; Ery,6,0,20,14
1731503792502,MATH 288,A00,754800,Ang; Jie Jun,10,0,10,0
1731503793529,MATH 290B,A00,754801,Sorensen; Claus M,19,0,20,1
1731503794559,MATH 292,A00,754802,Lu; Yunze,9,0,10,1
1731503795585,MATH 295,A00,754804,Bejenaru; Ioan,15,0,15,0
1731503796614,MATH 297,001,754807,Gamst; Anthony Collins,0,0,0,0
1731503797639,MATS 200,A00,751610,Graeve; Olivia A,9976,0,9999,23
1731503798735,MATS 201A,A00,751611,Luo; Jian,19,0,55,36
1731503811772,MATS 231,A00,751612,Cai; Shengqiang,14,0,25,11
1731503812805,MATS 255,A00,751613,Meyers; Marc,3,0,20,17
1731503813831,MATS 261A,A00,751614,Qiao; Yu,17,0,25,8
1731503814864,MATS 295,A00,751660,Graeve; Olivia A,9999,0,9999,0
1731503815896,MATS 296,A00,751661,Kim; Hyonny,9999,0,9999,0
1731503815896,MATS 296,B00,751665,Bandaru; Prabhakar,9999,0,9999,0
1731503816925,MBC 259,A00,799573,Murray; Samantha J.,2,0,26,24
1731503817966,MCWP 40,001,755308,Wastal; Carrie King,15,0,15,0
1731503817966,MCWP 40,002,755309,Wastal; Carrie King,15,0,15,0
1731503817966,MCWP 40,003,755310,Montejo; Carolina,20,0,20,0
1731503817966,MCWP 40,006,755313,Duru; Nur,15,0,20,5
1731503817966,MCWP 40,007,755316,Duru; Nur,19,0,20,1
1731503817966,MCWP 40,008,755317,Duru; Nur,20,0,20,0
1731503817966,MCWP 40,012,755322,Wastal; Carrie King,15,0,15,0
1731503817966,MCWP 40,013,755323,Wastal; Carrie King,14,0,15,1
1731503817966,MCWP 40,017,755327,Bartulis; Jason Michael,11,0,20,9
1731503817966,MCWP 40,018,755328,Bartulis; Jason Michael,15,0,20,5
1731503817966,MCWP 40,019,755329,Bartulis; Jason Michael,15,0,20,5
1731503819009,MCWP 50,001,755330,Wastal; Carrie King,10,0,15,5
1731503819009,MCWP 50,002,755331,Redela; Pamela Morgan,20,0,20,0
1731503819009,MCWP 50,003,755332,Redela; Pamela Morgan,18,0,20,2
1731503819009,MCWP 50,004,755333,Redela; Pamela Morgan,18,0,20,2
1731503819009,MCWP 50,005,755334,Compas; Sean Matthew,14,0,20,6
1731503819009,MCWP 50,006,755335,Compas; Sean Matthew,17,0,20,3
1731503819009,MCWP 50,007,755336,Compas; Sean Matthew,17,0,20,3
1731503819009,MCWP 50,008,755337,Carter; Andrea L,19,0,20,1
1731503819009,MCWP 50,009,755338,Carter; Andrea L,20,0,20,0
1731503819009,MCWP 50,010,755339,Carter; Andrea L,20,0,20,0
1731503819009,MCWP 50,011,755340,Smith; Haydee Marie,16,0,20,4
1731503819009,MCWP 50,012,755341,Smith; Haydee Marie,17,0,20,3
1731503819009,MCWP 50,013,755342,Smith; Haydee Marie,20,0,20,0
1731503819009,MCWP 50,014,755344,Pham; Vincent Minhduc,20,0,20,0
1731503819009,MCWP 50,015,755345,Pham; Vincent Minhduc,20,0,20,0
1731503819009,MCWP 50,016,755346,Pham; Vincent Minhduc,20,0,20,0
1731503819009,MCWP 50,017,755347,Morshed; Michael James,13,0,20,7
1731503819009,MCWP 50,018,755382,Silva; Kelly B,20,0,20,0
1731503819009,MCWP 50,019,755685,Silva; Kelly B,20,0,20,0
1731503819009,MCWP 50,020,755686,Carter; Jennifer A,19,0,20,1
1731503819009,MCWP 50,021,755687,Carter; Jennifer A,20,0,20,0
1731503819009,MCWP 50,022,755688,Carter; Jennifer A,18,0,20,2
1731503819009,MCWP 50,024,755694,Nies; Laurie Elizabeth,16,0,20,4
1731503819009,MCWP 50,025,755695,Nies; Laurie Elizabeth,15,0,20,5
1731503819009,MCWP 50,026,755704,Krone; Jarret,17,0,20,3
1731503819009,MCWP 50,027,755711,Krone; Jarret,19,0,20,1
1731503819009,MCWP 50,028,755739,Krone; Jarret,18,0,20,2
1731503819009,MCWP 50,031,755747,Morshed; Michael James,17,0,20,3
1731503819009,MCWP 50,032,755748,Morshed; Michael James,8,0,20,12
1731503820040,MCWP 125,A00,755868,Guillen; Melinda,15,0,20,5
1731503820040,MCWP 125,B00,755870,Guillen; Melinda,8,0,20,12
1731503821067,MCWP 125R,A00,755873,Miller; Elizabeth Deen,13,0,20,7
1731503821067,MCWP 125R,B00,755874,Miller; Elizabeth Deen,18,0,20,2
1731503821067,MCWP 125R,C00,795037,Miller; Elizabeth Deen,19,0,20,1
1731503834849,MED 238,A00,755306,Chen; Ju & Sun; Wei & Shyy; Yeun-Jund & Sheikh; Farah & Ross; Robert Scott & King; Kevin R & Evans; Sylvia M & Cho; Yoshitake,5,0,10,5
1731503835882,MED 246,A00,796576,Gordts; Philip & Lewis; Amanda Lark & Godula; Kamil & Gagneux; Pascal & Esko; Jeffrey D. & Bode; Lars,10,0,10,0
1731503836909,MED 262,A00,796570,Koola; Jejo David,24,0,30,6
1731503837941,MED 263,A00,796550,Curtius; Kathleen Mary & D'Antonio; Matteo,1,0,18,17
1731503838970,MED 278,A00,796573,Carter; Hannah Kathryn,10,0,15,5
1731503840017,MED 283,A00,755307,Ideker; Trey,0,0,0,0
1731503841045,MED 296,001,791666,Malinak; David James,9,0,10,1
1731503841045,MED 296,002,791667,Von Drygalski; Annette,9,0,10,1
1731503841045,MED 296,003,791668,Chi; Neil C.,8,0,10,2
1731503841045,MED 296,004,791670,Castellanos; Luis R.,9,0,10,1
1731503842072,MGT 3,A00,766229,Wagner; Timothy Ryan,95,0,98,3
1731503843100,MGT 4,A01,766234,Levkoff; Steven B.,4,0,8,4
1731503843100,MGT 4,A02,766235,Levkoff; Steven B.,6,0,8,2
1731503843100,MGT 4,A03,766273,Levkoff; Steven B.,8,0,9,1
1731503843100,MGT 4,B01,798342,Brooks; Marcus Raymond,31,0,32,1
1731503844127,MGT 5,A00,766275,Molloie Jr.; William H,181,0,186,5
1731503858166,MGT 12,A00,766277,Pecore; Joseph P.,72,0,100,28
1731503859198,MGT 16,A00,766279,Buchanan; Harold G,97,0,100,3
1731503859198,MGT 16,B00,766282,Buchanan; Harold G,96,0,100,4
1731503859198,MGT 16,C00,766285,Campbell; Robert Harold,117,0,120,3
1731503859198,MGT 16,D00,766288,Campbell; Robert Harold,119,0,120,1
1731503859198,MGT 16,E00,766290,Demill; Burritt,98,0,98,0
1731503859198,MGT 16,F00,766291,Lindenberger; Wade Douglas,85,0,100,15
1731503860234,MGT 18,A00,766299,McKay; Michael J,97,0,98,1
1731503860234,MGT 18,B00,766308,McKay; Michael J,93,0,98,5
1731503860234,MGT 18,C00,766310,McKay; Michael J,96,0,98,2
1731503860234,MGT 18,D00,766311,Chamberlain; Travis Dean,97,0,98,1
1731503861262,MGT 45,A00,766315,Pecore; Joseph P.,141,0,150,9
1731503861262,MGT 45,B00,766322,Pecore; Joseph P.,148,0,150,2
1731503862290,MGT 52,A00,766324,Deal; Jennifer Jean,89,0,98,9
1731503863316,MGT 71R,A00,766325,Phiroz; Zal Navroze,66,0,98,32
1731503864343,MGT 100,A00,766328,Yavorsky; Daniel Ryan,107,0,120,13
1731503864343,MGT 100,B00,796601,Yavorsky; Daniel Ryan,111,0,120,9
1731503865379,MGT 103,A00,766334,Bates; Kenneth Walter,91,0,98,7
1731503865379,MGT 103,C00,766338,Eberhard; Craig A,98,0,98,0
1731503865379,MGT 103,D00,766341,Eberhard; Craig A,96,0,98,2
1731503865379,MGT 103,E00,766343,Ehrich; Kristine R,92,0,98,6
1731503865379,MGT 103,F00,766344,Ehrich; Kristine R,93,0,98,5
1731503865379,MGT 103,G00,766604,Ehrich; Kristine R,97,0,98,1
1731503866405,MGT 105,A00,796605,Bates; Kenneth Walter,91,0,98,7
1731503867435,MGT 106,A00,766605,Eberhard; Craig A,96,0,98,2
1731503881188,MGT 107,A00,766688,Jaroszewicz; Ania,97,0,98,1
1731503881188,MGT 107,B00,766721,Jaroszewicz; Ania,80,0,98,18
1731503881188,MGT 107,C00,796609,Jaroszewicz; Ania,93,0,98,5
1731503882215,MGT 109,A00,766779,Staff,88,0,98,10
1731503883243,MGT 112,A00,766780,Somasundaram; Tyagarajan,52,0,60,8
1731503883243,MGT 112,B00,766781,Somasundaram; Tyagarajan,54,0,70,16
1731503884272,MGT 119,A00,766782,Etingue Kum; Menes,96,0,98,2
1731503885300,MGT 121A,A00,766783,Klaas; Jeffrey David,92,0,98,6
1731503886353,MGT 123,A00,796610,Felke; Magnus Roland,97,0,98,1
1731503887380,MGT 127R,A00,766784,Zhu; Kevin Xiaoguo,68,0,80,12
1731503888407,MGT 131A,A00,766802,Houskeeper; Robert,148,0,150,2
1731503889435,MGT 131B,A00,766833,Houskeeper; Robert,96,0,98,2
1731503890467,MGT 135,A00,766882,Anderson; John Charles,74,0,75,1
1731503891493,MGT 136,A00,766883,Lindenberger; Wade Douglas,90,0,98,8
1731503904665,MGT 137,A00,766893,Perez Cavazos; Gerardo,81,0,98,17
1731503905694,MGT 151R,A00,766954,Phiroz; Zal Navroze,92,0,98,6
1731503905694,MGT 151R,B00,766998,Phiroz; Zal Navroze,97,0,98,1
1731503906722,MGT 153,A00,766999,Perols; Johan Lars,57,0,90,33
1731503907750,MGT 160,A00,767000,Samek; Anya,87,0,90,3
1731503907750,MGT 160,B00,767001,Samek; Anya,74,0,90,16
1731503907750,MGT 160,C00,767038,Samek; Anya,86,0,90,4
1731503908777,MGT 162,A00,767085,Demill; Burritt,96,0,98,2
1731503908777,MGT 162,B00,767086,Demill; Burritt,92,0,98,6
1731503909806,MGT 162R,A00,767087,Gneezy; Uri,180,0,199,19
1731503910837,MGT 164,A00,767088,McKay; Mary A,97,0,98,1
1731503910837,MGT 164,B00,767089,McKay; Mary A,98,0,98,0
1731503910837,MGT 164,C00,767095,McKay; Mary A,96,0,98,2
1731503910837,MGT 164,D00,767097,Meyer; Alison Bloomfield,95,0,98,3
1731503910837,MGT 164,E00,767104,Smith; Pamela Karen,84,0,98,14
1731503911866,MGT 166,A00,767106,Moran; Cathleen L.,57,0,60,3
1731503911866,MGT 166,B00,767107,Moran; Cathleen L.,96,0,98,2
1731503911866,MGT 166,C00,767110,Moran; Cathleen L.,97,0,98,1
1731503912899,MGT 167,A00,767114,Jacob; Jo Dee C,97,0,98,1
1731503913929,MGT 172,A00,767115,Hedges; Kathleen & Royal; Rebecca,118,0,120,2
1731503913929,MGT 172,B00,767118,Hedges; Kathleen,94,0,98,4
1731503913929,MGT 172,C00,767121,Zimmermann; Carsten,98,0,98,0
1731503913929,MGT 172,D00,767124,Zimmermann; Carsten,97,0,98,1
1731503916073,MGT 173,A00,767130,Hayes; Sherry Lorine,91,0,98,7
1731503916073,MGT 173,B00,767135,Hayes; Sherry Lorine,97,0,98,1
1731503917100,MGT 175,A00,767137,Gopal; Christopher S.,97,0,98,1
1731503918125,MGT 176,A00,767139,Gopal; Christopher S.,89,0,98,9
1731503919152,MGT 180R,A00,767140,Engelberg; Joseph Edward,287,0,300,13
1731503920185,MGT 181,A00,767145,Bliss; Barbara Ann,83,0,98,15
1731503920185,MGT 181,B00,767155,Buchanan; Harold G,109,0,120,11
1731503921214,MGT 187,A00,767157,Dunn; Louis Jean,93,0,98,5
1731503921214,MGT 187,B00,767194,Dunn; Louis Jean,92,0,98,6
1731503922244,MGT 189,A00,767242,Dunn; Louis Jean,91,0,98,7
1731503922244,MGT 189,B00,767281,Reher; Michael Christopher,84,0,98,14
1731503923269,MGT 241,A00,770734,Staff,0,0,0,0
1731503924294,MGT 249,A00,767282,August; Terrence & Shin; Hyo Duk & Erat; Sanjiv,19,0,20,1
1731503925319,MGT 256,A00,767296,Liu; Wei,0,0,0,3
1731503926345,MGT 259,A00,767311,Smith; Pamela Karen,17,0,20,3
1731503927398,MGT 296,001,795366,Gneezy; Ayelet,3,0,3,0
1731503927398,MGT 296,002,795367,Amir; On,3,0,3,0
1731503927398,MGT 296,003,795368,Amir; On & Karmarkar; Uma R,2,0,3,1
1731503927398,MGT 296,004,795373,Liu; Jun,3,0,3,0
1731503927398,MGT 296,005,795374,Hansen; Karsten T.,2,0,3,1
1731503927398,MGT 296,006,795376,Erat; Sanjiv,2,0,3,1
1731503927398,MGT 296,007,795377,Timmermann; Allan,1,0,3,2
1731503927398,MGT 296,008,795378,Smith; Pamela Karen,3,0,3,0
1731503927398,MGT 296,009,795380,Zhang; Zhe,3,0,3,0
1731503927398,MGT 296,010,795381,Oveis; Christopher S,3,0,3,0
1731503927398,MGT 296,011,795384,Amir; On & Gneezy; Ayelet,3,0,3,0
1731503927398,MGT 296,012,795385,Luo; Danqi,3,0,3,0
1731503928472,MMW 12,A01,750828,Chang; Edmond Yi-Teh,16,0,16,0
1731503928472,MMW 12,A02,750829,Chang; Edmond Yi-Teh,16,0,16,0
1731503928472,MMW 12,A03,750830,Chang; Edmond Yi-Teh,15,0,16,1
1731503928472,MMW 12,A04,750863,Chang; Edmond Yi-Teh,15,0,16,1
1731503928472,MMW 12,A05,750864,Chang; Edmond Yi-Teh,16,0,16,0
1731503928472,MMW 12,A06,750870,Chang; Edmond Yi-Teh,16,0,16,0
1731503928472,MMW 12,A07,750874,Chang; Edmond Yi-Teh,16,0,16,0
1731503928472,MMW 12,A08,750877,Chang; Edmond Yi-Teh,16,0,16,0
1731503928472,MMW 12,A09,750882,Chang; Edmond Yi-Teh,16,0,16,0
1731503928472,MMW 12,A10,750884,Chang; Edmond Yi-Teh,16,0,16,0
1731503928472,MMW 12,A11,750890,Chang; Edmond Yi-Teh,16,0,16,0
1731503928472,MMW 12,A12,750891,Chang; Edmond Yi-Teh,16,0,16,0
1731503928472,MMW 12,A13,750892,Chang; Edmond Yi-Teh,16,0,16,0
1731503928472,MMW 12,A14,750940,Chang; Edmond Yi-Teh,16,0,16,0
1731503928472,MMW 12,A15,750951,Chang; Edmond Yi-Teh,0,0,0,0
1731503928472,MMW 12,A16,750957,Chang; Edmond Yi-Teh,0,0,0,0
1731503928472,MMW 12,A17,750967,Chang; Edmond Yi-Teh,16,0,16,0
1731503928472,MMW 12,A18,750976,Chang; Edmond Yi-Teh,16,0,16,0
1731503928472,MMW 12,A19,750977,Chang; Edmond Yi-Teh,16,0,16,0
1731503928472,MMW 12,A20,750980,Chang; Edmond Yi-Teh,16,0,16,0
1731503928472,MMW 12,A21,750981,Chang; Edmond Yi-Teh,16,0,16,0
1731503928472,MMW 12,A22,751031,Chang; Edmond Yi-Teh,16,0,16,0
1731503928472,MMW 12,A23,751032,Chang; Edmond Yi-Teh,0,0,0,0
1731503928472,MMW 12,B01,751035,Adamiak; Patrick John,15,0,16,1
1731503928472,MMW 12,B02,751065,Adamiak; Patrick John,14,0,16,2
1731503928472,MMW 12,B03,751066,Adamiak; Patrick John,16,0,16,0
1731503928472,MMW 12,B04,751067,Adamiak; Patrick John,16,0,16,0
1731503928472,MMW 12,B05,751068,Adamiak; Patrick John,16,0,16,0
1731503928472,MMW 12,B06,751069,Adamiak; Patrick John,16,0,16,0
1731503928472,MMW 12,B07,751070,Adamiak; Patrick John,16,0,16,0
1731503928472,MMW 12,B08,751071,Adamiak; Patrick John,16,0,16,0
1731503928472,MMW 12,B09,751072,Adamiak; Patrick John,15,0,16,1
1731503928472,MMW 12,B10,751073,Adamiak; Patrick John,16,0,16,0
1731503928472,MMW 12,B11,751074,Adamiak; Patrick John,16,0,16,0
1731503928472,MMW 12,B12,751075,Adamiak; Patrick John,16,0,16,0
1731503928472,MMW 12,B13,751076,Adamiak; Patrick John,16,0,16,0
1731503928472,MMW 12,B14,751077,Adamiak; Patrick John,16,0,16,0
1731503928472,MMW 12,B15,751078,Adamiak; Patrick John,0,0,0,0
1731503928472,MMW 12,B16,751079,Adamiak; Patrick John,0,0,0,0
1731503928472,MMW 12,B17,751080,Adamiak; Patrick John,15,0,16,1
1731503928472,MMW 12,B18,751081,Adamiak; Patrick John,16,0,16,0
1731503928472,MMW 12,B19,751082,Adamiak; Patrick John,16,0,16,0
1731503928472,MMW 12,B20,751083,Adamiak; Patrick John,16,0,16,0
1731503928472,MMW 12,B21,751084,Adamiak; Patrick John,15,0,16,1
1731503928472,MMW 12,B22,751085,Adamiak; Patrick John,15,0,16,1
1731503928472,MMW 12,C01,751087,Herbst; Matthew,16,0,16,0
1731503928472,MMW 12,C02,751088,Herbst; Matthew,16,0,16,0
1731503928472,MMW 12,C03,751090,Herbst; Matthew,16,0,16,0
1731503928472,MMW 12,C04,751091,Herbst; Matthew,16,0,16,0
1731503928472,MMW 12,C05,751092,Herbst; Matthew,14,0,16,2
1731503928472,MMW 12,C06,751093,Herbst; Matthew,16,0,16,0
1731503928472,MMW 12,C07,751094,Herbst; Matthew,15,0,16,1
1731503928472,MMW 12,C08,751096,Herbst; Matthew,16,0,16,0
1731503928472,MMW 12,C09,751097,Herbst; Matthew,16,0,16,0
1731503928472,MMW 12,C10,751098,Herbst; Matthew,15,0,16,1
1731503928472,MMW 12,C11,751099,Herbst; Matthew,16,0,16,0
1731503928472,MMW 12,C12,751100,Herbst; Matthew,16,0,16,0
1731503928472,MMW 12,C13,751101,Herbst; Matthew,15,0,16,1
1731503928472,MMW 12,C14,751102,Herbst; Matthew,16,0,16,0
1731503928472,MMW 12,C15,751103,Herbst; Matthew,0,0,0,0
1731503928472,MMW 12,C16,751105,Herbst; Matthew,0,0,0,0
1731503928472,MMW 12,C17,751106,Herbst; Matthew,16,0,16,0
1731503928472,MMW 12,C18,751107,Herbst; Matthew,16,0,16,0
1731503928472,MMW 12,C19,751108,Herbst; Matthew,16,0,16,0
1731503928472,MMW 12,C20,751110,Herbst; Matthew,16,0,16,0
1731503928472,MMW 12,C21,751112,Herbst; Matthew,0,0,0,0
1731503928472,MMW 12,C22,751113,Herbst; Matthew,0,0,0,0
1731503929500,MMW 14,A01,751190,Chang; Edmond Yi-Teh,25,0,28,3
1731503929500,MMW 14,A02,751227,Chang; Edmond Yi-Teh,27,0,28,1
1731503929500,MMW 14,A03,751235,Chang; Edmond Yi-Teh,0,0,0,0
1731503929500,MMW 14,A04,751248,Chang; Edmond Yi-Teh,0,0,0,0
1731503929500,MMW 14,A05,751249,Chang; Edmond Yi-Teh,27,0,28,1
1731503929500,MMW 14,A06,751253,Chang; Edmond Yi-Teh,25,0,28,3
1731503929500,MMW 14,B01,751265,Hertz; Deborah,24,0,28,4
1731503929500,MMW 14,B02,751266,Hertz; Deborah,22,0,28,6
1731503929500,MMW 14,B03,751267,Hertz; Deborah,0,0,0,0
1731503929500,MMW 14,B04,751270,Hertz; Deborah,24,0,28,4
1731503929500,MMW 14,B05,751273,Hertz; Deborah,28,0,28,0
1731503929500,MMW 14,C01,751386,Herbst; Matthew,0,0,0,0
1731503930529,MMW 122,A01,751389,Peterson; Johanna L,23,0,27,4
1731503930529,MMW 122,A02,751424,Peterson; Johanna L,25,0,27,2
1731503930529,MMW 122,A03,751435,Peterson; Johanna L,27,0,27,0
1731503930529,MMW 122,A04,751437,Peterson; Johanna L,27,0,27,0
1731503930529,MMW 122,A05,751438,Peterson; Johanna L,27,0,27,0
1731503930529,MMW 122,A06,751440,Peterson; Johanna L,27,0,27,0
1731503930529,MMW 122,A07,751441,Peterson; Johanna L,0,0,0,0
1731503930529,MMW 122,A08,751442,Peterson; Johanna L,0,0,0,0
1731503930529,MMW 122,A09,751443,Peterson; Johanna L,27,0,27,0
1731503930529,MMW 122,A10,751444,Peterson; Johanna L,26,0,27,1
1731503930529,MMW 122,A11,751448,Peterson; Johanna L,0,0,0,0
1731503930529,MMW 122,A12,751493,Peterson; Johanna L,0,0,0,0
1731503930529,MMW 122,B01,751497,Rahimi; Babak,26,0,27,1
1731503930529,MMW 122,B02,751501,Rahimi; Babak,25,0,27,2
1731503930529,MMW 122,B03,751504,Rahimi; Babak,26,0,27,1
1731503930529,MMW 122,B04,751505,Rahimi; Babak,27,0,27,0
1731503930529,MMW 122,B05,751526,Rahimi; Babak,22,0,27,5
1731503930529,MMW 122,B06,751528,Rahimi; Babak,27,0,27,0
1731503930529,MMW 122,B07,751531,Rahimi; Babak,26,0,27,1
1731503930529,MMW 122,B08,751533,Rahimi; Babak,26,0,27,1
1731503930529,MMW 122,B09,751534,Rahimi; Babak,0,0,0,0
1731503930529,MMW 122,B10,751535,Rahimi; Babak,0,0,0,0
1731503930529,MMW 122,C01,751538,Herbst; Matthew,0,0,0,0
1731503931554,MSED 295,A00,751699,Staff,5,0,5,0
1731503932580,MUS 1B,A01,755885,Staff,20,0,25,5
1731503932580,MUS 1B,A02,755889,Staff,21,0,25,4
1731503932580,MUS 1B,A03,755890,Staff,23,0,25,2
1731503932580,MUS 1B,A04,755891,Staff,25,0,25,0
1731503933606,MUS 2B,A01,755895,Carlson; Erik,30,0,30,0
1731503934638,MUS 2BK,A00,755896,Ohnishi; Takae,12,0,15,3
1731503934638,MUS 2BK,B00,755897,Ohnishi; Takae,15,0,15,0
1731503935680,MUS 4,A01,755899,Day; Kevin Alexander,24,0,25,1
1731503935680,MUS 4,A02,755900,Day; Kevin Alexander,25,0,25,0
1731503935680,MUS 4,A03,755901,Day; Kevin Alexander,25,0,25,0
1731503935680,MUS 4,A04,755902,Day; Kevin Alexander,25,0,25,0
1731503935680,MUS 4,A05,755903,Day; Kevin Alexander,25,0,25,0
1731503935680,MUS 4,A06,755904,Day; Kevin Alexander,25,0,25,0
1731503935680,MUS 4,A07,755926,Day; Kevin Alexander,25,0,25,0
1731503935680,MUS 4,A08,755927,Day; Kevin Alexander,24,0,25,1
1731503935680,MUS 4,A09,755951,Day; Kevin Alexander,25,0,25,0
1731503935680,MUS 4,A10,755952,Day; Kevin Alexander,25,0,25,0
1731503936711,MUS 6,A01,755954,Freitas Caetano; Marcelo,25,0,25,0
1731503936711,MUS 6,A02,755955,Freitas Caetano; Marcelo,22,0,25,3
1731503936711,MUS 6,A03,755982,Freitas Caetano; Marcelo,22,0,25,3
1731503936711,MUS 6,A04,755983,Freitas Caetano; Marcelo,25,0,25,0
1731503937744,MUS 9,A01,756195,Staff,19,0,20,1
1731503937744,MUS 9,A02,756197,Staff,20,0,20,0
1731503937744,MUS 9,A03,756198,Staff,20,0,20,0
1731503937744,MUS 9,A04,756199,Staff,20,0,20,0
1731503937744,MUS 9,A05,756201,Staff,20,0,20,0
1731503937744,MUS 9,A06,756209,Staff,20,0,20,0
1731503938773,MUS 12,A01,756214,Davis; Anthony Curtis,25,0,25,0
1731503938773,MUS 12,A02,756219,Davis; Anthony Curtis,24,0,25,1
1731503938773,MUS 12,A03,756221,Davis; Anthony Curtis,25,0,25,0
1731503938773,MUS 12,A04,756223,Davis; Anthony Curtis,25,0,25,0
1731503939802,MUS 13,A01,756228,Leslie Santana; Myrta,22,0,25,3
1731503939802,MUS 13,A02,756233,Leslie Santana; Myrta,21,0,25,4
1731503939802,MUS 13,A03,756234,Leslie Santana; Myrta,25,0,25,0
1731503939802,MUS 13,A04,756237,Leslie Santana; Myrta,25,0,25,0
1731503940834,MUS 15,A01,756244,Narucki; Susan M,23,0,25,2
1731503940834,MUS 15,A02,756250,Narucki; Susan M,23,0,25,2
1731503940834,MUS 15,A03,756256,Narucki; Susan M,23,0,25,2
1731503940834,MUS 15,A04,756259,Narucki; Susan M,25,0,25,0
1731503940834,MUS 15,A05,756262,Narucki; Susan M,24,0,25,1
1731503940834,MUS 15,A06,756269,Narucki; Susan M,22,0,25,3
1731503940834,MUS 15,A07,756273,Narucki; Susan M,25,0,25,0
1731503940834,MUS 15,A08,756280,Narucki; Susan M,23,0,25,2
1731503940834,MUS 15,A09,756281,Narucki; Susan M,25,0,25,0
1731503940834,MUS 15,A10,756282,Narucki; Susan M,23,0,25,2
1731503941863,MUS 17,A01,756669,Staff,23,0,25,2
1731503941863,MUS 17,A02,756673,Staff,23,0,25,2
1731503941863,MUS 17,A03,756674,Staff,17,0,25,8
1731503941863,MUS 17,A04,756675,Staff,24,0,25,1
1731503941863,MUS 17,A05,756679,Staff,25,0,25,0
1731503941863,MUS 17,A06,756683,Staff,21,0,25,4
1731503941863,MUS 17,A07,756689,Staff,25,0,25,0
1731503941863,MUS 17,A08,756693,Staff,24,0,25,1
1731503941863,MUS 17,A09,756695,Staff,24,0,25,1
1731503941863,MUS 17,A10,756697,Staff,24,0,25,1
1731503941863,MUS 17,A11,756701,Staff,23,0,25,2
1731503941863,MUS 17,A12,756703,Staff,24,0,25,1
1731503942905,MUS 20R,A01,797703,Borgo; David Garcia,7,0,25,18
1731503942905,MUS 20R,A02,797705,Borgo; David Garcia,24,0,25,1
1731503942905,MUS 20R,A03,797779,Borgo; David Garcia,23,0,25,2
1731503942905,MUS 20R,A04,797780,Borgo; David Garcia,25,0,25,0
1731503942905,MUS 20R,A05,797816,Borgo; David Garcia,23,0,25,2
1731503942905,MUS 20R,A06,797825,Borgo; David Garcia,25,0,25,0
1731503942905,MUS 20R,A07,797826,Borgo; David Garcia,24,0,25,1
1731503942905,MUS 20R,A08,797831,Borgo; David Garcia,21,0,25,4
1731503942905,MUS 20R,B01,798362,Borgo; David Garcia,3,0,3,0
1731503942905,MUS 20R,B02,798369,Borgo; David Garcia,3,0,3,0
1731503942905,MUS 20R,B03,798370,Borgo; David Garcia,3,0,3,0
1731503942905,MUS 20R,B04,798372,Borgo; David Garcia,3,0,3,0
1731503942905,MUS 20R,B05,798375,Borgo; David Garcia,3,0,3,0
1731503942905,MUS 20R,B06,798377,Borgo; David Garcia,3,0,3,0
1731503942905,MUS 20R,B07,798378,Borgo; David Garcia,3,0,3,0
1731503942905,MUS 20R,B08,798379,Borgo; David Garcia,3,0,3,0
1731503943943,MUS 32,001,735915,Dresser; Mark Stuart,10,0,10,0
1731503943943,MUS 32,002,735917,Curtis; Charles Rector,10,0,10,0
1731503943943,MUS 32,003,735920,Terrazas Perez; Wilfrido D,10,0,10,0
1731503943943,MUS 32,004,735921,Ohnishi; Takae,10,0,10,0
1731503943943,MUS 32,005,735923,Carlson; Erik,10,0,10,0
1731503943943,MUS 32,006,735924,Staff,10,0,10,0
1731503943943,MUS 32,007,735926,Staff,10,0,10,0
1731503944973,MUS 32V,A00,756706,Staff,10,0,10,0
1731503944973,MUS 32V,B00,756709,Staff,10,0,10,0
1731503946001,MUS 32VM,A00,756713,Staff,15,0,15,0
1731503947031,MUS 43,A00,756714,Yadegari; Shahrokh D,90,0,96,6
1731503948060,MUS 95C,A00,756725,Staff,38,0,40,2
1731503949087,MUS 95D,A00,756726,Yadegari; Shahrokh D,30,0,30,0
1731503950170,MUS 95E,A00,756730,Staff,40,0,40,0
1731503951199,MUS 95F,A00,756732,Staff,40,0,40,0
1731503952228,MUS 95G,A00,756742,Anderson; Kenneth,386,0,395,9
1731503952228,MUS 95G,B00,756743,Anderson; Kenneth,389,0,395,6
1731503953258,MUS 95JC,A00,756745,Kenyatta; Kamau,25,0,25,0
1731503954285,MUS 95L,A00,756749,Staff,65,0,65,0
1731503955310,MUS 95P,A00,756975,Nourai; Keyavash,20,0,20,0
1731503956336,MUS 95W,A00,756976,Seshadri; Kartik,28,0,30,2
1731503956336,MUS 95W,B00,756977,Seshadri; Kartik,30,0,30,0
1731503957366,MUS 101B,A01,757168,Day; Kevin Alexander,35,0,35,0
1731503958394,MUS 103B,A00,757172,Steiger; Rand,15,0,15,0
1731503959422,MUS 103E,A00,757173,Staff,10,0,10,0
1731503960449,MUS 107,A00,757174,Roberts; Matana,15,0,15,0
1731503961476,MUS 111,A00,757176,Guy; Nancy,117,0,120,3
1731503962504,MUS 113,A00,757178,Curtis; Charles Rector,30,0,30,0
1731503963529,MUS 114,A00,757179,Terrazas Perez; Wilfrido D,135,0,140,5
1731503964558,MUS 120B,A01,757182,Leslie Santana; Myrta,25,0,25,0
1731503965584,MUS 127,A00,757183,Dresser; Mark Stuart,94,0,100,6
1731503966610,MUS 130,A00,757185,Ohnishi; Takae,35,0,35,0
1731503967639,MUS 132,001,736011,Dresser; Mark Stuart,10,0,10,0
1731503967639,MUS 132,002,736012,Curtis; Charles Rector,10,0,10,0
1731503967639,MUS 132,003,736013,Terrazas Perez; Wilfrido D,10,0,10,0
1731503967639,MUS 132,004,736014,Ohnishi; Takae,10,0,10,0
1731503967639,MUS 132,005,736015,Carlson; Erik,10,0,10,0
1731503967639,MUS 132,006,736016,Staff,10,0,10,0
1731503967639,MUS 132,007,736017,Nourai; Keyavash,10,0,10,0
1731503967639,MUS 132,008,736018,Schick; Steven,10,0,10,0
1731503968669,MUS 132R,A00,757187,Narucki; Susan M,2,0,2,0
1731503969694,MUS 132V,A00,757189,Narucki; Susan M,15,0,15,0
1731503969694,MUS 132V,B00,757190,Staff,15,0,15,0
1731503970723,MUS 134,A00,757192,Yadegari; Shahrokh D,30,0,30,0
1731503971753,MUS 137B,A00,757193,Kenyatta; Kamau,34,0,35,1
1731503972778,MUS 143,A00,757194,Yadegari; Shahrokh D,27,0,31,4
1731503973805,MUS 160A,A00,757195,Dubnov; Shlomo,14,0,15,1
1731503973805,MUS 160A,B00,757198,Smythe; Cory Benjamin,15,0,15,0
1731503974832,MUS 171,A01,757200,Smyth; Tamara R.,47,0,65,18
1731503975860,MUS 173B,A01,757203,Britt; King James,25,0,25,0
1731503976886,MUS 174B,A00,757204,Britt; King James,18,0,25,7
1731503977912,MUS 176,A00,757205,Lou; Michelle Siulai,20,0,20,0
1731503978943,MUS 201A,A00,757207,Dresser; Mark Stuart,15,0,15,0
1731503979969,MUS 201B,A00,757208,Yadegari; Shahrokh D,13,0,15,2
1731503979969,MUS 201B,B00,757210,Roberts; Matana,13,0,15,2
1731503980998,MUS 201C,A00,757211,Schick; Steven,15,0,15,0
1731503982026,MUS 202,A00,795573,Schick; Steven,14,0,15,1
1731503983051,MUS 203B,A00,757213,Obermueller; Karola,14,0,15,1
1731503984084,MUS 203D,A00,757214,Davis; Anthony Curtis,10,0,10,0
1731503984084,MUS 203D,B00,757215,Lou; Michelle Siulai,10,0,10,0
1731503984084,MUS 203D,C00,757216,Obermueller; Karola,9,0,10,1
1731503984084,MUS 203D,D00,757217,Steiger; Rand,10,0,10,0
1731503984084,MUS 203D,E00,757218,McCormack; Timothy Matthew,10,0,10,0
1731503984084,MUS 203D,F00,795580,Liang; Lei,10,0,10,0
1731503985110,MUS 204,A00,757219,Lou; Michelle Siulai,13,0,15,2
1731503986136,MUS 205,A00,757220,Hankins; Sarah E.,13,0,15,2
1731503987161,MUS 206,A00,757221,Hankins; Sarah E.,14,0,15,1
1731503987161,MUS 206,B00,757222,Narucki; Susan M,14,0,15,1
1731503987161,MUS 206,C00,795581,Smythe; Cory Benjamin,15,0,15,0
1731503988185,MUS 207,A00,757223,Guy; Nancy,14,0,15,1
1731503989211,MUS 210,A00,757224,McCormack; Timothy Matthew,13,0,15,2
1731503990241,MUS 215D,A00,757225,Cimini; Amy Marie,14,0,15,1
1731503991265,MUS 232,001,736044,Dresser; Mark Stuart,10,0,10,0
1731503991265,MUS 232,002,736045,Curtis; Charles Rector,10,0,10,0
1731503991265,MUS 232,003,736046,Terrazas Perez; Wilfrido D,9,0,10,1
1731503991265,MUS 232,004,736047,Ohnishi; Takae,10,0,10,0
1731503991265,MUS 232,005,736048,Carlson; Erik,10,0,10,0
1731503991265,MUS 232,006,736049,Narucki; Susan M,9,0,10,1
1731503991265,MUS 232,007,736050,Staff,10,0,10,0
1731503991265,MUS 232,008,736051,Schick; Steven,10,0,10,0
1731503992291,MUS 234,A00,757226,Yadegari; Shahrokh D,20,0,20,0
1731503993316,MUS 245,A00,757230,Carlson; Erik,19,0,20,1
1731503994346,MUS 267,A00,757231,Smyth; Tamara R.,18,0,20,2
1731503995426,MUS 270D,A00,795583,Freitas Caetano; Marcelo,20,0,20,0
1731503996455,MUS 271A,A00,757235,Erbe; Tom,19,0,20,1
1731503997483,NANO 11,A00,757236,Fenning; David,100,0,100,0
1731503998515,NANO 15,A01,757238,Yang; Kesong,25,0,25,0
1731503999545,NANO 104,A00,757239,Vazquez Mena; Oscar,68,0,70,2
1731504000575,NANO 107,A01,757272,Cubukcu; Ertugrul,69,0,70,1
1731504001603,NANO 114,A00,757277,Jahed Motlagh; Zeinab,38,0,40,2
1731504002631,NANO 117,A00,757280,Cubukcu; Ertugrul,68,0,70,2
1731504003659,NANO 120A,A01,757286,Sirbuly; Donald,30,0,35,5
1731504003659,NANO 120A,B01,757294,Jokerst; Jesse Vincent,35,0,35,0
1731504004697,NANO 134,A00,757295,Pokorski; Jonathan Kyle,35,0,40,5
1731504005725,NANO 141A,A00,757296,Lubarda; Vlado,38,0,40,2
1731504006758,NANO 168,A00,757297,Fullerton; Eric E,37,0,40,3
1731504007784,NANO 200,A00,757302,Jahed Motlagh; Zeinab,88,0,120,32
1731504008810,NANO 203,A00,757314,Fenning; David,20,0,60,40
1731504009839,NANO 204,A00,757315,Li; Wan-Lu,28,0,30,2
1731504010865,NANO 205,A00,757323,Jokerst; Jesse Vincent,46,0,60,14
1731504011896,NANO 206,A00,757326,Chen; Shaochen,26,0,60,34
1731504012921,NANO 247B,A00,757331,Wang; Joseph,25,0,35,10
1731504013952,NANO 252,A00,757334,Meyers; Marc,16,0,20,4
1731504014983,NANO 265,A00,757355,Luo; Jian,8,0,10,2
1731504016014,NANO 272,A00,757357,Xu; Sheng,43,0,50,7
1731504017040,NEU 200B,A00,765050,Abdel-Azim; Eiman,0,0,0,0
1731504018068,NEU 276,A01,765052,Dore; Kim Bohemie,26,0,28,2
1731504019102,NEU 296,001,791944,Evans; Sean Jeffrey,5,0,10,5
1731504019102,NEU 296,002,791945,Graves; Jennifer Sharon Ol,9,0,10,1
1731504019102,NEU 296,003,791948,Staff,10,0,10,0
1731504020127,NEUG 221,A00,765055,Staff,7,0,12,5
1731504021154,NEUG 257,A01,765057,Halgren; Eric,16,0,18,2
1731504022183,NEUG 296,A00,765058,Bloodgood; Brenda Laurie,9998,0,9999,1
1731504023209,OPTH 296,001,792241,Baxter; Sally Liu,9,0,10,1
1731504023209,OPTH 296,002,792242,Staff,10,0,10,0
1731504023209,OPTH 296,003,792243,Staff,10,0,10,0
1731504024237,ORTH 296,001,792255,Staff,10,0,10,0
1731504024237,ORTH 296,002,792256,Staff,10,0,10,0
1731504024237,ORTH 296,003,792257,Staff,10,0,10,0
1731504025268,PAE 230,A00,791542,Villarreal Jr.; Elias,30,0,30,0
1731504026294,PAE 231,A00,791543,Villarreal Jr.; Elias,30,0,30,0
1731504027319,PAE 232,A00,791544,Villarreal Jr.; Elias,30,0,30,0
1731504028345,PAE 233,A00,791545,Villarreal Jr.; Elias,30,0,30,0
1731504029372,PAE 234,A01,791547,Villarreal Jr.; Elias,30,0,30,0
1731504030401,PAE 235,A01,791549,Villarreal Jr.; Elias,30,0,30,0
1731504031428,PAE 236,A00,791550,Villarreal Jr.; Elias,30,0,30,0
1731504032465,PATH 221,A00,761937,Yang; Jing,0,0,0,0
1731504033492,PATH 224,A01,799580,Ross; Camille,20,0,20,0
1731504034519,PATH 225,A01,797833,Klemke; Richard,25,0,25,0
1731504035548,PATH 296,001,792280,Staff,10,0,10,0
1731504035548,PATH 296,002,792282,Staff,10,0,10,0
1731504035548,PATH 296,003,792283,Staff,10,0,10,0
1731504036575,PEDS 296,001,792351,Staff,10,0,10,0
1731504036575,PEDS 296,002,792352,Staff,10,0,10,0
1731504036575,PEDS 296,003,792354,Staff,10,0,10,0
1731504037606,PH 40,A00,746085,Larsen; Britta Ann,94,0,100,6
1731504038635,PH 45,A01,785847,Stone; Matthew David,26,0,30,4
1731504038635,PH 45,A02,785848,Stone; Matthew David,26,0,30,4
1731504038635,PH 45,A03,785880,Stone; Matthew David,0,0,0,0
1731504038635,PH 45,A04,785898,Stone; Matthew David,0,0,0,0
1731504039667,PH 91,A00,746164,Harrell; Maralee Mae,100,0,100,0
1731504040696,PH 95,A00,746180,Larsen; Britta Ann,30,0,30,0
1731504041727,PH 98,A00,799480,Larsen; Britta Ann,0,0,0,0
1731504042756,PH 101,A00,746187,Tan; Gene Brian,28,0,40,12
1731504042756,PH 101,B00,746272,Miller; Lindsay Morgan,35,0,40,5
1731504043789,PH 102,A01,785945,Rana; Brinda Kanti,21,0,30,9
1731504043789,PH 102,A02,785966,Rana; Brinda Kanti,24,0,30,6
1731504044821,PH 110,A00,746301,Hartman; Sheri R,55,0,55,0
1731504044821,PH 110,B00,746625,Hartman; Sheri R,40,0,45,5
1731504045848,PH 120,A00,746626,Long; Kanya Claudine,49,0,55,6
1731504046875,PH 130,A00,746635,Kayser; Georgia Lyn,57,0,65,8
1731504047903,PH 161,A00,746643,Zoumas-Morse; Christine E.,55,0,60,5
1731504048933,PH 172,A00,746647,Ryan; Margaret Angela Kapp,35,0,40,5
1731504049962,PH 193,A00,746656,Staff,0,0,0,0
1731504049962,PH 193,B00,746659,Staff,0,0,0,0
1731504049962,PH 193,C00,746662,Staff,0,0,0,0
1731504049962,PH 193,D00,746667,Staff,0,0,0,0
1731504049962,PH 193,E00,746679,Staff,0,0,0,0
1731504049962,PH 193,F00,746683,Staff,0,0,0,0
1731504050988,PH 194,A00,746685,Nguyen; Annie Lu,0,0,0,0
1731504052017,PH 196AH,A01,746696,Binkin; Nancy Jeanne,20,0,20,0
1731504053045,PHAR 222,A00,761971,Yang; Jing,20,0,20,0
1731504054076,PHAR 255,A00,761972,Joiner; William J.,24,0,24,0
1731504055105,PHAR 275,A01,761977,Antal; Corina Elena & Obara; Christopher & Mendiola; Andrew & Gonzalez; David J,10,0,10,0
1731504056133,PHAR 295,A00,761978,Joiner; William J.,9,0,10,1
1731504057160,PHB 222,A00,746697,Messer; Karen Sue,30,0,50,20
1731504058188,PHB 226,A00,746698,Tu; Xin,15,0,25,10
1731504059220,PHB 243B,A01,746710,Thomas; Ronald G,9,0,20,11
1731504060250,PHB 244B,A00,746823,Vaida; Florin,24,0,45,21
1731504061279,PHB 280,A00,746910,Natarajan; Loki,48,0,75,27
1731504062304,PHB 291,A00,795411,Staff,14,0,25,11
1731504063333,PHIL 10,A01,761088,Carr; Jennifer Rose,39,0,44,5
1731504063333,PHIL 10,A02,761090,Carr; Jennifer Rose,44,0,44,0
1731504063333,PHIL 10,A03,761092,Carr; Jennifer Rose,42,0,44,2
1731504063333,PHIL 10,A04,761096,Carr; Jennifer Rose,44,0,44,0
1731504063333,PHIL 10,A05,761198,Carr; Jennifer Rose,44,0,44,0
1731504063333,PHIL 10,A06,761200,Carr; Jennifer Rose,43,0,44,1
1731504063333,PHIL 10,A07,761236,Carr; Jennifer Rose,44,0,44,0
1731504063333,PHIL 10,A08,761241,Carr; Jennifer Rose,43,0,44,1
1731504063333,PHIL 10,A09,761243,Carr; Jennifer Rose,0,0,0,0
1731504063333,PHIL 10,A10,761244,Carr; Jennifer Rose,0,0,0,0
1731504064363,PHIL 12,A01,761252,Kovaka; Karenc,29,0,30,1
1731504064363,PHIL 12,A02,761254,Kovaka; Karenc,0,0,0,0
1731504064363,PHIL 12,A03,761277,Kovaka; Karenc,30,0,30,0
1731504064363,PHIL 12,A04,761278,Kovaka; Karenc,29,0,30,1
1731504064363,PHIL 12,A05,761279,Kovaka; Karenc,30,0,30,0
1731504064363,PHIL 12,A06,761280,Kovaka; Karenc,29,0,30,1
1731504064363,PHIL 12,A07,761281,Kovaka; Karenc,30,0,30,0
1731504064363,PHIL 12,A08,761282,Kovaka; Karenc,0,0,0,0
1731504065391,PHIL 16,A00,761283,Harrell; Maralee Mae,31,0,33,2
1731504066423,PHIL 24,A00,761284,Callender; Craig Adam,120,0,120,0
1731504067456,PHIL 27,A01,761286,Lamey; Andy M.,17,0,25,8
1731504067456,PHIL 27,A02,761287,Lamey; Andy M.,18,0,25,7
1731504067456,PHIL 27,A03,761288,Lamey; Andy M.,0,0,0,0
1731504067456,PHIL 27,A04,761289,Lamey; Andy M.,0,0,0,0
1731504067456,PHIL 27,A05,761292,Lamey; Andy M.,21,0,25,4
1731504067456,PHIL 27,A06,761294,Lamey; Andy M.,20,0,25,5
1731504068490,PHIL 28,A01,761401,Brandt; Reuven A,16,0,25,9
1731504068490,PHIL 28,A02,761404,Brandt; Reuven A,23,0,25,2
1731504068490,PHIL 28,A03,761406,Brandt; Reuven A,23,0,25,2
1731504068490,PHIL 28,A04,761425,Brandt; Reuven A,18,0,25,7
1731504068490,PHIL 28,A05,761427,Brandt; Reuven A,25,0,25,0
1731504068490,PHIL 28,A06,761433,Brandt; Reuven A,23,0,25,2
1731504068490,PHIL 28,A07,761434,Brandt; Reuven A,0,0,0,0
1731504068490,PHIL 28,A08,761438,Brandt; Reuven A,0,0,0,0
1731504068490,PHIL 28,A09,761571,Brandt; Reuven A,8,0,25,17
1731504068490,PHIL 28,A10,761572,Brandt; Reuven A,24,0,25,1
1731504069518,PHIL 32,A01,761605,Johnson; Monte,23,0,25,2
1731504069518,PHIL 32,A02,761606,Johnson; Monte,25,0,25,0
1731504070544,PHIL 35,A00,761621,Marechal; Patricia,175,0,180,5
1731504071571,PHIL 51,A00,761645,Kovaka; Karenc,216,0,216,0
1731504072598,PHIL 90,A00,761646,Rudolph; Rachel Etta,31,0,33,2
1731504072598,PHIL 90,B00,761648,Kocurek; Alexander William,32,0,33,1
1731504073629,PHIL 100,A00,761696,Marechal; Patricia,24,0,32,8
1731504074658,PHIL 107,A00,761697,Tolley; Clinton,33,0,33,0
1731504075691,PHIL 111,A00,761698,Watkins; Eric,39,0,40,1
1731504076719,PHIL 122,A00,761699,Sher; Gila,31,0,33,2
1731504077747,PHIL 132,A00,761700,Sher; Gila,31,0,33,2
1731504078798,PHIL 136,A00,761701,Grush; Rick Scott,31,0,33,2
1731504079830,PHIL 138,A00,761721,Vargas; Manuel Rogelio,58,0,60,2
1731504080863,PHIL 149,A00,761738,Fulkerson; Matthew Todd,113,0,120,7
1731504081893,PHIL 163,A01,761771,Brandt; Reuven A,23,0,25,2
1731504081893,PHIL 163,A02,761774,Brandt; Reuven A,22,0,25,3
1731504081893,PHIL 163,A03,761778,Brandt; Reuven A,22,0,25,3
1731504081893,PHIL 163,A04,761785,Brandt; Reuven A,24,0,25,1
1731504081893,PHIL 163,A05,761810,Brandt; Reuven A,0,0,0,0
1731504081893,PHIL 163,A06,761819,Brandt; Reuven A,19,0,25,6
1731504081893,PHIL 163,A07,761823,Brandt; Reuven A,18,0,25,7
1731504081893,PHIL 163,A08,761827,Brandt; Reuven A,0,0,0,0
1731504081893,PHIL 163,A09,761833,Brandt; Reuven A,24,0,25,1
1731504081893,PHIL 163,A10,761840,Brandt; Reuven A,23,0,25,2
1731504082919,PHIL 167,A00,761841,Lamey; Andy M.,29,0,33,4
1731504083944,PHIL 176,A00,761843,Vargas; Manuel Rogelio,32,0,33,1
1731504084975,PHIL 177,A00,761848,Shields; Christopher John,33,0,33,0
1731504086004,PHIL 185,A00,794683,Shields; Christopher John,30,0,33,3
1731504088067,PHIL 191B,A00,799969,Tolley; Clinton,2,0,2,0
1731504088067,PHIL 191B,B00,799970,Bazargan-Forward; Saba,1,0,1,0
1731504089095,PHIL 201A,A00,761865,Tolley; Clinton,18,0,20,2
1731504090122,PHIL 206A,A00,761866,Carr; Jennifer Rose,17,0,20,3
1731504091147,PHIL 209C,A00,761870,McKenzie; Kerry V.,5,0,5,0
1731504092174,PHIL 209D,A00,761873,Lampland; Martha,5,0,5,0
1731504093202,PHIL 210,A00,761878,Johnson; Monte,19,0,20,1
1731504094228,PHIL 245,A00,761883,Cartwright; Nancy D.,14,0,20,6
1731504095260,PHIL 260,A00,761889,Bazargan-Forward; Saba & Yuan; Yuan,20,0,20,0
1731504096289,PHIL 271,A00,761891,Vargas; Manuel Rogelio & Fulkerson; Matthew Todd,10,0,10,0
1731504097315,PHIL 275,A00,761899,Watkins; Eric,10,0,10,0
1731504098342,PHIL 277,A00,761911,Tolley; Clinton,8,0,10,2
1731504099369,PHIL 278,A00,761919,Fulkerson; Matthew Todd & Cohen; Jonathan David,10,0,10,0
1731504100393,PHIL 280,A00,761930,Kovaka; Karenc,9999,0,9999,0
1731504113967,PHIL 281,A00,761931,Tolley; Clinton,10,0,10,0
1731504114997,PHIL 283,A00,794690,Tolley; Clinton & Vargas; Manuel Rogelio,10,0,10,0
1731504116024,PHIL 284,A00,761932,Kovaka; Karenc,10,0,10,0
1731504117055,PHIL 286,A00,761933,Chen; Keming & Callender; Craig Adam,10,0,10,0
1731504118080,PHIL 287,A00,761935,Johnson; Monte,10,0,10,0
1731504119115,PHIL 290,001,776411,Nelkin; Dana Kay,9999,0,9999,0
1731504119115,PHIL 290,002,776412,Bazargan-Forward; Saba,9999,0,9999,0
1731504119115,PHIL 290,003,776413,Brandt; Reuven A,9999,0,9999,0
1731504119115,PHIL 290,004,776414,Brink; David O.,9999,0,9999,0
1731504119115,PHIL 290,005,776415,Callender; Craig Adam,9999,0,9999,0
1731504119115,PHIL 290,006,776416,Carr; Jennifer Rose,9999,0,9999,0
1731504119115,PHIL 290,007,776483,Cartwright; Nancy D.,9999,0,9999,0
1731504119115,PHIL 290,008,776498,Cohen; Jonathan David,9999,0,9999,0
1731504119115,PHIL 290,009,776743,Danks; David J,9999,0,9999,0
1731504119115,PHIL 290,010,776746,Fulkerson; Matthew Todd,9999,0,9999,0
1731504119115,PHIL 290,011,776753,Grush; Rick Scott,9999,0,9999,0
1731504119115,PHIL 290,012,776756,Hardimon; Michael O.,9999,0,9999,0
1731504119115,PHIL 290,013,776760,Harrell; Maralee Mae,9999,0,9999,0
1731504119115,PHIL 290,014,776761,Johnson; Monte,9999,0,9999,0
1731504119115,PHIL 290,015,776762,Kovaka; Karenc,9999,0,9999,0
1731504119115,PHIL 290,016,776763,Lamey; Andy M.,9999,0,9999,0
1731504119115,PHIL 290,017,776766,Marechal; Patricia,9999,0,9999,0
1731504119115,PHIL 290,018,776771,McKenzie; Kerry V.,9999,0,9999,0
1731504119115,PHIL 290,019,776778,Rickless; Samuel Charles,9999,0,9999,0
1731504119115,PHIL 290,020,776782,Sher; Gila,9999,0,9999,0
1731504119115,PHIL 290,021,776785,Shields; Christopher John,9999,0,9999,0
1731504119115,PHIL 290,022,776787,Tolley; Clinton,9999,0,9999,0
1731504119115,PHIL 290,023,776796,Vargas; Manuel Rogelio,9999,0,9999,0
1731504119115,PHIL 290,024,776799,Watkins; Eric,9999,0,9999,0
1731504119115,PHIL 290,025,776802,Chen; Keming,9999,0,9999,0
1731504119115,PHIL 290,026,794693,Rudolph; Rachel Etta,9999,0,9999,0
1731504119115,PHIL 290,027,794696,Kocurek; Alexander William,9999,0,9999,0
1731504119115,PHIL 290,028,794697,Yuan; Yuan,9999,0,9999,0
1731504120143,PHIL 295,001,776806,Bazargan-Forward; Saba,9999,0,9999,0
1731504120143,PHIL 295,002,776808,Brandt; Reuven A,9999,0,9999,0
1731504120143,PHIL 295,003,776811,Brink; David O.,9999,0,9999,0
1731504120143,PHIL 295,004,776818,Callender; Craig Adam,9999,0,9999,0
1731504120143,PHIL 295,005,776820,Carr; Jennifer Rose,9999,0,9999,0
1731504120143,PHIL 295,006,776821,Cartwright; Nancy D.,9999,0,9999,0
1731504120143,PHIL 295,007,776825,Chen; Keming,9999,0,9999,0
1731504120143,PHIL 295,008,776827,Cohen; Jonathan David,9999,0,9999,0
1731504120143,PHIL 295,009,776831,Danks; David J,9999,0,9999,0
1731504120143,PHIL 295,010,776840,Fulkerson; Matthew Todd,9999,0,9999,0
1731504120143,PHIL 295,011,776842,Grush; Rick Scott,9999,0,9999,0
1731504120143,PHIL 295,012,776846,Hardimon; Michael O.,9999,0,9999,0
1731504120143,PHIL 295,013,776933,Harrell; Maralee Mae,9999,0,9999,0
1731504120143,PHIL 295,014,776934,Johnson; Monte,9999,0,9999,0
1731504120143,PHIL 295,015,776941,Kovaka; Karenc,9999,0,9999,0
1731504120143,PHIL 295,016,776960,Lamey; Andy M.,9999,0,9999,0
1731504120143,PHIL 295,017,777007,Marechal; Patricia,9999,0,9999,0
1731504120143,PHIL 295,018,777008,McKenzie; Kerry V.,9999,0,9999,0
1731504120143,PHIL 295,019,777047,Nelkin; Dana Kay,9999,0,9999,0
1731504120143,PHIL 295,020,777237,Rickless; Samuel Charles,9999,0,9999,0
1731504120143,PHIL 295,021,777242,Sher; Gila,9999,0,9999,0
1731504120143,PHIL 295,022,777245,Shields; Christopher John,9999,0,9999,0
1731504120143,PHIL 295,023,777246,Tolley; Clinton,9999,0,9999,0
1731504120143,PHIL 295,024,777247,Vargas; Manuel Rogelio,9999,0,9999,0
1731504120143,PHIL 295,025,777248,Watkins; Eric,9999,0,9999,0
1731504120143,PHIL 295,026,794698,Rudolph; Rachel Etta,9999,0,9999,0
1731504120143,PHIL 295,027,794699,Kocurek; Alexander William,9999,0,9999,0
1731504120143,PHIL 295,028,794710,Yuan; Yuan,9999,0,9999,0
1731504121171,PHYS 1A,A00,759213,Tsai; Philbert S,330,0,360,30
1731504122201,PHYS 1AL,001,759214,Yagil; Avi & Tsai; Philbert S,25,0,30,5
1731504122201,PHYS 1AL,002,759215,Yagil; Avi & Tsai; Philbert S,29,0,30,1
1731504122201,PHYS 1AL,003,759216,Yagil; Avi & Tsai; Philbert S,28,0,30,2
1731504122201,PHYS 1AL,004,759217,Yagil; Avi & Tsai; Philbert S,28,0,30,2
1731504122201,PHYS 1AL,005,759218,Yagil; Avi & Tsai; Philbert S,21,0,30,9
1731504122201,PHYS 1AL,006,759219,Yagil; Avi & Tsai; Philbert S,28,0,30,2
1731504122201,PHYS 1AL,007,759220,Yagil; Avi & Tsai; Philbert S,26,0,30,4
1731504122201,PHYS 1AL,008,759221,Yagil; Avi & Tsai; Philbert S,30,0,30,0
1731504122201,PHYS 1AL,009,759222,Yagil; Avi & Tsai; Philbert S,28,0,30,2
1731504122201,PHYS 1AL,010,759223,Yagil; Avi & Tsai; Philbert S,27,0,30,3
1731504122201,PHYS 1AL,011,759225,Yagil; Avi & Tsai; Philbert S,26,0,30,4
1731504122201,PHYS 1AL,012,759226,Yagil; Avi & Tsai; Philbert S,28,0,30,2
1731504123231,PHYS 1B,A00,759229,Smith; Douglas E,573,0,600,27
1731504123231,PHYS 1B,B00,759230,Smith; Douglas E,575,0,600,25
1731504126685,PHYS 1BL,001,759232,Yagil; Avi & Tsai; Philbert S,29,0,30,1
1731504126685,PHYS 1BL,002,759233,Yagil; Avi & Tsai; Philbert S,28,0,30,2
1731504126685,PHYS 1BL,003,759235,Yagil; Avi & Tsai; Philbert S,20,0,30,10
1731504126685,PHYS 1BL,004,759236,Yagil; Avi & Tsai; Philbert S,23,0,30,7
1731504126685,PHYS 1BL,005,759237,Yagil; Avi & Tsai; Philbert S,30,0,30,0
1731504126685,PHYS 1BL,006,759238,Yagil; Avi & Tsai; Philbert S,27,0,30,3
1731504126685,PHYS 1BL,007,759239,Yagil; Avi & Tsai; Philbert S,26,0,30,4
1731504126685,PHYS 1BL,008,759240,Yagil; Avi & Tsai; Philbert S,30,0,30,0
1731504126685,PHYS 1BL,009,759241,Yagil; Avi & Tsai; Philbert S,26,0,30,4
1731504126685,PHYS 1BL,010,759242,Yagil; Avi & Tsai; Philbert S,29,0,30,1
1731504126685,PHYS 1BL,011,759243,Yagil; Avi & Tsai; Philbert S,28,0,30,2
1731504126685,PHYS 1BL,012,759244,Yagil; Avi & Tsai; Philbert S,29,0,30,1
1731504126685,PHYS 1BL,015,759248,Yagil; Avi & Tsai; Philbert S,20,0,30,10
1731504126685,PHYS 1BL,016,759250,Yagil; Avi & Tsai; Philbert S,26,0,30,4
1731504126685,PHYS 1BL,017,759254,Yagil; Avi & Tsai; Philbert S,20,0,30,10
1731504126685,PHYS 1BL,018,759256,Yagil; Avi & Tsai; Philbert S,27,0,30,3
1731504126685,PHYS 1BL,019,759257,Yagil; Avi & Tsai; Philbert S,30,0,30,0
1731504126685,PHYS 1BL,020,759259,Yagil; Avi & Tsai; Philbert S,27,0,30,3
1731504126685,PHYS 1BL,021,759260,Yagil; Avi & Tsai; Philbert S,30,0,30,0
1731504126685,PHYS 1BL,022,759261,Yagil; Avi & Tsai; Philbert S,29,0,30,1
1731504126685,PHYS 1BL,023,759262,Yagil; Avi & Tsai; Philbert S,29,0,30,1
1731504126685,PHYS 1BL,024,759265,Yagil; Avi & Tsai; Philbert S,30,0,30,0
1731504126685,PHYS 1BL,025,759266,Yagil; Avi & Tsai; Philbert S,28,0,30,2
1731504126685,PHYS 1BL,026,759270,Yagil; Avi & Tsai; Philbert S,28,0,30,2
1731504126685,PHYS 1BL,027,759271,Yagil; Avi & Tsai; Philbert S,27,0,30,3
1731504126685,PHYS 1BL,028,759275,Yagil; Avi & Tsai; Philbert S,29,0,30,1
1731504126685,PHYS 1BL,029,759276,Yagil; Avi & Tsai; Philbert S,27,0,30,3
1731504126685,PHYS 1BL,030,759277,Yagil; Avi & Tsai; Philbert S,29,0,30,1
1731504126685,PHYS 1BL,031,759278,Yagil; Avi & Tsai; Philbert S,27,0,30,3
1731504126685,PHYS 1BL,032,759280,Yagil; Avi & Tsai; Philbert S,30,0,30,0
1731504126685,PHYS 1BL,033,759298,Yagil; Avi & Tsai; Philbert S,30,0,30,0
1731504126685,PHYS 1BL,034,759338,Yagil; Avi & Tsai; Philbert S,30,0,30,0
1731504126685,PHYS 1BL,035,759363,Yagil; Avi & Tsai; Philbert S,26,0,30,4
1731504126685,PHYS 1BL,036,759376,Yagil; Avi & Tsai; Philbert S,28,0,30,2
1731504127716,PHYS 1C,A00,759402,Bal; Gurleen K,341,0,362,21
1731504128744,PHYS 1CL,001,759406,Yagil; Avi & Tsai; Philbert S,25,0,30,5
1731504128744,PHYS 1CL,002,759408,Yagil; Avi & Tsai; Philbert S,23,0,30,7
1731504128744,PHYS 1CL,003,759464,Yagil; Avi & Tsai; Philbert S,27,0,30,3
1731504128744,PHYS 1CL,004,759467,Yagil; Avi & Tsai; Philbert S,25,0,30,5
1731504128744,PHYS 1CL,005,759469,Yagil; Avi & Tsai; Philbert S,27,0,30,3
1731504128744,PHYS 1CL,006,794532,Yagil; Avi & Tsai; Philbert S,26,0,30,4
1731504128744,PHYS 1CL,007,794533,Yagil; Avi & Tsai; Philbert S,27,0,30,3
1731504128744,PHYS 1CL,008,794534,Yagil; Avi & Tsai; Philbert S,30,0,30,0
1731504128744,PHYS 1CL,009,794535,Yagil; Avi & Tsai; Philbert S,29,0,30,1
1731504128744,PHYS 1CL,010,794536,Yagil; Avi & Tsai; Philbert S,30,0,30,0
1731504128744,PHYS 1CL,011,794537,Yagil; Avi & Tsai; Philbert S,28,0,30,2
1731504128744,PHYS 1CL,012,794538,Yagil; Avi & Tsai; Philbert S,29,0,30,1
1731504129794,PHYS 2A,A01,759498,Bal; Gurleen K,30,0,30,0
1731504129794,PHYS 2A,A02,759546,Bal; Gurleen K,30,0,30,0
1731504129794,PHYS 2A,A03,759548,Bal; Gurleen K,30,0,30,0
1731504129794,PHYS 2A,A04,759549,Bal; Gurleen K,30,0,30,0
1731504129794,PHYS 2A,A05,759550,Bal; Gurleen K,29,0,30,1
1731504129794,PHYS 2A,A06,759551,Bal; Gurleen K,29,0,30,1
1731504129794,PHYS 2A,A07,759552,Bal; Gurleen K,30,0,30,0
1731504129794,PHYS 2A,A08,759553,Bal; Gurleen K,30,0,30,0
1731504129794,PHYS 2A,A09,759554,Bal; Gurleen K,30,0,30,0
1731504129794,PHYS 2A,A10,759555,Bal; Gurleen K,30,0,30,0
1731504129794,PHYS 2A,A11,759556,Bal; Gurleen K,30,0,30,0
1731504129794,PHYS 2A,A12,759558,Bal; Gurleen K,29,0,30,1
1731504129794,PHYS 2A,B01,759560,Dudko; Olga,26,0,30,4
1731504129794,PHYS 2A,B02,759561,Dudko; Olga,30,0,30,0
1731504129794,PHYS 2A,B03,759562,Dudko; Olga,30,0,30,0
1731504129794,PHYS 2A,B04,759563,Dudko; Olga,29,0,30,1
1731504129794,PHYS 2A,B05,759565,Dudko; Olga,27,0,30,3
1731504129794,PHYS 2A,B06,759566,Dudko; Olga,28,0,30,2
1731504129794,PHYS 2A,B07,759567,Dudko; Olga,24,0,30,6
1731504129794,PHYS 2A,B08,759568,Dudko; Olga,30,0,30,0
1731504129794,PHYS 2A,B09,759569,Dudko; Olga,27,0,30,3
1731504129794,PHYS 2A,B10,759611,Dudko; Olga,29,0,30,1
1731504129794,PHYS 2A,B11,759661,Dudko; Olga,24,0,30,6
1731504129794,PHYS 2A,B12,759664,Dudko; Olga,24,0,30,6
1731504130829,PHYS 2B,A01,759701,Shotwell; Brian,29,0,30,1
1731504130829,PHYS 2B,A02,759737,Shotwell; Brian,30,0,30,0
1731504130829,PHYS 2B,A03,759743,Shotwell; Brian,29,0,30,1
1731504130829,PHYS 2B,A04,759744,Shotwell; Brian,30,0,30,0
1731504130829,PHYS 2B,A05,759745,Shotwell; Brian,28,0,30,2
1731504130829,PHYS 2B,A06,759779,Shotwell; Brian,27,0,30,3
1731504130829,PHYS 2B,A07,759782,Shotwell; Brian,28,0,30,2
1731504130829,PHYS 2B,A08,759796,Shotwell; Brian,29,0,30,1
1731504130829,PHYS 2B,A09,759798,Shotwell; Brian,26,0,30,4
1731504130829,PHYS 2B,A10,759905,Shotwell; Brian,29,0,30,1
1731504130829,PHYS 2B,A11,759989,Shotwell; Brian,28,0,30,2
1731504130829,PHYS 2B,A12,759992,Shotwell; Brian,23,0,30,7
1731504131863,PHYS 2C,A01,759994,Jun; Suckjoon,22,0,30,8
1731504131863,PHYS 2C,A02,759995,Jun; Suckjoon,27,0,30,3
1731504131863,PHYS 2C,A03,759996,Jun; Suckjoon,30,0,30,0
1731504131863,PHYS 2C,A04,759997,Jun; Suckjoon,29,0,30,1
1731504131863,PHYS 2C,A05,760002,Jun; Suckjoon,30,0,30,0
1731504131863,PHYS 2C,A06,760021,Jun; Suckjoon,30,0,30,0
1731504131863,PHYS 2C,A07,760032,Jun; Suckjoon,28,0,30,2
1731504131863,PHYS 2C,A08,760035,Jun; Suckjoon,30,0,30,0
1731504131863,PHYS 2C,A09,760041,Jun; Suckjoon,30,0,30,0
1731504131863,PHYS 2C,A10,760042,Jun; Suckjoon,30,0,30,0
1731504131863,PHYS 2C,A11,760043,Jun; Suckjoon,30,0,30,0
1731504131863,PHYS 2C,A12,760044,Jun; Suckjoon,30,0,30,0
1731504132893,PHYS 2CL,A01,760046,Jun; Suckjoon,24,0,28,4
1731504132893,PHYS 2CL,A02,760047,Jun; Suckjoon,26,0,28,2
1731504132893,PHYS 2CL,A03,760048,Jun; Suckjoon,25,0,28,3
1731504132893,PHYS 2CL,A04,760049,Jun; Suckjoon,25,0,28,3
1731504132893,PHYS 2CL,A05,760050,Jun; Suckjoon,24,0,28,4
1731504132893,PHYS 2CL,A06,760051,Jun; Suckjoon,28,0,28,0
1731504132893,PHYS 2CL,A07,760052,Jun; Suckjoon,25,0,28,3
1731504132893,PHYS 2CL,A08,760053,Jun; Suckjoon,26,0,28,2
1731504133920,PHYS 2D,A01,760055,Hirsch; Jorge Eduardo,29,0,32,3
1731504133920,PHYS 2D,A02,760056,Hirsch; Jorge Eduardo,31,0,32,1
1731504134947,PHYS 4A,A01,760058,Averitt; Richard Douglas,41,0,45,4
1731504134947,PHYS 4A,A02,760085,Averitt; Richard Douglas,44,0,45,1
1731504134947,PHYS 4A,A03,760086,Averitt; Richard Douglas,44,0,45,1
1731504134947,PHYS 4A,A04,760087,Averitt; Richard Douglas,45,0,45,0
1731504135974,PHYS 4D,A01,760090,Frano Pereira; Alex M,40,0,40,0
1731504135974,PHYS 4D,A02,760096,Frano Pereira; Alex M,39,0,40,1
1731504135974,PHYS 4D,A03,760097,Frano Pereira; Alex M,40,0,40,0
1731504137004,PHYS 12,A01,760099,Branson; James G,59,0,60,1
1731504138029,PHYS 39,A01,796284,Jun; Suckjoon,0,0,0,0
1731504139059,PHYS 41,A01,760104,Green; Daniel Richard,48,0,50,2
1731504140088,PHYS 87,A00,796262,Grinstein; Benjamin,20,0,20,0
1731504141114,PHYS 100B,A01,760163,Barreiro Guerrero; Julio,72,0,75,3
1731504142140,PHYS 105A,A01,760203,Lin; Tongyan,33,0,38,5
1731504142140,PHYS 105A,A02,760212,Lin; Tongyan,36,0,37,1
1731504143165,PHYS 110B,A01,760214,Serra; Mattia,74,0,75,1
1731504144194,PHYS 124,A01,760217,Arnold; Kam S,38,0,40,2
1731504145219,PHYS 130A,A01,760219,Parker; Daniel E,38,0,40,2
1731504146243,PHYS 130C,A01,760221,You; Yizhuang,22,0,30,8
1731504147269,PHYS 136,A00,760222,Grinstein; Benjamin,50,0,50,0
1731504148301,PHYS 139,A00,760223,Di Ventra; Massimiliano & Schuller; Ivan K,28,0,30,2
1731504149328,PHYS 140B,A01,760225,Arovas; Daniel P,26,0,30,4
1731504150361,PHYS 142,A01,794356,Duarte; Javier Mauricio,52,0,55,3
1731504151388,PHYS 152A,A01,760229,Butov; Leonid,39,0,40,1
1731504152415,PHYS 160,A01,760231,Fuller; George Michael,64,0,65,1
1731504153442,PHYS 176,A00,760232,Hwa; Terence T.,10,0,10,0
1731504154468,PHYS 178,A00,760233,Kleinfeld; David,32,0,35,3
1731504155498,PHYS 203A,A01,760242,Fogler; Michael M.,13,0,30,17
1731504156525,PHYS 211B,A00,760255,Grover; Tarun,28,0,30,2
1731504157552,PHYS 212B,A01,760269,Chivukula; Raja S,18,0,30,12
1731504158579,PHYS 215B,A00,760325,McGreevy; John A.,24,0,30,6
1731504159608,PHYS 225B,A00,760326,Flauger; Raphael M,27,0,30,3
1731504160637,PHYS 239,A00,760327,Di Ventra; Massimiliano & Schuller; Ivan K,12,0,15,3
1731504160637,PHYS 239,B00,760328,Goldenfeld; Nigel,25,0,30,5
1731504161668,PHYS 242,A00,794365,Duarte; Javier Mauricio,2,0,5,3
1731504162695,PHYS 250,A00,760331,Parker; Daniel E,45,0,50,5
1731504163722,PHYS 251,A00,760332,Grinstein; Benjamin,18,0,20,2
1731504164752,PHYS 252,A00,760333,Diamond; Patrick H,8,0,10,2
1731504165779,PHYS 253,A00,760336,Fuller; George Michael & Keating; Brian,19,0,20,1
1731504166807,PHYS 254,A00,760337,Tan; Tzer Han,30,0,30,0
1731504167837,PHYS 259A,A00,795452,Hwa; Terence T.,18,0,20,2
1731504168889,PHYS 260,A00,760340,Fuller; George Michael,46,0,50,4
1731504169917,PHYS 261,A00,760341,Schuller; Ivan K,28,0,30,2
1731504170943,PHYS 276,A00,760342,Hwa; Terence T.,6,0,10,4
1731504171973,PHYS 278,A00,760343,Kleinfeld; David,14,0,15,1
1731504173003,POLI 5D,A01,761982,Dai; Yinlin,6,0,6,0
1731504173003,POLI 5D,A02,761984,Dai; Yinlin,6,0,6,0
1731504173003,POLI 5D,A03,761987,Dai; Yinlin,6,0,6,0
1731504173003,POLI 5D,A04,761988,Dai; Yinlin,6,0,6,0
1731504173003,POLI 5D,A05,762321,Dai; Yinlin,5,0,6,1
1731504173003,POLI 5D,B01,762356,Dai; Yinlin,6,0,6,0
1731504173003,POLI 5D,B02,762362,Dai; Yinlin,6,0,6,0
1731504173003,POLI 5D,B03,762365,Dai; Yinlin,5,0,6,1
1731504173003,POLI 5D,B04,762369,Dai; Yinlin,6,0,6,0
1731504173003,POLI 5D,B05,762370,Dai; Yinlin,6,0,6,0
1731504174034,POLI 10D,A01,762376,Noble; Benjamin S,29,0,32,3
1731504174034,POLI 10D,A02,762377,Noble; Benjamin S,29,0,32,3
1731504174034,POLI 10D,A03,762384,Noble; Benjamin S,29,0,32,3
1731504174034,POLI 10D,A04,762385,Noble; Benjamin S,29,0,32,3
1731504174034,POLI 10D,A05,762390,Noble; Benjamin S,32,0,32,0
1731504174034,POLI 10D,A06,762397,Noble; Benjamin S,32,0,32,0
1731504175064,POLI 11D,A01,762400,Desposato; Scott,33,0,34,1
1731504175064,POLI 11D,A02,762403,Desposato; Scott,32,0,34,2
1731504175064,POLI 11D,A03,762406,Desposato; Scott,33,0,34,1
1731504175064,POLI 11D,A04,762408,Desposato; Scott,33,0,34,1
1731504175064,POLI 11D,A05,762409,Desposato; Scott,33,0,34,1
1731504175064,POLI 11D,A06,762411,Desposato; Scott,34,0,34,0
1731504176090,POLI 87,A00,799971,Mignozzetti; Umberto,20,0,20,0
1731504177117,POLI 100W,A00,762448,Paglayan; Agustina,111,0,120,9
1731504178210,POLI 104B,A00,762450,Smith; Glenn Chatmas,208,0,216,8
1731504179237,POLI 104C,A00,762453,Salam; Amna,102,0,115,13
1731504180264,POLI 104J,A00,762454,Nichter; Maysa,180,0,196,16
1731504181291,POLI 104U,A00,762456,Nichter; Maysa,130,0,146,16
1731504182319,POLI 108,A00,762463,Adida; Claire,289,0,295,6
1731504183351,POLI 110B,A00,762465,Ingham; Sean,54,0,56,2
1731504184379,POLI 113BR,A00,762468,Hoston; Germaine,193,0,200,7
1731504184379,POLI 113BR,B00,796178,Hoston; Germaine,30,0,30,0
1731504185411,POLI 114BR,A00,762469,Hoston; Germaine,195,0,200,5
1731504185411,POLI 114BR,B00,796626,Hoston; Germaine,30,0,30,0
1731504186442,POLI 117R,A00,762470,Forman; Fonna,27,0,40,13
1731504187473,POLI 118,A00,762472,Wiens; David,97,0,104,7
1731504188500,POLI 120G,A00,762598,Fisk; David Lee,111,0,115,4
1731504189528,POLI 124A,A00,762698,Fortunato; David,54,0,56,2
1731504190557,POLI 127,A00,762700,Feeley; Maureen Catherine,157,0,158,1
1731504191583,POLI 135,A00,762703,Fisk; David Lee,144,0,146,2
1731504192609,POLI 137,A00,762704,Saiegh; Sebastian,53,0,56,3
1731504193641,POLI 138,A00,762707,Draper; Matthew William,111,0,115,4
1731504194681,POLI 142J,A00,762708,Slantchev; Branislav,109,0,115,6
1731504195708,POLI 142L,A00,762709,Wagner; Wendy,138,0,146,8
1731504196736,POLI 147B,A00,762711,Roeder; Philip G,143,0,146,3
1731504197763,POLI 153,A00,762712,Fisk; David Lee,139,0,146,7
1731504198790,POLI 160AA,A00,762714,Staff,207,0,223,16
1731504199815,POLI 191B,A00,762715,Fowler; James,26,0,26,0
1731504200840,POLI 194,A00,770731,Hill; Seth J,9999,0,9999,0
1731504201865,POLI 197SD,A00,794843,Nichter; Maysa,9999,0,9999,0
1731504202892,POLI 203A,A00,762716,Ingham; Sean,21,0,25,4
1731504203917,POLI 212,A00,762739,Goldman; Harvey Stern,1,0,2,1
1731504204945,POLI 216,A00,762740,Wiens; David,23,0,25,2
1731504205971,POLI 220C,A00,762771,Garfias Royo; Ek Francisco,24,0,25,1
1731504206997,POLI 229,A00,762772,Saiegh; Sebastian,11,0,12,1
1731504206997,POLI 229,B00,762783,Liu; Guoer,22,0,25,3
1731504208023,POLI 231,A00,762784,Nichter; Simeon C,22,0,25,3
1731504209049,POLI 231E,A00,762788,Lowes; Sara Rachel & Bazzi; Samuel A,3,0,5,2
1731504210079,POLI 245,A00,762789,Naoi; Megumi,8,0,12,4
1731504211105,POLI 248,A00,762792,Lake; David A,19,0,25,6
1731504212134,POLI 257,A00,762795,Hill; Seth J,25,0,25,0
1731504213160,POLI 258,A00,762798,Noble; Benjamin S,25,0,25,0
1731504214191,POLI 271,A00,762799,Ahlquist; John S.,23,0,24,1
1731504215221,POLI 272,A00,762802,Mignozzetti; Umberto,11,0,12,1
1731504216249,POLI 281,A00,762803,Ban; Pamela M,13,0,13,0
1731504217279,POLI 282,A00,762804,Ferree; Karen E,23,0,25,2
1731504218310,POLI 283,A00,762805,Slantchev; Branislav,20,0,25,5
1731504219338,POLI 285,A00,762807,Ingham; Sean,10,0,10,0
1731504220365,POLI 286,A00,762808,Mignozzetti; Umberto,25,0,25,0
1731504221394,POLI 288,A00,762810,Fowler; James,12,0,12,0
1731504222420,PSY 296,001,792382,Staff,10,0,10,0
1731504222420,PSY 296,002,792383,Staff,10,0,10,0
1731504222420,PSY 296,003,792385,Staff,10,0,10,0
1731504223452,PSYC 1,A00,762811,Wennberg; Janna Wold,288,0,300,12
1731504224479,PSYC 2,A00,762815,Moranton; Nirelia Melbina-,247,0,250,3
1731504225505,PSYC 4,A00,795584,Anagnostaras; Stephan,285,0,295,10
1731504226540,PSYC 60,A01,786029,Lowe; Angela Beth,35,0,35,0
1731504226540,PSYC 60,A02,786035,Lowe; Angela Beth,33,0,35,2
1731504226540,PSYC 60,A03,786043,Lowe; Angela Beth,32,0,35,3
1731504226540,PSYC 60,A04,786046,Lowe; Angela Beth,32,0,35,3
1731504226540,PSYC 60,A05,786048,Lowe; Angela Beth,33,0,35,2
1731504226540,PSYC 60,A06,786049,Lowe; Angela Beth,33,0,35,2
1731504226540,PSYC 60,A07,786050,Lowe; Angela Beth,35,0,35,0
1731504226540,PSYC 60,B01,786056,Steiner; Eric Tomas,33,0,35,2
1731504226540,PSYC 60,B02,786058,Steiner; Eric Tomas,32,0,35,3
1731504226540,PSYC 60,B03,786061,Steiner; Eric Tomas,33,0,35,2
1731504226540,PSYC 60,B04,786065,Steiner; Eric Tomas,33,0,35,2
1731504226540,PSYC 60,B05,786068,Steiner; Eric Tomas,34,0,35,1
1731504226540,PSYC 60,B06,786071,Steiner; Eric Tomas,34,0,35,1
1731504226540,PSYC 60,B07,786075,Steiner; Eric Tomas,34,0,35,1
1731504227566,PSYC 70,A01,786078,Geller; Emma Harlan,27,0,35,8
1731504227566,PSYC 70,A02,786081,Geller; Emma Harlan,30,0,35,5
1731504227566,PSYC 70,A03,786084,Geller; Emma Harlan,35,0,35,0
1731504227566,PSYC 70,A04,786088,Geller; Emma Harlan,35,0,35,0
1731504227566,PSYC 70,A05,786089,Geller; Emma Harlan,35,0,35,0
1731504227566,PSYC 70,A06,786094,Geller; Emma Harlan,34,0,35,1
1731504228599,PSYC 71,A01,762821,Pilegard; Celeste Cristine,10,0,25,15
1731504228599,PSYC 71,A02,762822,Pilegard; Celeste Cristine,24,0,25,1
1731504228599,PSYC 71,B01,762826,Lowe; Angela Beth,24,0,25,1
1731504228599,PSYC 71,B02,762827,Lowe; Angela Beth,23,0,25,2
1731504229623,PSYC 101,A00,762829,Walker; Caren Michelle,255,0,295,40
1731504230650,PSYC 102,A00,762832,Gentner; Tim,220,0,225,5
1731504231680,PSYC 105,A00,762833,Brady; Timothy Francis,294,0,328,34
1731504232707,PSYC 106,A00,762834,Dobkins; Karen R.,282,0,295,13
1731504233737,PSYC 108,A00,762835,Adrian; Julia Anna,240,0,250,10
1731504234767,PSYC 110,A00,762838,Heyman; Gail D.,35,0,35,0
1731504235797,PSYC 111A,A01,762841,Geller; Emma Harlan,35,0,35,0
1731504236824,PSYC 116B,A01,762844,Lang; Ariel,21,0,21,0
1731504237851,PSYC 124,A00,762845,Dickenson; Janna Alene,76,0,80,4
1731504238898,PSYC 125,A00,762851,Rose; Fred E.,134,0,145,11
1731504239930,PSYC 137,A00,762853,Lin; Chujun,289,0,295,6
1731504240956,PSYC 144,A00,762855,Yilmaz; Anne Sheyda,285,0,295,10
1731504241983,PSYC 148,A00,762856,Mc Kenzie; Craig R.M.,90,0,100,10
1731504243009,PSYC 151,A00,762858,Glaser; Dale,67,0,70,3
1731504244039,PSYC 153,A00,762859,Harris; Christine Renee,241,0,250,9
1731504245069,PSYC 154,B00,762860,Lacefield; Katharine I,277,0,295,18
1731504246097,PSYC 162,A00,762863,Wixted; John T,284,0,295,11
1731504247124,PSYC 168,A00,762864,Chapman; Eddie Nathaniel,260,0,328,68
1731504248152,PSYC 172,A00,762865,Dickenson; Janna Alene,288,0,300,12
1731504249178,PSYC 175,A00,762868,Dobkins; Karen R.,35,0,35,0
1731504250204,PSYC 179,A00,762869,Lacefield; Katharine I,269,0,328,59
1731504251231,PSYC 181,A00,762872,Anagnostaras; Stephan,318,0,328,10
1731504252256,PSYC 184,A00,762873,Wilson; Brent M,281,0,295,14
1731504253284,PSYC 185,A00,762875,Aron; Adam,249,0,250,1
1731504254309,PSYC 187,A00,762876,Schachner; Adena,0,0,35,35
1731504255339,PSYC 193,A00,762879,Chapman; Eddie Nathaniel,29,0,35,6
1731504255339,PSYC 193,B00,762880,Pilegard; Celeste Cristine,48,0,50,2
1731504255339,PSYC 193,C00,762927,Rickard; Timothy C.,24,0,25,1
1731504255339,PSYC 193,D00,762934,Mukku; Dhananjaya,34,0,35,1
1731504255339,PSYC 193,E00,762935,Staff,48,0,50,2
1731504256372,PSYC 193L,A01,762937,Staff,23,0,35,12
1731504256372,PSYC 193L,B01,762939,Brown; Sandra A,65,0,65,0
1731504257400,PSYC 194B,A01,762941,Heyman; Gail D.,25,0,25,0
1731504258427,PSYC 201B,A01,762943,Staff,11,0,20,9
1731504259458,PSYC 220,A00,762944,Winkielman; Piotr,11,0,20,9
1731504260489,PSYC 224,A00,762945,Staff,28,0,30,2
1731504261519,PSYC 242,A00,762946,Staff,27,0,30,3
1731504262545,PSYC 247,A00,762947,Walker; Caren Michelle,19,0,20,1
1731504263572,PSYC 269,A00,762948,Schachner; Adena,19,0,20,1
1731504264601,PSYC 270B,A00,762949,Dobkins; Karen R.,18,0,20,2
1731504265632,PSYC 272,A00,762950,Mukku; Dhananjaya,20,0,20,0
1731504265632,PSYC 272,B00,762951,Brashier; Nadia Marie,16,0,20,4
1731504266660,PSYC 274,A00,762954,Staff,28,0,30,2
1731504267686,PSYC 275,A00,762955,Staff,19,0,30,11
1731504268713,PSYC 280,A00,762956,Serences; John Thomas,68,0,85,17
1731504269768,PSYC 296,001,777832,Anagnostaras; Stephan,9999,0,9999,0
1731504269768,PSYC 296,002,777833,Aron; Adam,9999,0,9999,0
1731504269768,PSYC 296,003,777834,Mukku; Dhananjaya,9999,0,9999,0
1731504269768,PSYC 296,004,777835,Barner; David A.,9998,0,9999,1
1731504269768,PSYC 296,005,777845,Schachner; Adena,9999,0,9999,0
1731504269768,PSYC 296,006,777846,Brown; Sandra A,9999,0,9999,0
1731504269768,PSYC 296,007,777847,Ferreira; Victor,9999,0,9999,0
1731504269768,PSYC 296,008,777848,Geller; Emma Harlan,9998,0,9999,1
1731504269768,PSYC 296,009,777849,Gentner; Tim,9999,0,9999,0
1731504269768,PSYC 296,010,777850,Gorman; Michael R.,9999,0,9999,0
1731504269768,PSYC 296,011,777852,Gremel; Christina M,9999,0,9999,0
1731504269768,PSYC 296,012,777854,Harris; Christine Renee,9999,0,9999,0
1731504269768,PSYC 296,013,777856,Pashler; Harold E,9999,0,9999,0
1731504269768,PSYC 296,014,777857,Pilegard; Celeste Cristine,9999,0,9999,0
1731504269768,PSYC 296,015,777858,Powell; Lindsey Jane,9999,0,9999,0
1731504269768,PSYC 296,016,777864,Rickard; Timothy C.,9998,0,9999,1
1731504269768,PSYC 296,017,777866,Serences; John Thomas,9998,0,9999,1
1731504269768,PSYC 296,018,777867,Walker; Caren Michelle,9998,0,9999,1
1731504269768,PSYC 296,019,777888,Lin; Chujun,9998,0,9999,1
1731504269768,PSYC 296,020,777889,Brashier; Nadia Marie,9997,0,9999,2
1731504269768,PSYC 296,021,777890,Oesch; Nicholas W,9999,0,9999,0
1731504269768,PSYC 296,022,777892,Long; Bria,9999,0,9999,0
1731504270794,RAD 278,A00,763247,Contijoch; Francisco,0,0,0,0
1731504271824,RAD 296,001,792406,Berman; Zachary,9,0,10,1
1731504271824,RAD 296,002,792408,Staff,10,0,10,0
1731504271824,RAD 296,003,792409,Staff,10,0,10,0
1731504272851,RELI 101,A00,763768,Rahimi; Babak,36,0,40,4
1731504273877,REV 20,A00,794904,Pomeroy; Robert S.,40,0,40,0
1731504274908,REV 87,A00,794931,Markman; Kristina,20,0,20,0
1731504275936,RMAS 296,001,792520,Murphy; James D,10,0,10,0
1731504275936,RMAS 296,002,792521,Staff,10,0,10,0
1731504275936,RMAS 296,003,792522,Staff,10,0,10,0
1731504276968,RMED 296,001,792600,Duleba; Antoni,9,0,10,1
1731504276968,RMED 296,002,792611,Staff,10,0,10,0
1731504276968,RMED 296,003,792620,Staff,10,0,10,0
1731504277997,SE 9,A01,763260,Kuester; Falko,28,0,34,6
1731504277997,SE 9,A02,763263,Kuester; Falko,33,0,33,0
1731504277997,SE 9,A03,763264,Kuester; Falko,31,0,33,2
1731504279028,SE 101A,A01,763356,Van Den Einde; Yael Dahlia,194,0,200,6
1731504280056,SE 101B,A01,763358,Todd; Michael,199,0,200,1
1731504281084,SE 102,A01,763360,Jandaghi Semnani; Shabnam,32,0,45,13
1731504281084,SE 102,A02,763361,Jandaghi Semnani; Shabnam,44,0,45,1
1731504281084,SE 102,A03,763362,Jandaghi Semnani; Shabnam,40,0,45,5
1731504282109,SE 103,A01,763364,Van Den Einde; Yael Dahlia,73,0,75,2
1731504282109,SE 103,A02,763365,Van Den Einde; Yael Dahlia,69,0,75,6
1731504283136,SE 110A,A01,763508,Lanza Di Scalea; Francesco,143,0,146,3
1731504284165,SE 110B,A00,763509,Asaro; Robert J,54,0,56,2
1731504285193,SE 115,A01,763555,Zhu; Qiang,198,0,200,2
1731504286224,SE 130A,A00,763556,Loh; Kenneth J. H.,37,0,40,3
1731504287256,SE 140A,A01,763558,Uang; Chia-Ming,2,0,24,22
1731504287256,SE 140A,A02,763559,Uang; Chia-Ming,10,0,24,14
1731504287256,SE 140A,A03,763560,Uang; Chia-Ming,22,0,24,2
1731504287256,SE 140A,A04,763561,Uang; Chia-Ming,20,0,24,4
1731504288281,SE 143A,A01,763563,Kosmatka; John B,15,0,32,17
1731504288281,SE 143A,A02,763564,Kosmatka; John B,32,0,32,0
1731504289307,SE 151A,A01,763566,Shing; P. Benson,71,0,100,29
1731504290334,SE 160A,A01,763569,Kosmatka; John B,168,0,175,7
1731504291376,SE 167,A01,763571,Chadha; Mayank,12,0,15,3
1731504292406,SE 171,A01,763573,Kim; Hyonny,20,0,35,15
1731504293436,SE 182,A01,763627,Hutchinson; Tara,44,0,50,6
1731504294464,SE 201B,A00,763629,Conte; Joel P,25,0,50,25
1731504295492,SE 203A,A00,763635,Tsampras; Georgios,39,0,65,26
1731504296519,SE 207,A00,763636,Palermo; Alessandro,0,0,20,20
1731504297547,SE 232,A01,763638,Jandaghi Semnani; Shabnam,21,0,40,19
1731504298573,SE 242,A01,763644,Tomac; Ingrid,5,0,25,20
1731504299604,SE 243,A00,763684,Hutchinson; Tara,40,0,40,0
1731504300633,SE 251A,A00,763751,Qiao; Yu,19,0,25,6
1731504301659,SE 252,A00,763752,Lanza Di Scalea; Francesco,20,0,25,5
1731504302690,SE 260A,A00,763753,Kosmatka; John B,11,0,15,4
1731504303717,SE 262,A00,763754,Kim; Hyonny,4,0,5,1
1731504304744,SE 266,A00,763755,Loh; Kenneth J. H.,5,0,15,10
1731504305773,SE 267A,A01,763758,Chadha; Mayank,12,0,15,3
1731504306801,SE 270,A00,763760,Morrison; Machel Leigh,26,0,35,9
1731504307828,SE 272,A00,763761,Asaro; Robert J,13,0,15,2
1731504308858,SE 273,A00,763762,Jandaghi Semnani; Shabnam,15,0,15,0
1731504309886,SE 276B,A00,763763,Chen; Jiun-Shyan,27,0,30,3
1731504310914,SE 281,A01,763765,Kuester; Falko,27,0,40,13
1731504311940,SE 290,A00,794880,Chen; Jiun-Shyan,57,0,100,43
1731504312973,SE 296,001,779072,Asaro; Robert J,9999,0,9999,0
1731504312973,SE 296,002,779073,Chen; Jiun-Shyan,9999,0,9999,0
1731504312973,SE 296,003,779074,Conte; Joel P,9999,0,9999,0
1731504312973,SE 296,004,779075,Elgamal; Ahmed,9999,0,9999,0
1731504312973,SE 296,005,779076,Hutchinson; Tara,9999,0,9999,0
1731504312973,SE 296,006,779077,Jandaghi Semnani; Shabnam,9999,0,9999,0
1731504312973,SE 296,007,779080,Kim; Hyonny,9999,0,9999,0
1731504312973,SE 296,008,779081,Kim; Hyunsun Alicia,9999,0,9999,0
1731504312973,SE 296,009,779082,Kosmatka; John B,9999,0,9999,0
1731504312973,SE 296,010,779085,Krysl; Petr,9999,0,9999,0
1731504312973,SE 296,011,779095,Kuester; Falko,9999,0,9999,0
1731504312973,SE 296,012,779096,Lanza Di Scalea; Francesco,9999,0,9999,0
1731504312973,SE 296,013,779098,Loh; Kenneth J. H.,9999,0,9999,0
1731504312973,SE 296,014,779172,McCartney; John Scott,9999,0,9999,0
1731504312973,SE 296,015,779175,Morrison; Machel Leigh,9999,0,9999,0
1731504312973,SE 296,016,779178,Mosqueda; Gilberto,9999,0,9999,0
1731504312973,SE 296,017,779179,Qiao; Yu,9999,0,9999,0
1731504312973,SE 296,018,779180,Shing; P. Benson,9999,0,9999,0
1731504312973,SE 296,019,779182,Todd; Michael,9998,0,9999,1
1731504312973,SE 296,020,779183,Tomac; Ingrid,9999,0,9999,0
1731504312973,SE 296,021,779185,Tsampras; Georgios,9999,0,9999,0
1731504312973,SE 296,022,779186,Uang; Chia-Ming,9999,0,9999,0
1731504312973,SE 296,023,779187,Van Den Einde; Yael Dahlia,9999,0,9999,0
1731504312973,SE 296,024,779188,Zhu; Qiang,9999,0,9999,0
1731504312973,SE 296,025,779190,Tehrani; Mehran,9999,0,9999,0
1731504312973,SE 296,026,779213,Palermo; Alessandro,9999,0,9999,0
1731504312973,SE 296,027,779214,Chadha; Mayank,9999,0,9999,0
1731504314003,SIO 1,A01,764333,Stegman; David,35,0,36,1
1731504314003,SIO 1,A02,764349,Stegman; David,35,0,36,1
1731504314003,SIO 1,A03,764383,Stegman; David,36,0,36,0
1731504314003,SIO 1,A04,764386,Stegman; David,35,0,36,1
1731504315085,SIO 3,A01,764389,Aburto Oropeza; Marco Octavio,35,0,35,0
1731504315085,SIO 3,A02,794529,Aburto Oropeza; Marco Octavio,35,0,35,0
1731504315085,SIO 3,A03,794527,Aburto Oropeza; Marco Octavio,34,0,35,1
1731504315085,SIO 3,A04,794528,Aburto Oropeza; Marco Octavio,35,0,35,0
1731504316114,SIO 25,A01,764394,Rivera-Collazo; Isabel C,40,0,40,0
1731504316114,SIO 25,A02,764395,Rivera-Collazo; Isabel C,37,0,40,3
1731504316114,SIO 25,A03,764397,Rivera-Collazo; Isabel C,40,0,40,0
1731504316114,SIO 25,A04,764401,Rivera-Collazo; Isabel C,39,0,40,1
1731504316114,SIO 25,A05,764454,Rivera-Collazo; Isabel C,38,0,40,2
1731504316114,SIO 25,A06,764460,Rivera-Collazo; Isabel C,38,0,40,2
1731504316114,SIO 25,A07,764480,Rivera-Collazo; Isabel C,38,0,40,2
1731504316114,SIO 25,A08,764484,Rivera-Collazo; Isabel C,39,0,40,1
1731504316114,SIO 25,A09,764488,Rivera-Collazo; Isabel C,39,0,40,1
1731504316114,SIO 25,A10,764490,Rivera-Collazo; Isabel C,38,0,40,2
1731504317141,SIO 45,A00,764491,Cook; Geoffrey W,91,0,120,29
1731504318166,SIO 65,A00,764497,Cook; Geoffrey W,34,0,35,1
1731504319196,SIO 87,A00,764567,Aburto Oropeza; Marco Octavio,25,0,25,0
1731504319196,SIO 87,B00,764568,Cook; Geoffrey W,20,0,20,0
1731504320223,SIO 90,A00,764570,Staff,57,0,65,8
1731504321251,SIO 102,A01,764574,Day; James M.D.,41,0,45,4
1731504322281,SIO 107,A00,764576,Schartup; Amina Bocary,28,0,30,2
1731504323307,SIO 109R,A00,764581,Forman; Fonna,53,0,75,22
1731504324333,SIO 116,A00,764582,Benmarhnia; Tarik,14,0,25,11
1731504325362,SIO 119,A01,764636,Send; Uwe & Andersson; Andreas Jerry,24,0,32,8
1731504325362,SIO 119,A02,764658,Send; Uwe & Andersson; Andreas Jerry,30,0,32,2
1731504325362,SIO 119,A03,764662,Send; Uwe & Andersson; Andreas Jerry,31,0,32,1
1731504325362,SIO 119,A04,764663,Send; Uwe & Andersson; Andreas Jerry,31,0,32,1
1731504326388,SIO 120,A01,764666,Cook; Geoffrey W,19,0,24,5
1731504327415,SIO 123,A00,764667,Allen; Andrew Ellis,38,0,40,2
1731504328453,SIO 126,A01,764669,Palenik; Brian,27,0,30,3
1731504328453,SIO 126,A02,764670,Palenik; Brian,29,0,30,1
1731504329486,SIO 133,A01,764673,Baumann-Pickering ; Simone & Kacev; David,27,0,36,9
1731504329486,SIO 133,A02,764674,Baumann-Pickering ; Simone & Kacev; David,33,0,36,3
1731504329486,SIO 133,A03,764675,Baumann-Pickering ; Simone & Kacev; David,30,0,36,6
1731504329486,SIO 133,A04,764676,Baumann-Pickering ; Simone & Kacev; David,34,0,36,2
1731504330514,SIO 134,A01,764678,Barton; Andrew David,13,0,14,1
1731504330514,SIO 134,A02,764680,Barton; Andrew David,12,0,14,2
1731504330514,SIO 134,A03,764682,Barton; Andrew David,8,0,14,6
1731504330514,SIO 134,A04,764684,Barton; Andrew David,13,0,14,1
1731504330514,SIO 134,A05,764685,Barton; Andrew David,13,0,14,1
1731504330514,SIO 134,A06,764686,Barton; Andrew David,12,0,15,3
1731504330514,SIO 134,A07,764687,Barton; Andrew David,12,0,15,3
1731504330514,SIO 134,A08,764688,Barton; Andrew David,15,0,15,0
1731504331541,SIO 144,A00,764690,Day; James M.D.,5,0,5,0
1731504332567,SIO 161,A01,764693,Fan; Wenyuan,18,0,20,2
1731504333598,SIO 162,A00,764694,Wright; Vashan,23,0,25,2
1731504334625,SIO 164,A00,764696,Staff,42,0,45,3
1731504335658,SIO 172,A00,764697,Norris; Joel Roland,35,0,40,5
1731504336684,SIO 178,A00,764699,Becker; Janet Maria,20,0,20,0
1731504337711,SIO 182,A00,764701,Constable; Steven C,19,0,20,1
1731504338742,SIO 187,A01,764776,Kacev; David,33,0,35,2
1731504338742,SIO 187,A02,764777,Kacev; David,32,0,35,3
1731504338742,SIO 187,A03,764779,Kacev; David,34,0,35,1
1731504338742,SIO 187,A04,764781,Kacev; David,32,0,35,3
1731504339777,SIO 190L,A01,764790,Sandin; Stuart Adrian,32,0,35,3
1731504340803,SIO 194,A00,770729,Hill; Seth J,9999,0,9999,0
1731504341832,SIOB 262,A00,764791,Moore; Bradley S.,23,0,25,2
1731504342863,SIOB 265,A01,764793,Jensen; Paul R.,8,0,12,4
1731504343894,SIOB 272,A01,764796,Sandin; Stuart Adrian,9,0,20,11
1731504343894,SIOB 272,A02,764797,Sandin; Stuart Adrian,14,0,20,6
1731504344924,SIOB 279,A00,794515,Barton; Andrew David,11,0,20,9
1731504345953,SIOB 286,A01,764803,Mesnick; Sarah & Smith; Jennifer,0,0,20,20
1731504346982,SIOB 291,A00,764806,Staff,0,0,0,0
1731504348016,SIOB 296,A00,794530,Staff,0,0,0,20
1731504349053,SIOB 297,A00,764807,Allen; Eric,17,0,25,8
1731504350080,SIOC 200C,A00,764808,Lin; Ying-Tsong,19,0,20,1
1731504351110,SIOC 202A,A00,764810,Hao; Xuanting & Lin; Ying-Tsong,22,0,30,8
1731504352140,SIOC 203B,A00,764811,Llewellyn Smith; Stefan G.,22,0,25,3
1731504353165,SIOC 207B,A00,764813,Meyer; Florian,1,0,5,4
1731504354192,SIOC 208,A00,764814,Merrifield; Mark A,30,0,40,10
1731504355219,SIOC 209,A00,764881,Benmarhnia; Tarik,12,0,30,18
1731504355219,SIOC 209,B00,794517,Charbit; Lia,30,0,30,0
1731504356246,SIOC 211A,A00,764882,Mackinnon; Jennifer A.,18,0,25,7
1731504357276,SIOC 212A,A00,764892,Eisenman; Ian,9,0,20,11
1731504358301,SIOC 216A,A00,794518,Werner; Bradley T.,19,0,20,1
1731504359330,SIOC 217B,A00,764895,Norris; Joel Roland,12,0,20,8
1731504360357,SIOC 217D,A00,764904,Keeling; Ralph F. & Russell; Lynn M.,19,0,20,1
1731504361389,SIOC 219,A00,796147,Mackinnon; Jennifer A. & Young; William Roy,29,0,30,1
1731504362420,SIOC 221B,A00,764907,Gille; Sarah T,17,0,25,8
1731504363448,SIOC 223,A00,764910,Send; Uwe & Merrifield; Mark A,18,0,20,2
1731504364477,SIOC 237B,A00,764912,Stramski; Dariusz,17,0,20,3
1731504365502,SIOC 296,A00,799576,Staff,0,0,0,0
1731504366530,SIOG 200C,A00,794531,Fan; Wenyuan,0,0,0,0
1731504367556,SIOG 223B,A00,764966,Agnew; Duncan Carr & Fan; Wenyuan,18,0,20,2
1731504368582,SIOG 227A,A00,765040,Gabriel; Anne Alice-Agnes,5,0,10,5
1731504369608,SIOG 228,A00,765043,Kacev; David,7,0,20,13
1731504370638,SIOG 229,A00,765046,Borsa; Adrian Antal,19,0,20,1
1731504371663,SIOG 234,A00,765047,Sandwell; David T,13,0,15,2
1731504372695,SIOG 237,A01,765099,Fialko; Yuri A.,18,0,20,2
1731504373721,SIOG 239,A00,765100,Gabriel; Anne Alice-Agnes,20,0,20,0
1731504374751,SIOG 252A,A00,765102,Day; James M.D.,5,0,10,5
1731504375780,SIOG 260,A00,765105,Schartup; Amina Bocary,21,0,50,29
1731504385027,SOCE 194,A00,770728,Hill; Seth J,9999,0,9999,0
1731504386054,SOCG 202,A00,764221,Goldman; Harvey Stern,4,0,10,6
1731504387081,SOCG 203,A00,764223,Ribas Norris; Janet Vanesa,1,0,10,9
1731504388112,SOCG 205,A00,764255,Sutton; April Marie,6,0,10,4
1731504389145,SOCG 208B,A00,764258,Ng; Kwai,5,0,10,5
1731504390172,SOCG 209,A00,764259,Lewis; Kevin Michael,0,0,10,10
1731504391201,SOCG 247,A00,764260,Edington; Claire Ellen,5,0,5,0
1731504392227,SOCG 253,A00,764262,Evans; John Hyde,4,0,8,4
1731504393257,SOCG 255C,A00,764266,McKenzie; Kerry V.,5,0,5,0
1731504394285,SOCG 255D,A00,764272,Lampland; Martha,5,0,5,0
1731504395314,SOCG 284,B00,800628,Navon; Daniel,0,0,0,0
1731504396344,SOCG 290,A00,794511,Gong; Neil M,9,0,10,1
1731504397377,SOCI 1,A01,763771,Rogers; Julia Ellen,30,0,30,0
1731504397377,SOCI 1,A02,763835,Rogers; Julia Ellen,29,0,30,1
1731504397377,SOCI 1,A03,763839,Rogers; Julia Ellen,30,0,30,0
1731504397377,SOCI 1,A04,763845,Rogers; Julia Ellen,27,0,30,3
1731504397377,SOCI 1,A05,763860,Rogers; Julia Ellen,29,0,30,1
1731504397377,SOCI 1,A06,763866,Rogers; Julia Ellen,30,0,30,0
1731504398405,SOCI 2,A01,763874,Staff,32,0,32,0
1731504398405,SOCI 2,A02,763875,Staff,30,0,32,2
1731504398405,SOCI 2,A03,763876,Staff,30,0,32,2
1731504398405,SOCI 2,A04,763896,Staff,30,0,32,2
1731504398405,SOCI 2,A05,763899,Staff,30,0,32,2
1731504398405,SOCI 2,A06,763901,Staff,31,0,32,1
1731504398405,SOCI 2,A07,763902,Staff,30,0,32,2
1731504398405,SOCI 2,A08,763904,Staff,31,0,32,1
1731504399434,SOCI 20,A01,763907,Kenworthy; Lane A.,30,0,30,0
1731504399434,SOCI 20,A02,763908,Kenworthy; Lane A.,26,0,30,4
1731504400465,SOCI 60,A01,763977,Ribas Norris; Janet Vanesa,28,0,32,4
1731504400465,SOCI 60,A02,763979,Ribas Norris; Janet Vanesa,31,0,32,1
1731504401501,SOCI 70,A01,763986,Lewis; Kevin Michael,25,0,30,5
1731504401501,SOCI 70,A02,763988,Lewis; Kevin Michael,30,0,30,0
1731504401501,SOCI 70,A03,763990,Lewis; Kevin Michael,27,0,30,3
1731504401501,SOCI 70,A04,764042,Lewis; Kevin Michael,27,0,30,3
1731504402531,SOCI 100,A01,764047,Goldman; Harvey Stern,29,0,30,1
1731504402531,SOCI 100,A02,764048,Goldman; Harvey Stern,29,0,30,1
1731504402531,SOCI 100,A03,764052,Goldman; Harvey Stern,28,0,30,2
1731504402531,SOCI 100,A04,764058,Goldman; Harvey Stern,28,0,30,2
1731504403560,SOCI 103M,A00,764059,Kilpatrick; Kevin,25,0,30,5
1731504404596,SOCI 104,A00,764066,Arnal; Maud Marie Leonie,25,0,30,5
1731504405624,SOCI 106,A00,795036,Shafir; Gershon,29,0,30,1
1731504406655,SOCI 109,A00,764070,Kilpatrick; Kevin,29,0,30,1
1731504407694,SOCI 117,A01,764078,Jones; Gabrielle Anastasia,15,0,17,2
1731504407694,SOCI 117,A02,764084,Jones; Gabrielle Anastasia,16,0,17,1
1731504407694,SOCI 117,A03,764085,Jones; Gabrielle Anastasia,17,0,17,0
1731504407694,SOCI 117,A04,764086,Jones; Gabrielle Anastasia,19,0,19,0
1731504407694,SOCI 117,B01,764163,Aragon; Maria Jose,8,0,10,2
1731504407694,SOCI 117,B02,764170,Aragon; Maria Jose,10,0,10,0
1731504408721,SOCI 118,A00,764178,Rogers; Julia Ellen,74,0,75,1
1731504409753,SOCI 119,A00,764179,Victoria Torres; Pablo,86,0,90,4
1731504410779,SOCI 120T,A00,764180,Staff,56,0,56,0
1731504411807,SOCI 124,A00,764181,Kenworthy; Lane A.,48,0,50,2
1731504412832,SOCI 125,A00,764182,Watson; Tobias,63,0,65,2
1731504413862,SOCI 126,A01,764184,Jones; Makeba,17,0,20,3
1731504413862,SOCI 126,A02,764185,Jones; Makeba,20,0,20,0
1731504413862,SOCI 126,A03,764186,Jones; Makeba,20,0,20,0
1731504414894,SOCI 127,A00,764187,Fitzgerald; David S,60,0,65,5
1731504415925,SOCI 130E,A00,764188,Pitt; Richard Norris,42,0,45,3
1731504416953,SOCI 133E,A00,764189,Pitt; Richard Norris,55,0,56,1
1731504417984,SOCI 135,A00,764190,Payne; Christine Anna,70,0,74,4
1731504419011,SOCI 136E,A00,764191,Ruiz; Jonathan Joseph,55,0,56,1
1731504420037,SOCI 136F,A00,764192,Gong; Neil M,55,0,56,1
1731504421062,SOCI 140,A00,764193,Tirshfield; Jeffrey T,46,0,49,3
1731504422087,SOCI 142,A00,764194,Crofts; Christine,56,0,70,14
1731504423116,SOCI 144P,A00,764195,Estefan; Michel,71,0,75,4
1731504424145,SOCI 148,A00,764196,Payne; Christine Anna,93,0,100,7
1731504425176,SOCI 148E,A00,764197,Calderon-Zaks; Michael Aar,43,0,45,2
1731504426203,SOCI 149,A00,764198,Alvarez; Camila Huerta,49,0,55,6
1731504427233,SOCI 150,A00,764200,Victoria Torres; Pablo,74,0,75,1
1731504428261,SOCI 154,A00,764201,Crofts; Christine,46,0,55,9
1731504429286,SOCI 159,B00,764202,Staff,56,0,56,0
1731504430311,SOCI 160,A00,764203,Ostovany; Khashayar,49,0,50,1
1731504431337,SOCI 161,A00,764204,Arnal; Maud Marie Leonie,53,0,56,3
1731504432362,SOCI 162,A00,764207,Rogers; Julia Ellen,53,0,55,2
1731504433388,SOCI 169,A00,764208,Shafir; Gershon,34,0,35,1
1731504434417,SOCI 170,A00,764209,Lampland; Martha,45,0,45,0
1731504435444,SOCI 171,A00,764210,Ruiz; Jonathan Joseph,51,0,56,5
1731504436469,SOCI 173,A00,764211,Navon; Daniel,99,0,100,1
1731504437498,SOCI 175,A00,764213,Calderon-Zaks; Michael Aar,64,0,65,1
1731504438526,SOCI 180,A00,764214,Ostovany; Khashayar,48,0,50,2
1731504439555,SOCI 183,A00,764215,Sutton; April Marie,25,0,25,0
1731504440581,SOCI 188,A01,764217,Andrews; Abigail Leslie,0,0,0,0
1731504441612,SOCI 188E,A00,764219,Jules-Rosette; Bennetta W.,30,0,30,0
1731504442638,SOCI 196B,A00,764220,Turner; Christena L.,14,0,15,1
1731504443671,SOMC 225,A00,792643,Rifkin; Dena E.,160,0,160,0
1731504444699,SOMC 227,A00,792651,Gold; Jeffrey Joseph,160,0,160,0
1731504445730,SOMC 237,A00,792671,Gold; Jeffrey Joseph,160,0,160,0
1731504446762,SOMC 238,A00,792678,Papamatheakis; Demosthenes,160,0,160,0
1731504447787,SOMC 239,A00,792686,Rifkin; Dena E.,160,0,160,0
1731504448820,SOMC 243,A00,793653,Gaines; Tommi L.,160,0,160,0
1731504449849,SOMC 245B,A01,792743,Noel; Geoffroy Pierre Jean,160,0,160,0
1731504450878,SOMC 246B,A00,792744,Eyler; Lisa T.,160,0,160,0
1731504452144,SOMC 247B,A50,792756,Calcutt; Nigel A,160,0,160,0
1731504453170,SOMC 248B,A00,792757,Joshi; Weena Erin,160,0,160,0
1731504454195,SOMC 251B,A00,792760,Eyler; Lisa T.,160,0,160,0
1731504455221,SOMC 252B,A00,792780,Taddonio; Michael Adam,160,0,160,0
1731504456251,SOMC 253B,A00,792808,Wooten; Darcy A,160,0,160,0
1731504457279,SOMC 254B,A00,792815,Joshi; Weena Erin,160,0,160,0
1731504458308,SOMC 255B,A00,792836,Allison; Matthew,160,0,160,0
1731504459333,SOMC 256B,A00,792845,Shapiro; Desiree Nicolette,160,0,160,0
1731504460362,SPPH 263A,A00,792290,O'Donoghue; Anthony John & Abagyan; Ruben,47,0,50,3
1731504461388,SPPS 200A,A00,792291,Luli; Alex J,100,0,100,0
1731504462418,SPPS 202,A00,792292,Fricovsky; Eduardo Santiago,76,0,80,4
1731504463445,SPPS 207,A01,792296,Hernandez Y Delso; Inmacul,76,0,80,4
1731504464472,SPPS 208,A00,792297,Bounthavong; Mark,76,0,80,4
1731504465504,SPPS 210,001,799992,Gustafsson; Asa Birgitta,99,0,99,0
1731504466536,SPPS 212B,A01,792301,Humber; Douglas M,80,0,80,0
1731504467562,SPPS 212D,A01,792304,Patel; Nimish,80,0,80,0
1731504468589,SPPS 216,A00,792305,Fitzgerald; Robert,80,0,80,0
1731504469617,SPPS 218A,A00,792306,Vijapurkar; Ulka,80,0,80,0
1731504470650,SPPS 223,A01,792308,Hook; Vivian Yuan-Ho,95,0,99,4
1731504471682,SPPS 224,A01,792310,Momper; Jeremiah D,76,0,80,4
1731504472713,SPPS 234,A00,792312,Rifkin; Dena E.,80,0,80,0
1731504473745,SPPS 248,A00,792315,Brandl; Katharina,80,0,80,0
1731504474771,SPPS 251,A00,792316,Chen; Timothy,20,0,20,0
1731504475801,SPPS 254,A00,792317,Shapiro; Desiree Nicolette,49,0,50,1
1731504476826,SPPS 264B,A00,792319,Tsunoda; Shirley M.,30,0,30,0
1731504477853,SPPS 270B,A00,792320,Fricovsky; Eduardo Santiago,30,0,30,0
1731504478882,SPPS 274,A00,792323,Namba; Jennifer Mariko,60,0,60,0
1731504479907,SPPS 278,A00,792325,Fricovsky; Eduardo Santiago,99,0,99,0
1731504480933,SPPS 282,A00,792326,Radic; Zoran,10,0,10,0
1731504481959,SPPS 287,A00,792327,Tsunoda; Shirley M.,60,0,60,0
1731504482990,SPPS 288,A00,792328,Saunders; Ila Maewal,98,0,99,1
1731504484073,SPPS 289,A00,792329,Armour; Jon Christopher,60,0,60,0
1731504485100,SURG 296,001,792875,Reid; Christopher,9,0,10,1
1731504485100,SURG 296,002,792880,Staff,10,0,10,0
1731504485100,SURG 296,003,792882,Staff,10,0,10,0
1731504486157,SYN 1,001,768443,Rosenberg; Ryan Glenn,17,0,20,3
1731504486157,SYN 1,002,768444,Iatarola; Briana Marie,11,0,20,9
1731504486157,SYN 1,003,768445,Bishop; Graham,14,0,20,6
1731504486157,SYN 1,004,768446,Atkinson; Arthur Laird,19,0,20,1
1731504486157,SYN 1,005,768447,Girard; Gabrielle,20,0,20,0
1731504486157,SYN 1,006,768455,Girard; Gabrielle,20,0,20,0
1731504486157,SYN 1,007,768471,Fish; Gwendolyn Anne,20,0,20,0
1731504486157,SYN 1,008,768473,Deavenport; James Cary,16,0,20,4
1731504486157,SYN 1,009,768474,Hom; Kirstyn Courtney,20,0,20,0
1731504486157,SYN 1,010,768494,Hom; Kirstyn Courtney,12,0,20,8
1731504486157,SYN 1,011,768525,Deavenport; James Cary,19,0,20,1
1731504486157,SYN 1,012,768794,Lagapa; Jason,19,0,20,1
1731504486157,SYN 1,013,768795,Meyer; Leslie Rose,17,0,20,3
1731504486157,SYN 1,014,768798,Meyer; Leslie Rose,18,0,20,2
1731504487186,SYN 1R,001,768853,Atkinson; Arthur Laird,19,0,20,1
1731504488214,SYN 2,001,768857,Birberick; Brittany Celest,20,0,20,0
1731504488214,SYN 2,002,768859,Girard; Gabrielle,17,0,20,3
1731504488214,SYN 2,003,768862,Tawater; Hanna Jean,20,0,20,0
1731504488214,SYN 2,004,768869,Tawater; Hanna Jean,17,0,20,3
1731504488214,SYN 2,005,768871,Difruscio; Mark,20,0,20,0
1731504488214,SYN 2,006,768872,Rock; Martin,18,0,20,2
1731504488214,SYN 2,007,768876,Difruscio; Mark,17,0,20,3
1731504488214,SYN 2,008,768878,Staff,20,0,20,0
1731504488214,SYN 2,010,768890,Rock; Martin,18,0,20,2
1731504488214,SYN 2,011,768891,Browne; Emily,19,0,20,1
1731504489239,SYN 2R,001,768972,Staff,18,0,20,2
1731504490276,SYN 100,A01,768983,Gladstein; Jill M,15,0,15,0
1731504490276,SYN 100,A02,768990,Gladstein; Jill M,14,0,15,1
1731504490276,SYN 100,B01,769012,Tawater; Hanna Jean,6,0,15,9
1731504490276,SYN 100,B02,769014,Tawater; Hanna Jean,5,0,15,10
1731504490276,SYN 100,C01,769019,Rosenberg; Ryan Glenn,11,0,15,4
1731504490276,SYN 100,C02,769022,Rosenberg; Ryan Glenn,15,0,15,0
1731504490276,SYN 100,D01,769025,Rosenberg; Ryan Glenn,14,0,15,1
1731504490276,SYN 100,D02,769027,Rosenberg; Ryan Glenn,12,0,15,3
1731504490276,SYN 100,E01,769044,Browne; Emily,13,0,15,2
1731504490276,SYN 100,E02,769053,Browne; Emily,14,0,15,1
1731504490276,SYN 100,F01,769071,Browne; Emily,10,0,15,5
1731504490276,SYN 100,F02,769072,Browne; Emily,15,0,15,0
1731504490276,SYN 100,G01,769096,Iatarola; Briana Marie,13,0,15,2
1731504490276,SYN 100,G02,769202,Iatarola; Briana Marie,10,0,15,5
1731504490276,SYN 100,H01,769221,Meyer; Leslie Rose,12,0,15,3
1731504490276,SYN 100,H02,795165,Meyer; Leslie Rose,14,0,15,1
1731504490276,SYN 100,I01,769227,Deavenport; James Cary,11,0,15,4
1731504490276,SYN 100,I02,769228,Deavenport; James Cary,12,0,15,3
1731504490276,SYN 100,J01,769230,Hom; Kirstyn Courtney,11,0,15,4
1731504490276,SYN 100,J02,769231,Hom; Kirstyn Courtney,14,0,15,1
1731504490276,SYN 100,K01,769233,Bishop; Graham,14,0,24,10
1731504490276,SYN 100,L01,769237,Difruscio; Mark,6,0,15,9
1731504490276,SYN 100,L02,769238,Difruscio; Mark,12,0,15,3
1731504490276,SYN 100,M01,769277,Gormally; Brenna,13,0,15,2
1731504490276,SYN 100,M02,769284,Gormally; Brenna,15,0,15,0
1731504490276,SYN 100,N01,769291,Rock; Martin,11,0,15,4
1731504490276,SYN 100,N02,769292,Rock; Martin,15,0,15,0
1731504490276,SYN 100,O01,769308,Atkinson; Arthur Laird,11,0,15,4
1731504490276,SYN 100,O02,769309,Atkinson; Arthur Laird,15,0,15,0
1731504491303,SYN 150,001,769422,Gladstein; Jill M,20,0,20,0
1731504491303,SYN 150,002,769423,Vega; Adrian,19,0,20,1
1731504491303,SYN 150,003,769424,Fish; Gwendolyn Anne,19,0,20,1
1731504491303,SYN 150,004,769427,Lagapa; Jason,20,0,20,0
1731504491303,SYN 150,005,769430,Lagapa; Jason,20,0,20,0
1731504491303,SYN 150,006,769431,Fish; Gwendolyn Anne,20,0,20,0
1731504491303,SYN 150,007,796615,Vega; Adrian,19,0,20,1
1731504492431,SYN 150R,001,769499,Vega; Adrian,20,0,20,0
1731504493474,TDAC 1,A00,760383,Walsh; Kim C.,11,0,20,9
1731504493474,TDAC 1,B00,760388,Walsh; Kim C.,19,0,20,1
1731504493474,TDAC 1,C00,760389,Walsh; Kim C.,19,0,20,1
1731504493474,TDAC 1,D00,760395,Walsh; Kim C.,16,0,20,4
1731504493474,TDAC 1,E00,760396,Walsh; Kim C.,17,0,20,3
1731504493474,TDAC 1,F00,760406,Walsh; Kim C.,17,0,20,3
1731504494518,TDAC 101,A00,760817,Harting; Carla Kelso,19,0,20,1
1731504494518,TDAC 101,B00,760819,Salovey; Todd,17,0,20,3
1731504495547,TDAC 102,A00,795388,Walsh; Kim C.,19,0,20,1
1731504496575,TDAC 108,A00,795390,Staff,14,0,16,2
1731504497601,TDAC 111,A00,760821,Meyer; Ursula,20,0,20,0
1731504498626,TDAC 115,A00,760822,Buescher; Stephen W.,14,0,20,6
1731504499656,TDAC 122,A00,795391,Perry; Lamar,30,0,30,0
1731504499656,TDAC 122,B00,796062,Celik; Aysan Karagasli,30,0,30,0
1731504500690,TDDE 1,A01,760433,Guirguis; Mark C,16,0,18,2
1731504500690,TDDE 1,A02,760434,Guirguis; Mark C,17,0,18,1
1731504500690,TDDE 1,A03,760436,Guirguis; Mark C,16,0,18,2
1731504500690,TDDE 1,A04,760513,Guirguis; Mark C,18,0,18,0
1731504500690,TDDE 1,A05,760515,Guirguis; Mark C,18,0,18,0
1731504501715,TDDE 111,A00,760823,Benzoni; Elisa,0,0,0,0
1731504502745,TDDE 130,A00,760827,Guirguis; Mark C,19,0,20,1
1731504503773,TDDE 132,A00,760828,Guirguis; Mark C,20,0,20,0
1731504504799,TDDM 1,A00,760516,Wilson; Terry A.,29,0,30,1
1731504505833,TDDM 101,A00,795403,Johnston; Holly,29,0,30,1
1731504506865,TDDR 101,A00,760835,Powell; Lora,28,0,30,2
1731504507904,TDDR 102,A00,760836,Powell; Lora,20,0,20,0
1731504508933,TDDR 190,A00,795392,Perry; Lamar,35,0,35,0
1731504509964,TDGE 1,A01,760522,Salovey; Todd,20,0,20,0
1731504509964,TDGE 1,A02,760523,Salovey; Todd,20,0,20,0
1731504509964,TDGE 1,A03,760526,Salovey; Todd,20,0,20,0
1731504509964,TDGE 1,A04,760531,Salovey; Todd,18,0,20,2
1731504509964,TDGE 1,A05,760546,Salovey; Todd,20,0,20,0
1731504509964,TDGE 1,A06,760784,Salovey; Todd,19,0,20,1
1731504510994,TDGE 11,A00,760785,Anderson; Mysia Anyse,128,0,146,18
1731504512024,TDGE 25,A00,760786,Harting; Carla Kelso,18,0,20,2
1731504512024,TDGE 25,B00,760788,Harting; Carla Kelso,17,0,20,3
1731504512024,TDGE 25,C00,760789,Harting; Carla Kelso,14,0,20,6
1731504512024,TDGE 25,D00,760790,Harting; Carla Kelso,16,0,20,4
1731504513052,TDGE 87,A00,760791,Guirguis; Mark C,20,0,20,0
1731504513052,TDGE 87,B00,795393,Adler; Steven,20,0,20,0
1731504514081,TDGE 124,A00,760838,Fulton; Julia,231,0,250,19
1731504515106,TDGE 127,A00,760839,Havis; Allan,218,0,225,7
1731504516132,TDGE 131,A00,760840,Burelle; Julie Sara Veronique,203,0,205,2
1731504517159,TDGR 210B,A00,760881,Celik; Aysan Karagasli,10,0,10,0
1731504518184,TDGR 212,A00,760883,Meyer; Ursula,10,0,10,0
1731504519211,TDGR 219,A00,760886,Perry; Lamar,0,0,0,0
1731504520238,TDGR 221A,A00,760887,Staff,10,0,10,0
1731504521265,TDGR 223B,A00,760889,Buescher; Stephen W.,10,0,10,0
1731504522295,TDGR 224B,A00,760890,Meyer; Ursula,10,0,10,0
1731504523320,TDGR 225B,A00,760891,Blair; Kyle Adam,10,0,10,0
1731504524348,TDGR 229,A00,760892,Brill; Robert L.,1,0,1,0
1731504524348,TDGR 229,B00,760893,Stalling; Vanessa,1,0,1,0
1731504524348,TDGR 229,C00,760894,Porter; Lisa,1,0,1,0
1731504525378,TDGR 244,A00,760895,Iizuka; Naomi Hisako,20,0,20,0
1731504526405,TDGR 245,A00,760898,Stalling; Vanessa,5,0,5,0
1731504527430,TDGR 250,A00,760899,Stein; Deborah Isobel,7,0,7,0
1731504528455,TDGR 251,A00,760900,Iizuka; Naomi Hisako,5,0,5,0
1731504528455,TDGR 251,B00,760901,Stein; Deborah Isobel,5,0,5,0
1731504529484,TDGR 257A,A00,760903,Staff,7,0,7,0
1731504530514,TDGR 262,A01,796141,Petrovich; Victoria A.,10,0,10,0
1731504531543,TDGR 269A,A00,760905,Petrovich; Victoria A.,18,0,20,2
1731504532570,TDGR 270C,A00,760909,Kuhl; Christopher August,20,0,20,0
1731504533599,TDGR 270D,A00,760911,McElver; Robert Harrison,20,0,20,0
1731504534627,TDGR 274,A00,760912,Brill; Robert L.,9,0,10,1
1731504535654,TDGR 275,A00,760913,Kuhl; Christopher August,10,0,10,0
1731504536681,TDGR 276,A00,760914,Benzoni; Elisa,10,0,10,0
1731504537707,TDGR 278,A00,760915,Staff,10,0,10,0
1731504537707,TDGR 278,B00,760919,Staff,20,0,20,0
1731504538734,TDGR 279,A00,760920,Benzoni; Elisa,5,0,5,0
1731504538734,TDGR 279,B00,760921,Petrovich; Victoria A.,4,0,5,1
1731504538734,TDGR 279,C00,760923,McElver; Robert Harrison,5,0,5,0
1731504538734,TDGR 279,D00,760924,Kuhl; Christopher August,5,0,5,0
1731504538734,TDGR 279,E00,760927,Brill; Robert L.,4,0,5,1
1731504539759,TDGR 282,A00,760930,McElver; Robert Harrison,10,0,10,0
1731504540790,TDGR 286,A00,760931,Staff,10,0,10,0
1731504541818,TDGR 288,A00,760932,Porter; Lisa,5,0,5,0
1731504542843,TDGR 289C,A00,760933,Mehrishi; Rishika,10,0,10,0
1731504543875,TDGR 289D,A00,760934,Power; Jade Yukana,10,0,10,0
1731504544961,TDGR 292,A00,760936,Burelle; Julie Sara Veronique,14,0,15,1
1731504545988,TDGR 293,A00,760937,Perry; Lamar,2,0,2,0
1731504547016,TDGR 296,A00,760938,Porter; Lisa,3,0,3,0
1731504547016,TDGR 296,B00,760939,Powell; Lora,3,0,3,0
1731504548045,TDGR 297,001,760940,Iizuka; Naomi Hisako,3,0,3,0
1731504549073,TDHD 20,A00,760792,Jun; Grace Shin Hae,20,0,20,0
1731504550103,TDHD 176,A00,795405,Staff,45,0,45,0
1731504551129,TDHT 10,A00,760794,Power; Jade Yukana,15,0,15,0
1731504551129,TDHT 10,B00,760795,Power; Jade Yukana,13,0,15,2
1731504552154,TDHT 22,A01,760797,Yapp; Hentyle T,24,0,24,0
1731504552154,TDHT 22,A02,760799,Yapp; Hentyle T,24,0,24,0
1731504552154,TDHT 22,A03,760801,Yapp; Hentyle T,21,0,24,3
1731504553180,TDHT 101,A00,760843,Mehrishi; Rishika,24,0,25,1
1731504553180,TDHT 101,B00,760845,Perry; Lamar,23,0,25,2
1731504554205,TDHT 102,A00,760846,Anderson; Mysia Anyse,24,0,25,1
1731504555233,TDHT 111,A00,760849,Power; Jade Yukana,17,0,20,3
1731504556263,TDMV 1,A00,760802,Arcidiacono; Kristin,25,0,30,5
1731504556263,TDMV 1,B00,760803,Staff,26,0,30,4
1731504557290,TDMV 2,A00,796063,Sammartano; Tonnie,20,0,30,10
1731504558314,TDMV 3,A00,760805,Mack; Kara Shanai',34,0,40,6
1731504559342,TDMV 11,A00,760807,Staff,28,0,30,2
1731504560369,TDMV 20,A00,760808,Alvarez; Ana Maria,0,0,0,0
1731504560369,TDMV 20,B00,760810,Smith; Alison D,30,0,30,0
1731504561396,TDMV 110,A00,760851,Weinberg; Sadie,30,0,30,0
1731504562421,TDMV 120,A00,760852,Yapp; Hentyle T,29,0,30,1
1731504562421,TDMV 120,B00,760853,Brown; Bernard Joseph,0,0,0,0
1731504563448,TDMV 123,A00,760855,Duran; Marcos Antonio,28,0,30,2
1731504564478,TDMV 130,A00,760856,Mack; Kara Shanai',40,0,40,0
1731504565509,TDMV 138,A00,795397,Corrales; Joseph Bernales,34,0,40,6
1731504566540,TDMV 140,A00,760857,Staff,37,0,40,3
1731504566540,TDMV 140,B00,760859,Corrales; Joseph Bernales,37,0,40,3
1731504566540,TDMV 140,C00,760860,Caligagan; Tony,37,0,40,3
1731504567567,TDMV 142,A00,760861,Blanco; Juan Carlos,28,0,30,2
1731504568596,TDMV 143,A00,760862,Fyall; Daunte Edward,30,0,30,0
1731504569621,TDMV 144,A00,760864,Staff,29,0,30,1
1731504570646,TDMV 146,A00,760866,Caligagan; Tony,28,0,30,2
1731504571672,TDMV 148,A00,760867,Jun; Grace Shin Hae,38,0,40,2
1731504572702,TDPF 161,A00,760869,Brown; Bernard Joseph,40,0,40,0
1731504573731,TDPF 163,A00,760870,Fyall; Daunte Edward,30,0,30,0
1731504573731,TDPF 163,B00,760871,Johnston; Holly,30,0,30,0
1731504573731,TDPF 163,C00,760872,Blanco; Juan Carlos,30,0,30,0
1731504574757,TDPR 6,A01,760812,Guirguis; Mark C,50,0,50,0
1731504574757,TDPR 6,A02,760814,Guirguis; Mark C,50,0,50,0
1731504575782,TDPR 102,A00,760873,Guirguis; Mark C,20,0,20,0
1731504576811,TDPR 104,A00,760874,Powell; Lora,15,0,15,0
1731504577839,TDPW 101,A00,760875,Stein; Deborah Isobel,20,0,20,0
1731504577839,TDPW 101,B00,760876,Stein; Deborah Isobel,19,0,20,1
1731504577839,TDPW 101,C00,760877,Stein; Deborah Isobel,20,0,20,0
1731504577839,TDPW 101,D00,760878,Stein; Deborah Isobel,18,0,20,2
1731504577839,TDPW 101,E00,760879,Stein; Deborah Isobel,20,0,20,0
1731504578865,TDPW 104,A00,760880,Staff,20,0,20,0
1731504579894,TDTR 10,A00,760815,Yapp; Hentyle T,30,0,30,0
1731504580922,TDTR 15,A00,760816,Smith; Alison D,29,0,30,1
1731504581947,TDTR 104,A00,795400,Smith; Alison D,30,0,30,0
1731504582974,TMC 15,A00,799598,Staff,25,0,25,0
1731504584001,TMC 20,A00,795572,Carver; Leslie J.,25,0,25,0
1731504585026,UROL 296,001,793638,Staff,10,0,10,0
1731504585026,UROL 296,002,793644,Staff,10,0,10,0
1731504586062,USP 2,A01,762958,Pezzoli; Keith,33,0,35,2
1731504586062,USP 2,A02,762960,Pezzoli; Keith,31,0,35,4
1731504587092,USP 3,A01,762962,Wickland; Teo Akande,34,0,35,1
1731504587092,USP 3,A02,762963,Wickland; Teo Akande,31,0,35,4
1731504588119,USP 4,A00,762964,Staff,27,0,30,3
1731504589193,USP 5,A01,762967,Sun; Feiyang,31,0,35,4
1731504589193,USP 5,A02,762968,Sun; Feiyang,33,0,35,2
1731504590219,USP 6,A01,762970,Shvartzberg Carrio; Manuel,35,0,35,0
1731504590219,USP 6,A02,762971,Shvartzberg Carrio; Manuel,34,0,35,1
1731504591248,USP 15,A01,762973,Anderson; William Raymond,32,0,35,3
1731504591248,USP 15,A02,762974,Anderson; William Raymond,34,0,35,1
1731504592275,USP 25,A00,762975,Shenkman; Michael Thomas,69,0,70,1
1731504593305,USP 100,A00,762976,Arroyo; John Christopher,66,0,70,4
1731504594331,USP 101,A00,762977,Staff,65,0,65,0
1731504595360,USP 108,A00,762978,Pezzoli; Keith,29,0,30,1
1731504596444,USP 124,A00,762979,Fulton; William,64,0,70,6
1731504597469,USP 128A,A01,762982,Lewis; Leslie R,13,0,13,0
1731504598496,USP 138,A00,762984,Anderson; William Raymond,25,0,25,0
1731504599526,USP 141A,A00,762985,Lewis; Leslie R,25,0,25,0
1731504600552,USP 143,A00,762986,Hinds; Juli Beth,198,0,225,27
1731504601578,USP 150,A00,762987,Osias; David,55,0,60,5
1731504602612,USP 151,A00,763006,Boomhower; Matthew Charles,68,0,70,2
1731504603639,USP 152A,A01,763042,Moeder; Nathan L,27,0,30,3
1731504603639,USP 152A,A02,763060,Moeder; Nathan L,30,0,30,0
1731504604668,USP 153,A00,763071,Shenkman; Michael Thomas,64,0,70,6
1731504605709,USP 158A,A00,798344,Bajaj; Ravi Siddharth,35,0,35,0
1731504606734,USP 159A,A00,763078,Gherini; Paul Pier-Carlo,8,0,8,0
1731504607766,USP 165A,A00,763079,Collins; Caroline Imani,23,0,25,2
1731504608792,USP 165B,A00,763083,Shilon; Mor,13,0,15,2
1731504609819,USP 170,A00,763084,Entezam; Maryam,48,0,50,2
1731504610852,USP 171,A00,763147,Lerner; Amy M,43,0,55,12
1731504611881,USP 173,A00,763151,Shvartzberg Carrio; Manuel,44,0,50,6
1731504612908,USP 175,A00,763152,Peerson; Susan,23,0,25,2
1731504613935,USP 177A,A00,763156,Velasco; Diego,24,0,25,1
1731504613935,USP 177A,B00,763158,Garcia; Kathleen,24,0,25,1
1731504614961,USP 179,A00,763161,Peerson; Susan,23,0,25,2
1731504615989,USP 180,A00,763164,Frank; Lawrence Douglas,28,0,30,2
1731504617015,USP 183,A00,763165,Sutton; April Marie,25,0,25,0
1731504618041,USP 185B,A01,763169,Boomhower; Matthew Charles,0,0,0,4
1731504618041,USP 185B,B01,763180,Sun; Feiyang,0,0,0,0
1731504619066,USP 187,A01,763190,Martin; Isaac,23,0,30,7
1731504619066,USP 187,A02,763196,Martin; Isaac,30,0,30,0
1731504620092,USP 188,A01,763235,Andrews; Abigail Leslie,28,0,30,2
1731504621119,USP 189,A00,763237,Arroyo; John Christopher,25,0,25,0
1731504621119,USP 189,B00,763240,Osias; David,23,0,25,2
1731504622198,USP 191A,A00,763243,Staff,15,0,20,5
1731504623225,USP 193,A00,795586,Devereux; Christina Schopp,22,0,25,3
1731504624254,USP 194,A00,770726,Hill; Seth J,9999,0,9999,0
1731504625281,USP 271,A00,763245,Lerner; Amy M,0,0,5,5
1731504626314,VIS 2,A01,769502,Segade; Alexandro Abraham,25,0,25,0
1731504626314,VIS 2,A02,769503,Segade; Alexandro Abraham,24,0,25,1
1731504626314,VIS 2,A03,769504,Segade; Alexandro Abraham,25,0,25,0
1731504626314,VIS 2,A04,769505,Segade; Alexandro Abraham,24,0,25,1
1731504626314,VIS 2,A05,769506,Segade; Alexandro Abraham,25,0,25,0
1731504626314,VIS 2,A06,769507,Segade; Alexandro Abraham,25,0,25,0
1731504626314,VIS 2,A07,769508,Segade; Alexandro Abraham,0,0,0,0
1731504626314,VIS 2,A08,769509,Segade; Alexandro Abraham,0,0,0,0
1731504627344,VIS 6,A00,769510,Staff,141,0,146,5
1731504628372,VIS 11,A01,769513,Cartwright; Lisa,33,0,34,1
1731504628372,VIS 11,A02,769514,Cartwright; Lisa,33,0,34,1
1731504628372,VIS 11,A03,769515,Cartwright; Lisa,34,0,34,0
1731504628372,VIS 11,A04,769516,Cartwright; Lisa,34,0,34,0
1731504628372,VIS 11,A05,769517,Cartwright; Lisa,34,0,34,0
1731504628372,VIS 11,A06,769519,Cartwright; Lisa,33,0,34,1
1731504628372,VIS 11,A07,769521,Cartwright; Lisa,31,0,34,3
1731504628372,VIS 11,A08,769522,Cartwright; Lisa,34,0,34,0
1731504628372,VIS 11,A09,769523,Cartwright; Lisa,33,0,34,1
1731504628372,VIS 11,A10,769524,Cartwright; Lisa,33,0,34,1
1731504628372,VIS 11,A11,769554,Cartwright; Lisa,34,0,34,0
1731504628372,VIS 11,A12,769557,Cartwright; Lisa,34,0,34,0
1731504629400,VIS 21B,A01,769570,Shen; Kuiyi,31,0,32,1
1731504629400,VIS 21B,A02,769571,Shen; Kuiyi,31,0,32,1
1731504629400,VIS 21B,A03,769587,Shen; Kuiyi,31,0,32,1
1731504629400,VIS 21B,A04,769600,Shen; Kuiyi,32,0,32,0
1731504629400,VIS 21B,A05,769639,Shen; Kuiyi,32,0,32,0
1731504629400,VIS 21B,A06,769693,Shen; Kuiyi,32,0,32,0
1731504629400,VIS 21B,A07,769710,Shen; Kuiyi,31,0,32,1
1731504629400,VIS 21B,A08,769755,Shen; Kuiyi,32,0,32,0
1731504630433,VIS 22,A01,769936,Rose; Jordan M,32,0,32,0
1731504630433,VIS 22,A02,769969,Rose; Jordan M,32,0,32,0
1731504630433,VIS 22,A03,769978,Rose; Jordan M,31,0,32,1
1731504630433,VIS 22,A04,770005,Rose; Jordan M,32,0,32,0
1731504630433,VIS 22,A05,770007,Rose; Jordan M,32,0,32,0
1731504630433,VIS 22,A06,770009,Rose; Jordan M,31,0,32,1
1731504630433,VIS 22,A07,770047,Rose; Jordan M,28,0,32,4
1731504630433,VIS 22,A08,770048,Rose; Jordan M,31,0,32,1
1731504630433,VIS 22,A09,770050,Rose; Jordan M,32,0,32,0
1731504630433,VIS 22,A10,770055,Rose; Jordan M,32,0,32,0
1731504630433,VIS 22,A11,770057,Rose; Jordan M,32,0,32,0
1731504630433,VIS 22,A12,770063,Rose; Jordan M,32,0,32,0
1731504631465,VIS 41,A01,770086,D'Elena-Tweed; Jessica Erin,24,0,25,1
1731504631465,VIS 41,A02,770194,D'Elena-Tweed; Jessica Erin,23,0,25,2
1731504631465,VIS 41,A03,770195,D'Elena-Tweed; Jessica Erin,23,0,25,2
1731504631465,VIS 41,A04,770196,D'Elena-Tweed; Jessica Erin,23,0,25,2
1731504631465,VIS 41,A05,770197,D'Elena-Tweed; Jessica Erin,24,0,25,1
1731504631465,VIS 41,A06,770198,D'Elena-Tweed; Jessica Erin,25,0,25,0
1731504631465,VIS 41,A07,770199,D'Elena-Tweed; Jessica Erin,25,0,25,0
1731504631465,VIS 41,A08,770200,D'Elena-Tweed; Jessica Erin,24,0,25,1
1731504632493,VIS 60,A01,770202,Mostajo; Lorena,25,0,25,0
1731504632493,VIS 60,A02,770203,Mostajo; Lorena,25,0,25,0
1731504632493,VIS 60,A03,770204,Mostajo; Lorena,25,0,25,0
1731504632493,VIS 60,A04,770205,Mostajo; Lorena,25,0,25,0
1731504632493,VIS 60,A05,770206,Mostajo; Lorena,25,0,25,0
1731504632493,VIS 60,A06,770207,Mostajo; Lorena,25,0,25,0
1731504633526,VIS 83,A00,770208,Kester; Grant,195,0,200,5
1731504634556,VIS 100,A00,770210,Cruz; Edwin Teddy,140,0,146,6
1731504635587,VIS 101A,A00,770215,Park; Kyong Dong,10,0,15,5
1731504635587,VIS 101A,B00,770229,Riley; Joe,13,0,15,2
1731504636613,VIS 103,A00,770230,Cruz; Edwin Teddy,145,0,146,1
1731504637641,VIS 103B,A00,770234,Park; Kyong Dong,74,0,75,1
1731504638668,VIS 105A,A00,770237,Tonies; Joshua Vanjaymes,24,0,30,6
1731504639697,VIS 105B,A00,770239,Tonies; Joshua Vanjaymes,27,0,30,3
1731504640723,VIS 105C,A00,770240,Adler; Amy,13,0,15,2
1731504641755,VIS 106A,A00,770241,Tobe; Geoffroy,25,0,25,0
1731504641755,VIS 106A,B00,770243,De Luca; Mara Julia,22,0,25,3
1731504642781,VIS 106B,A00,770244,De Luca; Mara Julia,22,0,25,3
1731504643807,VIS 107A,A00,770248,Iglesias; Janelle Ann,21,0,25,4
1731504644835,VIS 107C,A00,770249,Staff,15,0,15,0
1731504645862,VIS 108,A00,770250,Moss; Ceci,15,0,15,0
1731504645862,VIS 108,B00,770251,Adler; Amy,11,0,15,4
1731504646889,VIS 110D,A00,770253,Dean; Danielle Adobi,11,0,15,4
1731504647921,VIS 110F,A00,770254,Iglesias; Janelle Ann,14,0,15,1
1731504648947,VIS 110M,A00,770256,Dean; Danielle Adobi,15,0,15,0
1731504649974,VIS 112,A00,770257,Welchman; John C.,12,0,15,3
1731504650999,VIS 114B,A00,770260,Tronzo; William,12,0,15,3
1731504652024,VIS 124G,A00,770261,Rose; Jordan M,72,0,75,3
1731504653049,VIS 125G,A00,770262,Kester; Grant,75,0,75,0
1731504654078,VIS 126HN,A00,770264,Newsome; Elizabeth Ann,74,0,75,1
1731504655105,VIS 128C,A00,770265,Gaines; Malik Julian,75,0,75,0
1731504656131,VIS 128D,A00,770267,Asplund; Ingrid Marie,73,0,75,2
1731504657156,VIS 129E,A00,770268,Shen; Kuiyi,15,0,15,0
1731504658182,VIS 131,A00,770269,Erdmann; Dean,15,0,15,0
1731504659207,VIS 133,A01,770274,Staff,34,0,34,0
1731504659207,VIS 133,A02,770275,Staff,33,0,34,1
1731504660233,VIS 133A,A00,770276,Staff,13,0,15,2
1731504661259,VIS 135,A01,770280,Staff,21,0,22,1
1731504661259,VIS 135,A02,770281,Staff,16,0,22,6
1731504662289,VIS 141A,A01,770284,Stalbaum; Brett,23,0,25,2
1731504662289,VIS 141A,A02,770285,Stalbaum; Brett,21,0,25,4
1731504663315,VIS 142,A01,770287,Stalbaum; Brett,25,0,25,0
1731504663315,VIS 142,A02,770288,Stalbaum; Brett,25,0,25,0
1731504663315,VIS 142,A03,770290,Stalbaum; Brett,25,0,25,0
1731504663315,VIS 142,A04,770291,Stalbaum; Brett,25,0,25,0
1731504663315,VIS 142,A05,770292,Stalbaum; Brett,24,0,25,1
1731504663315,VIS 142,A06,770293,Stalbaum; Brett,25,0,25,0
1731504664342,VIS 145A,A01,770301,Stone; Patricia,20,0,22,2
1731504664342,VIS 145A,A02,770302,Stone; Patricia,22,0,22,0
1731504664342,VIS 145A,A03,770303,Stone; Patricia,22,0,22,0
1731504664342,VIS 145A,A04,770304,Stone; Patricia,20,0,22,2
1731504664342,VIS 145A,A05,770306,Stone; Patricia,21,0,22,1
1731504664342,VIS 145A,A06,770307,Stone; Patricia,21,0,22,1
1731504665372,VIS 146B,A00,794512,Twomey; Robert Daniel,15,0,15,0
1731504666400,VIS 147A,A01,770309,Staff,22,0,22,0
1731504666400,VIS 147A,A02,770311,Staff,20,0,22,2
1731504666400,VIS 147A,A03,770312,Staff,22,0,22,0
1731504666400,VIS 147A,A04,770313,Staff,22,0,22,0
1731504667426,VIS 147B,A00,770316,Akten; Mehmet,11,0,15,4
1731504668453,VIS 149,A00,770318,Alexander; Amy J,14,0,15,1
1731504668453,VIS 149,B00,795449,Crandall; Jordan,13,0,15,2
1731504669483,VIS 150,A00,770319,Wardwell; Mariana Razo,70,0,75,5
1731504670509,VIS 157D,A01,770329,Williams; Alena J,33,0,34,1
1731504670509,VIS 157D,A02,770334,Williams; Alena J,33,0,34,1
1731504671537,VIS 160A,A00,770375,Akten; Mehmet,9,0,15,6
1731504671537,VIS 160A,B00,770380,Alexander; Amy J,14,0,15,1
1731504671537,VIS 160A,C00,770391,Twomey; Robert Daniel,11,0,15,4
1731504672563,VIS 161,A00,770470,D'Elena-Tweed; Jessica Erin,14,0,15,1
1731504673595,VIS 164,A00,770484,Cross; Brian R,19,0,22,3
1731504673595,VIS 164,B00,770535,Erdmann; Dean,22,0,22,0
1731504674624,VIS 165B,A00,770548,Sprague; Sean Jeffrey,20,0,22,2
1731504675649,VIS 169A,A00,770551,Mostajo; Lorena,20,0,22,2
1731504676680,VIS 171,A00,770552,Dinco; Dino,22,0,22,0
1731504677708,VIS 174,A00,770599,Cross; Brian R,20,0,22,2
1731504677708,VIS 174,B00,770666,Dinco; Dino,21,0,22,1
1731504677708,VIS 174,C00,770705,Dinco; Dino,22,0,22,0
1731504678738,VIS 179,A00,770708,Zurita; Dmitri,22,0,22,0
1731504679768,VIS 180A,A00,770709,Erdmann; Dean,22,0,22,0
1731504680793,VIS 180B,A00,770710,Stone; Patricia,21,0,22,1
1731504681819,VIS 182A,A00,770711,Sprague; Sean Jeffrey,21,0,22,1
1731504682848,VIS 185,A00,770712,Trigilio; Michael,17,0,22,5
1731504683875,VIS 200,A00,770713,Wardwell; Mariana Razo,12,0,15,3
1731504684901,VIS 201,A00,770714,Bratton; Benjamin H.,10,0,15,5
1731504685927,VIS 202,A00,770715,Mangolte; Babette,2,0,15,13
1731504686951,VIS 203,A00,770716,Segade; Alexandro Abraham,0,0,15,15
1731504688049,VIS 242,A00,770718,Cartwright; Lisa,8,0,15,7
1731504689080,VIS 255,A00,770719,Welchman; John C.,8,0,15,7
1731504690108,VIS 260,A00,770720,Newsome; Elizabeth Ann,9,0,15,6
1731504691143,WCWP 10A,001,765834,Staff,0,0,0,0
1731504691143,WCWP 10A,002,765835,Windham; Emily,13,0,20,7
1731504691143,WCWP 10A,003,765836,Windham; Emily,17,0,20,3
1731504691143,WCWP 10A,004,765837,Escobar; Jordan Christophe,17,0,20,3
1731504691143,WCWP 10A,005,765838,Windham; Emily,16,0,20,4
1731504691143,WCWP 10A,006,765839,Escobar; Jordan Christophe,18,0,20,2
1731504691143,WCWP 10A,007,765840,Escobar; Jordan Christophe,19,0,20,1
1731504691143,WCWP 10A,008,765841,Staff,0,0,0,0
1731504691143,WCWP 10A,009,765842,Merryman; Walter,19,0,20,1
1731504691143,WCWP 10A,010,765843,Merryman; Walter,18,0,20,2
1731504691143,WCWP 10A,011,765844,Staff,0,0,0,0
1731504691143,WCWP 10A,012,765855,Staff,0,0,0,0
1731504691143,WCWP 10A,013,766004,Staff,0,0,0,0
1731504691143,WCWP 10A,014,766006,Susi; Natalie,15,0,20,5
1731504691143,WCWP 10A,015,766008,Welji; Haleema Nazir,18,0,20,2
1731504691143,WCWP 10A,016,766010,Martiniuk; Jill,19,0,20,1
1731504691143,WCWP 10A,017,766012,Martiniuk; Jill,16,0,20,4
1731504691143,WCWP 10A,018,766050,Staff,0,0,0,0
1731504691143,WCWP 10A,019,766051,Martiniuk; Jill,14,0,20,6
1731504691143,WCWP 10A,020,766052,Staff,0,0,0,0
1731504691143,WCWP 10A,021,766053,Holloway Ii; Mathew,19,0,20,1
1731504691143,WCWP 10A,022,766054,Holloway Ii; Mathew,20,0,20,0
1731504691143,WCWP 10A,023,766055,Holloway Ii; Mathew,20,0,20,0
1731504692175,WCWP 10B,001,766056,Staff,0,0,0,0
1731504692175,WCWP 10B,002,766057,Ornelas; Tricia,19,0,20,1
1731504692175,WCWP 10B,003,766058,Ornelas; Tricia,19,0,20,1
1731504692175,WCWP 10B,004,766119,Gagnon; Jeffrey C,0,0,0,0
1731504692175,WCWP 10B,005,766120,Ornelas; Tricia,15,0,20,5
1731504692175,WCWP 10B,006,766127,Staff,0,0,0,0
1731504692175,WCWP 10B,007,766162,Staff,0,0,0,0
1731504692175,WCWP 10B,008,766181,Dhir; Simrita,20,0,20,0
1731504692175,WCWP 10B,009,766182,Dhir; Simrita,17,0,20,3
1731504692175,WCWP 10B,010,766186,Uriarte; Emma,11,0,20,9
1731504692175,WCWP 10B,011,766187,Dhir; Simrita,18,0,20,2
1731504692175,WCWP 10B,012,766188,Uriarte; Emma,12,0,20,8
1731504692175,WCWP 10B,013,766189,Staff,0,0,0,0
1731504692175,WCWP 10B,014,766190,Staff,0,0,0,0
1731504692175,WCWP 10B,015,766191,Staff,0,0,0,0
1731504692175,WCWP 10B,016,766193,Staff,0,0,0,0
1731504692175,WCWP 10B,017,766194,Staff,0,0,0,0
1731504692175,WCWP 10B,018,766195,Staff,0,0,0,0
1731504692175,WCWP 10B,019,766196,Staff,0,0,0,0
1731504692175,WCWP 10B,020,766198,Staff,0,0,0,0
1731504692175,WCWP 10B,021,766201,Staff,0,0,0,0
1731504692175,WCWP 10B,022,766203,Staff,0,0,0,0
1731504692175,WCWP 10B,023,766204,Staff,0,0,0,0
1731504692175,WCWP 10B,024,766205,Staff,0,0,0,0
1731504692175,WCWP 10B,025,766207,Staff,0,0,0,0
1731504692175,WCWP 10B,026,766208,Staff,0,0,0,0
1731504692175,WCWP 10B,027,766209,Staff,0,0,0,0
1731504692175,WCWP 10B,028,766210,Staff,0,0,0,0
1731504693204,WCWP 100,A00,766213,McCleary; Keith Long,17,0,20,3
1731504693204,WCWP 100,B00,766215,McCleary; Keith Long,20,0,20,0
1731504693204,WCWP 100,C00,766217,McCleary; Keith Long,20,0,20,0
1731504693204,WCWP 100,D00,766220,Twohig; Niall Ivan,17,0,20,3
1731504693204,WCWP 100,E00,766221,Twohig; Niall Ivan,14,0,20,6
1731504693204,WCWP 100,F00,766222,Young; Mark T,19,0,20,1
1731504693204,WCWP 100,G00,766223,Young; Mark T,18,0,20,2
1731504693204,WCWP 100,H00,766224,Twohig; Niall Ivan,20,0,20,0
1731504693204,WCWP 100,I00,766228,Young; Mark T,19,0,20,1
1731504694234,WES 237A,A00,763250,Weibel; Nadir,15,0,15,0
1731504695260,WES 268B,A01,763253,Ling; Patrick L,15,0,15,0
1731504696287,WES 269,A00,763255,Pannuto; Patrick William,15,0,15,0
1731504698727,AAPI 198,A00,795102,Solomon; Amanda Lee Albaniel,9999,0,9999,0
1731504699755,AAS 10,A01,734476,Butler; Elizabeth Annette,32,0,34,2
1731504699755,AAS 10,A02,734477,Butler; Elizabeth Annette,33,0,34,1
1731504700841,AAS 11,A01,734479,Butler; Elizabeth Annette,33,0,34,1
1731504700841,AAS 11,A02,734480,Butler; Elizabeth Annette,33,0,34,1
1731504701874,AESE 241,A00,733587,Erat; Sanjiv & Wade; Jon P,35,0,35,0
1731504702904,AESE 278B,A00,733588,Gessner; Richard K.,35,0,35,0
1731504703932,AESE 278C,A00,733589,Wade; Jon P,35,0,35,0
1731504704963,AESE 279A,A00,733591,Zak; Alexander & Wade; Jon P,35,0,35,0
1731504705990,ANAR 121,A01,733532,Staff,39,0,40,1
1731504707018,ANAR 143,A00,799583,Dunseth; Zachary Clark,29,0,30,1
1731504708045,ANAR 158,A00,733535,Goldstein; Paul S,36,0,40,4
1731504709073,ANAR 164,A00,733536,Staff,44,0,45,1
1731504710101,ANAR 165,A00,799586,Staff,30,0,30,0
1731504711129,ANBI 100,A00,733537,Fox; Patrick Keolu Ozer,39,0,40,1
1731504712157,ANBI 130,A00,733538,Non; Amy L,55,0,70,15
1731504713185,ANBI 134,A00,733552,Simonson; Tatum Sasha Summ,28,0,30,2
1731504714215,ANBI 140,A00,733553,Staff,34,0,40,6
1731504715246,ANBI 143,A00,733554,Wilder; Linnea Lorene,36,0,40,4
1731504716277,ANBI 173,A00,733555,Wilder; Linnea Lorene,69,0,70,1
1731504717301,ANES 296,001,791559,Staff,10,0,10,0
1731504717301,ANES 296,002,791560,Staff,10,0,10,0
1731504717301,ANES 296,003,791561,Staff,10,0,10,0
1731504718329,ANSC 101A,A00,733558,Kang; Byung Chu,148,0,150,2
1731504719355,ANSC 109,A00,733559,Pedersen; David,40,0,40,0
1731504720385,ANSC 125,A00,733560,Brenner; Suzanne A,65,0,70,5
1731504721418,ANSC 135,A00,733561,Stone; Annika Britt,38,0,40,2
1731504722446,ANSC 139,A00,733562,Csordas; Thomas J.,20,0,20,0
1731504723472,ANSC 146,A00,733563,Kang; Byung Chu,69,0,70,1
1731504724499,ANSC 148,A00,733564,Schonberg; Jeffrey,46,0,46,0
1731504725527,ANSC 150,A00,733565,Sloane; Julia Kathryn,35,0,35,0
1731504726557,ANSC 154,A00,733566,Brenner; Suzanne A,10,0,12,2
1731504727589,ANSC 164,A00,733567,Stewart; Alexander B,37,0,40,3
1731504728614,ANSC 184,A00,733568,Fortier; Jana,40,0,40,0
1731504729642,ANSC 190,A00,733569,Jassal; Aftab,39,0,40,1
1731504730676,ANTH 5,A00,733397,Semendeferi; Ekaterini,20,0,20,0
1731504731706,ANTH 10,A00,733400,Staff,247,0,250,3
1731504732733,ANTH 21,A01,733407,Stone; Annika Britt,30,0,30,0
1731504732733,ANTH 21,A02,733409,Stone; Annika Britt,29,0,30,1
1731504732733,ANTH 21,A03,733411,Stone; Annika Britt,27,0,30,3
1731504732733,ANTH 21,A04,733414,Stone; Annika Britt,24,0,30,6
1731504732733,ANTH 21,A05,733416,Stone; Annika Britt,27,0,30,3
1731504733765,ANTH 23,A01,733472,Stewart; Alexander B,35,0,35,0
1731504733765,ANTH 23,A02,733501,Stewart; Alexander B,34,0,35,1
1731504733765,ANTH 23,A03,733502,Stewart; Alexander B,34,0,35,1
1731504733765,ANTH 23,A04,733507,Stewart; Alexander B,35,0,35,0
1731504733765,ANTH 23,A05,733525,Stewart; Alexander B,35,0,35,0
1731504733765,ANTH 23,A06,733528,Stewart; Alexander B,35,0,35,0
1731504734793,ANTH 45,A00,733530,Jassal; Aftab,30,0,30,0
1731504735822,ANTH 87,A00,795649,Pedersen; David,20,0,20,0
1731504736847,ANTH 102,A00,733570,Fox; Patrick Keolu Ozer,144,0,150,6
1731504737872,ANTH 106,A00,733571,Sloane; Julia Kathryn,30,0,30,0
1731504738903,ANTH 107,A00,733572,Shtienberg; Gilad,28,0,30,2
1731504739930,ANTH 111,A00,733573,Bialecki; Jon Anthony,39,0,40,1
1731504740962,ANTH 128A,A01,733576,Lewis; Leslie R,12,0,12,0
1731504741989,ANTH 196B,A00,733577,Varma; Saiba,15,0,15,0
1731504743019,ANTH 200,A00,733578,Fox; Patrick Keolu Ozer,15,0,15,0
1731504744046,ANTH 203,A00,733579,Gagneux; Pascal,9,0,15,6
1731504745076,ANTH 212,A00,733582,Marchetto; Maria Carolina,14,0,15,1
1731504746103,ANTH 230,001,799994,Gagneux; Pascal,19,0,20,1
1731504747131,ANTH 231,A00,799587,Staff,13,0,15,2
1731504748161,ANTH 236,A00,733583,Csordas; Thomas J.,9,0,12,3
1731504749191,ANTH 269,A00,733584,Lampland; Martha,5,0,5,0
1731504750222,ANTH 273,A00,733585,McKenzie; Kerry V.,5,0,5,0
1731504751249,ANTH 280F,A00,733586,Yeh; Rihan Wen Xin,13,0,15,2
1731504752290,ANTH 295,001,799995,Algaze; Guillermo,3,0,3,0
1731504752290,ANTH 295,002,799996,Brenner; Suzanne A,3,0,3,0
1731504752290,ANTH 295,003,799997,Csordas; Thomas J.,3,0,3,0
1731504752290,ANTH 295,004,799998,Fox; Patrick Keolu Ozer,3,0,3,0
1731504752290,ANTH 295,005,799999,Gagneux; Pascal,3,0,3,0
1731504752290,ANTH 295,006,800000,Goldstein; Paul S,3,0,3,0
1731504752290,ANTH 295,007,800001,Hankins; Joseph D.,3,0,3,0
1731504752290,ANTH 295,008,800002,Jassal; Aftab,3,0,3,0
1731504752290,ANTH 295,009,800035,Jenkins; Janis A.,3,0,3,0
1731504752290,ANTH 295,010,800036,Kaiser; Bronwyn Nicole,3,0,3,0
1731504752290,ANTH 295,011,800037,Kang; Byung Chu,3,0,3,0
1731504752290,ANTH 295,012,800038,Marchetto; Maria Carolina,3,0,3,0
1731504752290,ANTH 295,013,800039,Non; Amy L,3,0,3,0
1731504752290,ANTH 295,014,800040,Pedersen; David,3,0,3,0
1731504752290,ANTH 295,015,800041,Rivera-Collazo; Isabel C,3,0,3,0
1731504752290,ANTH 295,016,800042,Varma; Saiba,3,0,3,0
1731504752290,ANTH 295,017,800043,Yeh; Rihan Wen Xin,3,0,3,0
1731504753319,ANTH 296,001,800044,Braswell; Geoffrey E.,3,0,3,0
1731504753319,ANTH 296,002,800045,Marchetto; Maria Carolina,3,0,3,0
1731504753319,ANTH 296,003,800107,Rivera-Collazo; Isabel C,3,0,3,0
1731504753319,ANTH 296,004,800108,Varma; Saiba,2,0,3,1
1731504753319,ANTH 296,005,800109,Algaze; Guillermo,3,0,3,0
1731504753319,ANTH 296,006,800110,Brenner; Suzanne A,3,0,3,0
1731504753319,ANTH 296,007,800111,Csordas; Thomas J.,3,0,3,0
1731504753319,ANTH 296,008,800112,Fox; Patrick Keolu Ozer,3,0,3,0
1731504753319,ANTH 296,009,800113,Gagneux; Pascal,3,0,3,0
1731504753319,ANTH 296,010,800114,Goldstein; Paul S,2,0,3,1
1731504753319,ANTH 296,011,800116,Hankins; Joseph D.,3,0,3,0
1731504753319,ANTH 296,012,800117,Jassal; Aftab,3,0,3,0
1731504753319,ANTH 296,013,800118,Jenkins; Janis A.,3,0,3,0
1731504753319,ANTH 296,014,800119,Kaiser; Bronwyn Nicole,2,0,3,1
1731504753319,ANTH 296,015,800120,Kang; Byung Chu,3,0,3,0
1731504753319,ANTH 296,016,800121,Levy; Thomas E,3,0,3,0
1731504753319,ANTH 296,017,800122,Non; Amy L,3,0,3,0
1731504753319,ANTH 296,018,800123,Pedersen; David,3,0,3,0
1731504753319,ANTH 296,019,800184,Postero; Nancy Grey,3,0,3,0
1731504753319,ANTH 296,020,800185,Semendeferi; Ekaterini,3,0,3,0
1731504753319,ANTH 296,021,800186,Yeh; Rihan Wen Xin,3,0,3,0
1731504754347,ASTR 3,A01,733595,Trumbo; Samantha Kathleen,294,0,300,6
1731504755377,ASTR 20B,A01,733598,Konopacky; Quinn Morgan,49,0,50,1
1731504756405,ASTR 99,001,799856,Konopacky; Quinn Morgan,9999,0,9999,0
1731504757437,ASTR 102,A01,733600,Diamond; Patrick H & Konopacky; Quinn Morgan,29,0,30,1
1731504758466,ASTR 105,A01,733607,Boggs; Steven Edward,30,0,30,0
1731504759494,ASTR 122,A01,733609,Keres; Dusan,40,0,40,0
1731504760522,ASTR 150,A01,733641,Theissen; Christopher Alexander,28,0,30,2
1731504760522,ASTR 150,A02,733642,Theissen; Christopher Alexander,28,0,30,2
1731504761549,ASTR 201,A00,790490,Burgasser; Adam Jonathan,9,0,15,6
1731504762578,ASTR 210,A00,733648,Staff,12,0,15,3
1731504763604,ASTR 220,A00,733650,Wright; Shelley Adams,12,0,15,3
1731504764634,ASTR 250,A00,733652,Theissen; Christopher Alexander & Hosseinzadeh; Griffin Alex,22,0,30,8
1731504765664,ASTR 251,A00,733653,Theissen; Christopher Alexander & Hosseinzadeh; Griffin Alex,23,0,30,7
1731504766692,AUD 236,A01,791504,Harris; Jeffrey Paul,5,0,5,0
1731504767720,AUD 263,A00,791538,Zettner; Erika,13,0,13,0
1731504768746,AUD 276,A00,791507,Zettner; Erika,13,0,13,0
1731504769773,AUD 284,A01,791509,Zettner; Erika,13,0,13,0
1731504770799,AUD 291,A00,791534,Zettner; Erika,13,0,13,0
1731504771826,AUD 296,A00,791535,Zettner; Erika,13,0,13,0
1731504772881,AWP 3,002,733077,Ajo; Frances Margaret,12,0,12,0
1731504772881,AWP 3,003,733078,Given; William Allan,12,0,12,0
1731504772881,AWP 3,004,733080,Ajo; Frances Margaret,12,0,12,0
1731504772881,AWP 3,005,733082,Westerfeld; Kevin John,12,0,12,0
1731504772881,AWP 3,007,733085,O'Neil; Courtney L,12,0,12,0
1731504772881,AWP 3,008,733087,O'Neil; Courtney L,12,0,12,0
1731504772881,AWP 3,009,733138,Zimmerman; Guy,12,0,12,0
1731504772881,AWP 3,010,733139,Zimmerman; Guy,12,0,12,0
1731504772881,AWP 3,011,733140,Westerfeld; Kevin John,12,0,12,0
1731504772881,AWP 3,012,733141,Zimmerman; Guy,11,0,12,1
1731504772881,AWP 3,013,733142,Sartor; Alexandra,12,0,12,0
1731504772881,AWP 3,014,733143,Sartor; Alexandra,12,0,12,0
1731504772881,AWP 3,015,733144,Vaughn; Kelsey Sara,12,0,12,0
1731504772881,AWP 3,016,733145,Vaughn; Kelsey Sara,12,0,12,0
1731504772881,AWP 3,019,733148,Kolodezh; Samuel,12,0,12,0
1731504772881,AWP 3,020,733149,Kolodezh; Samuel,12,0,12,0
1731504772881,AWP 3,022,733151,Kolodezh; Samuel,12,0,12,0
1731504773923,AWP 4A,001,733154,Tsurska Svetina; Olena,13,0,14,1
1731504773923,AWP 4A,002,733156,Tsurska Svetina; Olena,10,0,14,4
1731504773923,AWP 4A,003,733157,Chandler; Bailee Daniele,12,0,14,2
1731504773923,AWP 4A,004,733158,Chandler; Bailee Daniele,13,0,14,1
1731504773923,AWP 4A,005,733159,Hall; Graham T,14,0,14,0
1731504773923,AWP 4A,006,733160,Hall; Graham T,14,0,14,0
1731504773923,AWP 4A,007,733161,Falcon; Jennifer A,14,0,14,0
1731504773923,AWP 4A,008,733162,Falcon; Jennifer A,13,0,14,1
1731504773923,AWP 4A,011,733165,Tiernan; Christa Michelle,14,0,14,0
1731504773923,AWP 4A,012,733166,Tiernan; Christa Michelle,12,0,14,2
1731504773923,AWP 4A,013,733168,Gardella; Alexander Drew,14,0,14,0
1731504773923,AWP 4A,014,733169,Gardella; Alexander Drew,12,0,14,2
1731504773923,AWP 4A,016,733171,Coulter; Jane Elisabeth,14,0,14,0
1731504773923,AWP 4A,017,733172,Spicer; Jacqueline,14,0,14,0
1731504773923,AWP 4A,018,733173,Spicer; Jacqueline,14,0,14,0
1731504773923,AWP 4A,019,733174,Christie; Veronica Ann,14,0,14,0
1731504773923,AWP 4A,020,733175,Bolin; Jillian,14,0,14,0
1731504773923,AWP 4A,021,733176,Bolin; Jillian,14,0,14,0
1731504773923,AWP 4A,022,733177,Zroka; Amy Liane,14,0,14,0
1731504773923,AWP 4A,023,733178,Zroka; Amy Liane,14,0,14,0
1731504773923,AWP 4A,024,733179,Christie; Veronica Ann,13,0,14,1
1731504773923,AWP 4A,025,733181,Steinberg; Stacy A,14,0,14,0
1731504773923,AWP 4A,026,733182,Steinberg; Stacy A,12,0,14,2
1731504773923,AWP 4A,027,733184,Gilmore; Lauren Monica,14,0,14,0
1731504773923,AWP 4A,028,733185,Gilmore; Lauren Monica,14,0,14,0
1731504773923,AWP 4A,032,733195,Grant; Melinda G,14,0,14,0
1731504773923,AWP 4A,033,733198,Grant; Melinda G,14,0,14,0
1731504773923,AWP 4A,037,733286,Jones; William Jadie,13,0,14,1
1731504773923,AWP 4A,038,733310,Jones; William Jadie,14,0,14,0
1731504773923,AWP 4A,039,733318,Heiser; Jerrod A,14,0,14,0
1731504773923,AWP 4A,040,733320,Heiser; Jerrod A,13,0,14,1
1731504773923,AWP 4A,041,733321,Bourdeau; Joseph Albert,14,0,14,0
1731504773923,AWP 4A,042,733331,Bourdeau; Joseph Albert,14,0,14,0
1731504773923,AWP 4A,043,733337,Wilson; Natalie Ann,13,0,14,1
1731504773923,AWP 4A,044,733378,Wilson; Natalie Ann,12,0,14,2
1731504773923,AWP 4A,045,733379,Staff,14,0,14,0
1731504773923,AWP 4A,046,733380,Staff,14,0,14,0
1731504773923,AWP 4A,047,733385,Staff,14,0,14,0
1731504773923,AWP 4A,048,733386,Staff,14,0,14,0
1731504773923,AWP 4A,049,733388,Staff,0,0,0,0
1731504773923,AWP 4A,050,733389,Staff,0,0,0,0
1731504773923,AWP 4A,051,733390,Staff,0,0,0,0
1731504773923,AWP 4A,052,733392,Staff,0,0,0,0
1731504773923,AWP 4A,053,733394,Staff,0,0,0,0
1731504773923,AWP 4A,054,733395,Staff,0,0,0,0
1731504774954,BENG 1,A01,733659,Sah; Robert Lie-Yuan,62,0,65,3
1731504774954,BENG 1,A02,733715,Sah; Robert Lie-Yuan,60,0,65,5
1731504774954,BENG 1,A03,733716,Sah; Robert Lie-Yuan,63,0,65,2
1731504775987,BENG 112A,A01,733831,Schmid-Schoenbein; Geert W,28,0,35,7
1731504775987,BENG 112A,A02,733832,Schmid-Schoenbein; Geert W,34,0,35,1
1731504777012,BENG 119B,A00,733833,Taylor Amos; Alyssa C,22,0,30,8
1731504778040,BENG 120,A01,733837,Huang; Xiaohua,35,0,35,0
1731504778040,BENG 120,A02,733843,Huang; Xiaohua,33,0,35,2
1731504779072,BENG 123,A01,733846,Palsson; Bernhard O.,24,0,30,6
1731504779072,BENG 123,A02,733847,Palsson; Bernhard O.,24,0,30,6
1731504780100,BENG 126B,A00,733850,Taylor Amos; Alyssa C,26,0,30,4
1731504781128,BENG 127B,A00,733860,Taylor Amos; Alyssa C,30,0,30,0
1731504782158,BENG 128B,A00,733862,Taylor Amos; Alyssa C,30,0,30,0
1731504783185,BENG 129B,A00,733865,Taylor Amos; Alyssa C,30,0,30,0
1731504784214,BENG 130,A00,733907,Subramaniam; Shankar,141,0,145,4
1731504785240,BENG 139B,A00,734022,Taylor Amos; Alyssa C,30,0,30,0
1731504786273,BENG 140A,A01,734136,Silva; Gabriel,27,0,30,3
1731504786273,BENG 140A,A02,734141,Silva; Gabriel,25,0,30,5
1731504786273,BENG 140A,A03,734146,Silva; Gabriel,25,0,30,5
1731504787299,BENG 147B,A00,734149,Taylor Amos; Alyssa C,28,0,30,2
1731504788326,BENG 148B,A00,734154,Taylor Amos; Alyssa C,25,0,30,5
1731504789353,BENG 149B,A00,734172,Taylor Amos; Alyssa C,30,0,30,0
1731504790383,BENG 152,A01,734185,Taylor Amos; Alyssa C,19,0,20,1
1731504791413,BENG 161B,A00,734193,Huang; Xiaohua,55,0,70,15
1731504792446,BENG 168,A01,734228,Shi; Lingyan,22,0,40,18
1731504792446,BENG 168,A02,734229,Shi; Lingyan,39,0,40,1
1731504792446,BENG 168,A03,734231,Shi; Lingyan,37,0,40,3
1731504793474,BENG 169B,A00,734233,Taylor Amos; Alyssa C,24,0,30,6
1731504794498,BENG 179B,A00,734243,Taylor Amos; Alyssa C,28,0,30,2
1731504795529,BENG 181,A01,734246,Pevzner; Pavel Arkadjevich,37,0,40,3
1731504796559,BENG 186B,A01,734248,Cauwenberghs; Gert,69,0,70,1
1731504797585,BENG 187C,A00,734249,Taylor Amos; Alyssa C,121,0,170,49
1731504798614,BENG 189,A00,734250,Contijoch; Francisco,26,0,30,4
1731504799643,BENG 191,A00,734252,Lal; Ratnesh,15,0,20,5
1731504800669,BENG 202,A00,734255,Pevzner; Pavel Arkadjevich,25,0,25,0
1731504801699,BENG 204,A01,734257,Subramaniam; Shankar,0,0,50,50
1731504802730,BENG 207,A00,734258,Friend; James Robert,0,0,0,0
1731504803761,BENG 212,A00,734259,Palsson; Bernhard O.,0,0,20,20
1731504804844,BENG 223,A00,734260,Kravets; Vira V.,0,0,60,60
1731504805872,BENG 225,A01,734263,Bartko; Andrew Peter,0,0,0,0
1731504806904,BENG 230B,A00,734289,Engler; Adam J.,38,0,120,82
1731504807937,BENG 238,A00,734290,Chen; Ju & Sun; Wei & Shyy; Yeun-Jund & Sheikh; Farah & Ross; Robert Scott & King; Kevin R & Evans; Sylvia M & Cho; Yoshitake,0,0,40,40
1731504808964,BENG 241A,A01,734314,Cyphert; Erika Leah,0,0,50,50
1731504809991,BENG 241B,A00,734333,Khojah; Reem I,35,0,70,35
1731504811017,BENG 247B,A00,734334,Wang; Joseph,0,0,40,40
1731504812046,BENG 277,A00,734336,Khojah; Reem I,0,0,0,0
1731504813072,BENG 278,A00,734340,Contijoch; Francisco,0,0,0,0
1731504814157,BENG 280B,A00,734351,El Kaffas; Ahmed,20,0,56,36
1731504815186,BENG 281,A00,734352,Aguado; Brian Alberto,25,0,120,95
1731504816211,BENG 291,A00,734356,Lal; Ratnesh,15,0,30,15
1731504817242,BENG 292,A01,734364,Ross; Camille,20,0,20,0
1731504818267,BENG 294B,A01,734430,Schmid-Schoenbein; Geert W,12,0,20,8
1731504819295,BENG 295,A00,734431,Watson; John Thomas,9999,0,9999,0
1731504820327,BGGN 206B,A00,765115,Oegema; Karen & Desai; Arshad,28,0,60,32
1731504821354,BGGN 207,A01,765121,Ross; Camille,0,0,0,0
1731504822382,BGGN 209,A00,765126,Neal; Sonya E,0,0,30,30
1731504823412,BGGN 213,A00,765129,Grant; Barry J,24,0,30,6
1731504824439,BGGN 216,A01,765138,Mueller; Liam O'Connor,0,0,0,24
1731504825467,BGGN 225,A00,765141,Lu; Li-Fan & Zuniga; Elina I,0,0,30,30
1731504826494,BGGN 228,A00,765144,Perry; Michael William & Kiger; Amy,0,0,30,30
1731504827520,BGGN 237,A01,765148,Goren; Alon M,10,0,10,0
1731504828549,BGGN 240,A01,765160,Benna; Marcus K,4,0,5,1
1731504828549,BGGN 240,A02,765210,Benna; Marcus K,1,0,5,4
1731504828549,BGGN 240,A03,765211,Benna; Marcus K,3,0,5,2
1731504828549,BGGN 240,A04,765212,Benna; Marcus K,2,0,5,3
1731504829577,BGGN 246A,A00,765223,Sejnowski; Terrence J,18,0,30,12
1731504830603,BGGN 249B,A00,765226,Abdel-Azim; Eiman,0,0,0,0
1731504831735,BGGN 271,001,798422,Ackerman; Susan,9999,0,9999,0
1731504831735,BGGN 271,002,798586,Akbari; Omar Sultan,9997,0,9999,2
1731504831735,BGGN 271,003,798588,Allen; Nicola J,9998,0,9999,1
1731504831735,BGGN 271,004,798599,Alperin; Mariann,9998,0,9999,1
1731504831735,BGGN 271,005,798600,Antal; Corina Elena,9998,0,9999,1
1731504831735,BGGN 271,006,798612,Bouvet; Michael,9999,0,9999,0
1731504831735,BGGN 271,007,798613,Breen; Ellen C.,9999,0,9999,0
1731504831735,BGGN 271,008,798637,Bui; Jack D,9998,0,9999,1
1731504831735,BGGN 271,009,798666,Burnett; Lindsey,9998,0,9999,1
1731504831735,BGGN 271,010,798745,Caffrey; Conor,9998,0,9999,1
1731504831735,BGGN 271,011,798780,Castle; Michael James,9998,0,9999,1
1731504831735,BGGN 271,012,798781,Chang; John Tzu-yu,9999,0,9999,0
1731504831735,BGGN 271,013,798782,Chen; Xu,9998,0,9999,1
1731504831735,BGGN 271,014,798783,Cheng; Christine Shiang-Ling,9999,0,9999,0
1731504831735,BGGN 271,015,798784,Cheresh; David A.,9998,0,9999,1
1731504831735,BGGN 271,016,798803,Cherqui; Stephanie,9999,0,9999,0
1731504831735,BGGN 271,017,798804,Chu; Hiutung,9998,0,9999,1
1731504831735,BGGN 271,018,798806,Church; Kellie Breen,9999,0,9999,0
1731504831735,BGGN 271,019,798807,Cleland; Elsa Eleanor,9998,0,9999,1
1731504831735,BGGN 271,020,798808,Coufal; Nicole Gabriele,9999,0,9999,0
1731504831735,BGGN 271,021,798809,Croker; Ben Adam,9999,0,9999,0
1731504831735,BGGN 271,022,798810,Crotty Alexander; Laura E,9997,0,9999,2
1731504831735,BGGN 271,023,798811,De Silva; Shermin,9999,0,9999,0
1731504831735,BGGN 271,024,798812,Dhar; Debanjan,9998,0,9999,1
1731504831735,BGGN 271,025,798813,Doherty; Taylor Alan,9997,0,9999,2
1731504831735,BGGN 271,026,798814,Dore; Kim Bohemie,9997,0,9999,2
1731504831735,BGGN 271,027,798815,Dulawa; Stephanie Carole,9999,0,9999,0
1731504831735,BGGN 271,028,798817,Farley; Emma Kristen,9998,0,9999,1
1731504831735,BGGN 271,029,798818,Feldstein; Ariel E,9999,0,9999,0
1731504831735,BGGN 271,030,798819,Feng; Gen-Sheng,9999,0,9999,0
1731504831735,BGGN 271,031,798820,Fisch; Kathleen Marie,9995,0,9999,4
1731504831735,BGGN 271,032,798822,Friedman; Rick Adam,9999,0,9999,0
1731504831735,BGGN 271,033,798823,Furnari; Frank,9999,0,9999,0
1731504831735,BGGN 271,034,798825,George; Olivier,9998,0,9999,1
1731504831735,BGGN 271,035,798826,Ghosh; Pradipta,9998,0,9999,1
1731504831735,BGGN 271,036,798828,Glasgow; Stacey Marie,9998,0,9999,1
1731504831735,BGGN 271,037,798832,Golden; James W,9998,0,9999,1
1731504831735,BGGN 271,038,798833,Golden; Susan S.,9999,0,9999,0
1731504831735,BGGN 271,039,798834,Goren; Alon M,9998,0,9999,1
1731504831735,BGGN 271,040,798835,Guatelli; John C,9998,0,9999,1
1731504831735,BGGN 271,041,798836,Guma; Monica,9998,0,9999,1
1731504831735,BGGN 271,042,798837,Gustafsson; Asa Birgitta,9999,0,9999,0
1731504831735,BGGN 271,043,798838,Hamdoun; Amr,9999,0,9999,0
1731504831735,BGGN 271,044,798839,Hao; Nan,9999,0,9999,0
1731504831735,BGGN 271,045,798841,Hasty; Jeff M,9999,0,9999,0
1731504831735,BGGN 271,046,798842,Ideker; Trey,9999,0,9999,0
1731504831735,BGGN 271,047,798843,Jiang; Qingfei,9998,0,9999,1
1731504831735,BGGN 271,048,798845,Jin; Yishi,9997,0,9999,2
1731504831735,BGGN 271,049,798846,Joshi; Shweta,9999,0,9999,0
1731504831735,BGGN 271,050,798849,Ju; Won-Kyu,9998,0,9999,1
1731504831735,BGGN 271,051,798850,Jun; Suckjoon,9999,0,9999,0
1731504831735,BGGN 271,052,798852,Kaech; Susan Michelle,9997,0,9999,2
1731504831735,BGGN 271,053,798853,Kauffman; Alexander,9997,0,9999,2
1731504831735,BGGN 271,054,798854,Kleinfeld; David,9998,0,9999,1
1731504831735,BGGN 271,055,798855,Koloski; Miranda Jane,9998,0,9999,1
1731504831735,BGGN 271,056,798856,Komiyama; Takaki,9998,0,9999,1
1731504831735,BGGN 271,057,798858,Kronenberg; Mitchell E.,9999,0,9999,0
1731504831735,BGGN 271,058,798859,Kufareva; Irina,9999,0,9999,0
1731504831735,BGGN 271,059,798860,Lee; Yun Sok,9999,0,9999,0
1731504831735,BGGN 271,060,798861,Leutgeb; Stefan,9999,0,9999,0
1731504831735,BGGN 271,061,798862,Li; Willis Xiaowei,9998,0,9999,1
1731504831735,BGGN 271,062,798864,Lim; Byungkook,9999,0,9999,0
1731504831735,BGGN 271,063,798865,Lo; Stanley M.,9999,0,9999,0
1731504831735,BGGN 271,064,798867,Lopez Ramirez; Miguel Alej,9998,0,9999,1
1731504831735,BGGN 271,065,798868,Lu; Pengzhe,9998,0,9999,1
1731504831735,BGGN 271,066,798869,Lyons; Deirdre Colleen,9998,0,9999,1
1731504831735,BGGN 271,067,798870,Lyumkis; Dmitry Evgenievich,9999,0,9999,0
1731504831735,BGGN 271,068,798871,McConville; Patrick James,9998,0,9999,1
1731504831735,BGGN 271,069,798873,McDonnell; Lisa Marie,9999,0,9999,0
1731504831735,BGGN 271,070,798877,Mertens; Jerome Stefan,9999,0,9999,0
1731504831735,BGGN 271,071,798900,Morris; Gerald P,9999,0,9999,0
1731504831735,BGGN 271,072,798911,Muotri; Alysson,9999,0,9999,0
1731504831735,BGGN 271,073,798916,Muroyama; Andrew David,9998,0,9999,1
1731504831735,BGGN 271,074,798919,Murre; Cornelis,9998,0,9999,1
1731504831735,BGGN 271,075,798920,Nieh; James Charles,9997,0,9999,2
1731504831735,BGGN 271,076,798922,Niwa; Maho,9999,0,9999,0
1731504831735,BGGN 271,077,798925,Parast; Mana,9999,0,9999,0
1731504831735,BGGN 271,078,798927,Perry; Michael William,9999,0,9999,0
1731504831735,BGGN 271,079,798929,Pillus; Lorraine,9998,0,9999,1
1731504831735,BGGN 271,080,798932,Pogliano; Joseph,9999,0,9999,0
1731504831735,BGGN 271,081,798936,Pride; David Tevis,9999,0,9999,0
1731504831735,BGGN 271,082,798939,Pruneda-Paz; Jose L.,9998,0,9999,1
1731504831735,BGGN 271,083,798940,Rana; Tariq,9999,0,9999,0
1731504831735,BGGN 271,084,798945,Rao; Anjana,9999,0,9999,0
1731504831735,BGGN 271,085,798950,Raz; Eyal,9997,0,9999,2
1731504831735,BGGN 271,086,798952,Ren; Bing,9999,0,9999,0
1731504831735,BGGN 271,087,798955,Rifkin; Scott,9998,0,9999,1
1731504831735,BGGN 271,088,798956,Risbrough; Victoria Blythe,9998,0,9999,1
1731504831735,BGGN 271,089,798958,Rose; Noah Hartmann,9999,0,9999,0
1731504831735,BGGN 271,090,798962,Rosenfeld; Michael G,9999,0,9999,0
1731504831735,BGGN 271,091,798964,Saier; Milton H.,9998,0,9999,1
1731504831735,BGGN 271,092,798966,Saltiel; Alan,9997,0,9999,2
1731504831735,BGGN 271,093,798967,Sanchez-Lopez; Elsa,9998,0,9999,1
1731504831735,BGGN 271,094,798969,Schroeder; Julian I,9998,0,9999,1
1731504831735,BGGN 271,095,798970,Sebat; Lilia Mikhailovna,9997,0,9999,2
1731504831735,BGGN 271,096,798972,Sen; George L,9999,0,9999,0
1731504831735,BGGN 271,097,798974,Shaner; Nathan C.,9999,0,9999,0
1731504831735,BGGN 271,098,798976,Shurin; Jonathan,9997,0,9999,2
1731504831735,BGGN 271,099,798982,Sicklick; Jason Keith,9999,0,9999,0
1731504831735,BGGN 271,100,798985,Signer; Robert,9999,0,9999,0
1731504831735,BGGN 271,101,798986,Simonson; Tatum Sasha Summ,9998,0,9999,1
1731504831735,BGGN 271,102,798990,Steinmetz; Nicole F,9999,0,9999,0
1731504831735,BGGN 271,103,798992,Su; Chih-Ying,9999,0,9999,0
1731504831735,BGGN 271,104,798994,Suel; Gurol Mehmet,9999,0,9999,0
1731504831735,BGGN 271,105,799024,Telese; Francesca,9999,0,9999,0
1731504831735,BGGN 271,106,799032,Towers; Christina Garlingt,9997,0,9999,2
1731504831735,BGGN 271,107,799089,Valdez-Jasso; Daniela,9999,0,9999,0
1731504831735,BGGN 271,108,799108,Wahlin; Karl Jonas,9997,0,9999,2
1731504831735,BGGN 271,109,799109,Webster; Nicholas J G,9999,0,9999,0
1731504831735,BGGN 271,110,799127,Welsbie; Derek,9999,0,9999,0
1731504831735,BGGN 271,111,799128,Wildonger; Jill Cathleen,9997,0,9999,2
1731504831735,BGGN 271,112,799129,Yaksh; Tony L.,9999,0,9999,0
1731504831735,BGGN 271,113,799150,Yeo; Eugene Wei-Ming,9998,0,9999,1
1731504831735,BGGN 271,114,799151,Ying; Wei,9997,0,9999,2
1731504831735,BGGN 271,115,799152,Young; Jared W.,9999,0,9999,0
1731504831735,BGGN 271,116,799153,Zage; Peter,9999,0,9999,0
1731504831735,BGGN 271,117,799154,Zengler; Karsten B,9998,0,9999,1
1731504831735,BGGN 271,118,799155,Zhang; Jin,9999,0,9999,0
1731504831735,BGGN 271,119,799156,Zhao; Yunde,9999,0,9999,0
1731504831735,BGGN 271,120,799157,Zheng; Ye,9998,0,9999,1
1731504831735,BGGN 271,121,799158,Zhou; Huilin,9999,0,9999,0
1731504831735,BGGN 271,122,799159,Zou; Yimin,9998,0,9999,1
1731504832766,BGGN 275,A00,765242,Flagg; Matthew Paul,0,0,0,12
1731504833794,BGGN 276,A00,765243,Flagg; Matthew Paul,0,0,0,12
1731504834828,BGGN 290,A00,765245,Pasquinelli; Amy & Hampton; Randolph Y.,0,0,0,8
1731504835861,BGGN 293,A00,765250,Tour; Ella,0,0,30,30
1731504835861,BGGN 293,B00,765260,Petrie; Katherine Lynn,0,0,0,12
1731504836888,BGJC 204,A00,765301,Lu; Li-Fan & Chang; John Tzu-yu,9982,0,9999,17
1731504838089,BGRD 200,001,799275,Ackerman; Susan,9999,0,9999,0
1731504838089,BGRD 200,002,799276,Akbari; Omar Sultan,9997,0,9999,2
1731504838089,BGRD 200,003,799277,Allen; Eric,9999,0,9999,0
1731504838089,BGRD 200,004,799278,Allen; Nicola J,9998,0,9999,1
1731504838089,BGRD 200,005,799279,Alperin; Mariann,9998,0,9999,1
1731504838089,BGRD 200,006,799280,Amaro; Rommie E,9999,0,9999,0
1731504838089,BGRD 200,007,799281,Antal; Corina Elena,9998,0,9999,1
1731504838089,BGRD 200,008,799282,Asahina; Kenta,9999,0,9999,0
1731504838089,BGRD 200,009,799283,Augustine; Vineet,9999,0,9999,0
1731504838089,BGRD 200,010,799284,Ayres; Janelle Samantha,9998,0,9999,1
1731504838089,BGRD 200,011,799285,Banghart; Matthew Ryan,9999,0,9999,0
1731504838089,BGRD 200,012,799286,Barton; Andrew David,9999,0,9999,0
1731504838089,BGRD 200,013,799287,Benna; Marcus K,9999,0,9999,0
1731504838089,BGRD 200,014,799288,Bennett; Eric J,9999,0,9999,0
1731504838089,BGRD 200,015,799289,Biering; Scott B,9999,0,9999,0
1731504838089,BGRD 200,016,799290,Bloodgood; Brenda Laurie,9999,0,9999,0
1731504838089,BGRD 200,017,799291,Bouvet; Michael,9999,0,9999,0
1731504838089,BGRD 200,018,799292,Breen; Ellen C.,9999,0,9999,0
1731504838089,BGRD 200,019,799293,Briggs; Steven,9999,0,9999,0
1731504838089,BGRD 200,020,799294,Bui; Jack D,9998,0,9999,1
1731504838089,BGRD 200,021,799295,Burnett; Lindsey,9998,0,9999,1
1731504838089,BGRD 200,022,799296,Caffrey; Conor,9998,0,9999,1
1731504838089,BGRD 200,023,799297,Callaway; Edward M,9999,0,9999,0
1731504838089,BGRD 200,024,799298,Castle; Michael James,9999,0,9999,0
1731504838089,BGRD 200,025,799299,Chaim; Isaac,9999,0,9999,0
1731504838089,BGRD 200,026,799300,Chang; John Tzu-yu,9998,0,9999,1
1731504838089,BGRD 200,027,799301,Chen; Xu,9999,0,9999,0
1731504838089,BGRD 200,028,799302,Cheng; Christine Shiang-Ling,9999,0,9999,0
1731504838089,BGRD 200,029,799303,Cheresh; David A.,9998,0,9999,1
1731504838089,BGRD 200,030,799304,Cherqui; Stephanie,9999,0,9999,0
1731504838089,BGRD 200,031,799305,Chu; Hiutung,9998,0,9999,1
1731504838089,BGRD 200,032,799306,Church; Kellie Breen,9999,0,9999,0
1731504838089,BGRD 200,033,799307,Cleland; Elsa Eleanor,9997,0,9999,2
1731504838089,BGRD 200,034,799308,Cooper; Kimberly Lynn,9999,0,9999,0
1731504838089,BGRD 200,035,799309,Coufal; Nicole Gabriele,9999,0,9999,0
1731504838089,BGRD 200,036,799310,Croker; Ben Adam,9999,0,9999,0
1731504838089,BGRD 200,037,799311,Crotty Alexander; Laura E,9997,0,9999,2
1731504838089,BGRD 200,038,799313,Daugherty; Matthew Dorton,9998,0,9999,1
1731504838089,BGRD 200,039,799314,De Silva; Shermin,9999,0,9999,0
1731504838089,BGRD 200,040,799315,Desai; Arshad,9999,0,9999,0
1731504838089,BGRD 200,041,799316,Dhar; Debanjan,9998,0,9999,1
1731504838089,BGRD 200,042,799317,Dickinson; Alexandra Jazz,9999,0,9999,0
1731504838089,BGRD 200,043,799318,Dixon; Jesse,9998,0,9999,1
1731504838089,BGRD 200,044,799319,Doherty; Taylor Alan,9997,0,9999,2
1731504838089,BGRD 200,045,799320,Dore; Kim Bohemie,9997,0,9999,2
1731504838089,BGRD 200,046,799321,Dulawa; Stephanie Carole,9999,0,9999,0
1731504838089,BGRD 200,047,799323,Ecker; Joseph R,9998,0,9999,1
1731504838089,BGRD 200,048,799324,Engle; Dannielle D,9999,0,9999,0
1731504838089,BGRD 200,049,799325,Ernst; Andreas,9998,0,9999,1
1731504838089,BGRD 200,050,799326,Esko; Jeffrey D.,9999,0,9999,0
1731504838089,BGRD 200,051,799327,Farley; Emma Kristen,9998,0,9999,1
1731504838089,BGRD 200,052,799328,Feldstein; Ariel E,9999,0,9999,0
1731504838089,BGRD 200,053,799329,Feng; Gen-Sheng,9999,0,9999,0
1731504838089,BGRD 200,054,799330,Fisch; Kathleen Marie,9995,0,9999,4
1731504838089,BGRD 200,055,799331,Friedman; Rick Adam,9999,0,9999,0
1731504838089,BGRD 200,056,799332,Furnari; Frank,9999,0,9999,0
1731504838089,BGRD 200,057,799333,Gage; Fred H,9999,0,9999,0
1731504838089,BGRD 200,058,799334,George; Olivier,9998,0,9999,1
1731504838089,BGRD 200,059,799335,Ghosh; Pradipta,9998,0,9999,1
1731504838089,BGRD 200,060,799336,Glasgow; Stacey Marie,9998,0,9999,1
1731504838089,BGRD 200,061,799337,Glass; Christopher,9999,0,9999,0
1731504838089,BGRD 200,062,799338,Golden; James W,9998,0,9999,1
1731504838089,BGRD 200,063,799339,Golden; Susan S.,9999,0,9999,0
1731504838089,BGRD 200,064,799340,Goren; Alon M,9998,0,9999,1
1731504838089,BGRD 200,065,799341,Guatelli; John C,9998,0,9999,1
1731504838089,BGRD 200,066,799342,Guma; Monica,9998,0,9999,1
1731504838089,BGRD 200,067,799343,Gustafsson; Asa Birgitta,9999,0,9999,0
1731504838089,BGRD 200,068,799344,Gutkind; Jorge Silvio,9999,0,9999,0
1731504838089,BGRD 200,069,799345,Hamdoun; Amr,9999,0,9999,0
1731504838089,BGRD 200,070,799346,Hampton; Randolph Y.,9998,0,9999,1
1731504838089,BGRD 200,071,799347,Hao; Nan,9999,0,9999,0
1731504838089,BGRD 200,072,799348,Hargreaves; Diana Clare,9998,0,9999,1
1731504838089,BGRD 200,073,799349,Hasty; Jeff M,9999,0,9999,0
1731504838089,BGRD 200,074,799350,Hollern; Daniel Patrick,9998,0,9999,1
1731504838089,BGRD 200,075,799351,Holway; David A.,9999,0,9999,0
1731504838089,BGRD 200,076,799352,Huffaker; Alisa,9998,0,9999,1
1731504838089,BGRD 200,077,799353,Hui; Enfu,9999,0,9999,0
1731504838089,BGRD 200,078,799354,Hwa; Terence T.,9999,0,9999,0
1731504838089,BGRD 200,079,799355,Ideker; Trey,9999,0,9999,0
1731504838089,BGRD 200,080,799356,Jackrel; Sara,9997,0,9999,2
1731504838089,BGRD 200,081,799357,Jiang; Qingfei,9998,0,9999,1
1731504838089,BGRD 200,082,799358,Jin; Yishi,9997,0,9999,2
1731504838089,BGRD 200,083,799359,Joshi; Shweta,9999,0,9999,0
1731504838089,BGRD 200,084,799360,Ju; Won-Kyu,9998,0,9999,1
1731504838089,BGRD 200,085,799361,Jun; Suckjoon,9999,0,9999,0
1731504838089,BGRD 200,086,799362,Kadonaga; James T,9999,0,9999,0
1731504838089,BGRD 200,087,799363,Kaech; Susan Michelle,9995,0,9999,4
1731504838089,BGRD 200,088,799364,Kauffman; Alexander,9997,0,9999,2
1731504838089,BGRD 200,089,799365,Kleinfeld; David,9999,0,9999,0
1731504838089,BGRD 200,090,799366,Knight; Robin,9999,0,9999,0
1731504838089,BGRD 200,091,799367,Koloski; Miranda Jane,9998,0,9999,1
1731504838089,BGRD 200,092,799368,Komiyama; Takaki,9997,0,9999,2
1731504838089,BGRD 200,093,799369,Kosuri; Pallav,9998,0,9999,1
1731504838089,BGRD 200,094,799370,Kronenberg; Mitchell E.,9999,0,9999,0
1731504838089,BGRD 200,095,799371,Staff,9999,0,9999,0
1731504838089,BGRD 200,096,799372,Kryazhimskiy; Sergey A,9999,0,9999,0
1731504838089,BGRD 200,097,799373,Kufareva; Irina,9999,0,9999,0
1731504838089,BGRD 200,098,799374,Lee; Kuo Fen,9999,0,9999,0
1731504838089,BGRD 200,099,799375,Lee; Yun Sok,9999,0,9999,0
1731504838089,BGRD 200,100,799376,Leutgeb; Jill K.,9999,0,9999,0
1731504838089,BGRD 200,101,799377,Leutgeb; Stefan,9999,0,9999,0
1731504838089,BGRD 200,102,799378,Li; Willis Xiaowei,9998,0,9999,1
1731504838089,BGRD 200,103,799379,Lim; Byungkook,9998,0,9999,1
1731504838089,BGRD 200,104,799380,Lo; Stanley M.,9999,0,9999,0
1731504838089,BGRD 200,105,799381,Looger; Loren Lee,9998,0,9999,1
1731504838089,BGRD 200,106,799382,Lopez Ramirez; Miguel Alej,9998,0,9999,1
1731504838089,BGRD 200,107,799383,Lovett-Barron; Matthew Rod,9997,0,9999,2
1731504838089,BGRD 200,108,799384,Lu; Li-Fan,9998,0,9999,1
1731504838089,BGRD 200,109,799385,Lu; Pengzhe,9998,0,9999,1
1731504838089,BGRD 200,110,799386,Lykke-Andersen; Jens,9998,0,9999,1
1731504838089,BGRD 200,111,799387,Lyons; Deirdre Colleen,9998,0,9999,1
1731504838089,BGRD 200,112,799388,Lyumkis; Dmitry Evgenievich,9998,0,9999,1
1731504838089,BGRD 200,113,799389,Manor; Uri,9999,0,9999,0
1731504838089,BGRD 200,114,799390,Mayfield; Stephen P.,9998,0,9999,1
1731504838089,BGRD 200,115,799391,McConville; Patrick James,9999,0,9999,0
1731504838089,BGRD 200,116,799392,McDonnell; Lisa Marie,9999,0,9999,0
1731504838089,BGRD 200,117,799393,Mertens; Jerome Stefan,9999,0,9999,0
1731504838089,BGRD 200,118,799394,Meyer; Justin Raymond,9999,0,9999,0
1731504838089,BGRD 200,119,799395,Morris; Gerald P,9999,0,9999,0
1731504838089,BGRD 200,120,799396,Mueller; Lena,9998,0,9999,1
1731504838089,BGRD 200,121,799397,Muotri; Alysson,9999,0,9999,0
1731504838089,BGRD 200,122,799398,Muroyama; Andrew David,9995,0,9999,4
1731504838089,BGRD 200,123,799399,Murre; Cornelis,9998,0,9999,1
1731504838089,BGRD 200,124,799400,Reyes De Barboza; Nabora S,9999,0,9999,0
1731504838089,BGRD 200,125,799401,Neal; Sonya E,9998,0,9999,1
1731504838089,BGRD 200,126,799402,Nieh; James Charles,9997,0,9999,2
1731504838089,BGRD 200,127,799403,Nimmerjahn; Axel,9999,0,9999,0
1731504838089,BGRD 200,128,799404,Niwa; Maho,9999,0,9999,0
1731504838089,BGRD 200,129,799405,Nizet; Victor F.,9999,0,9999,0
1731504838089,BGRD 200,130,799406,Oegema; Karen,9999,0,9999,0
1731504838089,BGRD 200,131,799407,Panda; Satchidananda,9998,0,9999,1
1731504838089,BGRD 200,132,799408,Parast; Mana,9999,0,9999,0
1731504838089,BGRD 200,133,799409,Pasquinelli; Amy,9998,0,9999,1
1731504838089,BGRD 200,134,799410,Pekkurnaz Banghart; Gulcin,9999,0,9999,0
1731504838089,BGRD 200,135,799411,Perry; Michael William,9999,0,9999,0
1731504838089,BGRD 200,136,799413,Pillus; Lorraine,9998,0,9999,1
1731504838089,BGRD 200,137,799414,Pogliano; Joseph,9999,0,9999,0
1731504838089,BGRD 200,138,799415,Pogliano; Kit J.,9999,0,9999,0
1731504838089,BGRD 200,139,799416,Pride; David Tevis,9999,0,9999,0
1731504838089,BGRD 200,140,799417,Pruneda-Paz; Jose L.,9998,0,9999,1
1731504838089,BGRD 200,141,799418,Ramanan; Deepshika,9998,0,9999,1
1731504838089,BGRD 200,142,799419,Rana; Tariq,9998,0,9999,1
1731504838089,BGRD 200,143,799420,Rao; Anjana,9999,0,9999,0
1731504838089,BGRD 200,144,799421,Raz; Eyal,9997,0,9999,2
1731504838089,BGRD 200,145,799422,Reck-Peterson; Samara L,9999,0,9999,0
1731504838089,BGRD 200,146,799423,Ren; Bing,9999,0,9999,0
1731504838089,BGRD 200,147,799424,Rennison; Diana,9998,0,9999,1
1731504838089,BGRD 200,148,799425,Rifkin; Scott,9999,0,9999,0
1731504838089,BGRD 200,149,799426,Risbrough; Victoria Blythe,9998,0,9999,1
1731504838089,BGRD 200,150,799427,Rivera; Fabian Chavez,9997,0,9999,2
1731504838089,BGRD 200,151,799428,Rohner; Patrick Thomas,9999,0,9999,0
1731504838089,BGRD 200,152,799429,Rose; Noah Hartmann,9999,0,9999,0
1731504838089,BGRD 200,153,799430,Rosenfeld; Michael G,9999,0,9999,0
1731504838089,BGRD 200,154,799431,Russell; Alistair B,9999,0,9999,0
1731504838089,BGRD 200,155,799432,Saier; Milton H.,9998,0,9999,1
1731504838089,BGRD 200,156,799433,Saltiel; Alan,9997,0,9999,2
1731504838089,BGRD 200,157,799434,Sanchez-Lopez; Elsa,9999,0,9999,0
1731504838089,BGRD 200,158,799435,Saphire; Erica Ollmann,9999,0,9999,0
1731504838089,BGRD 200,159,799436,Schroeder; Julian I,9997,0,9999,2
1731504838089,BGRD 200,160,799437,Sebat; Lilia Mikhailovna,9997,0,9999,2
1731504838089,BGRD 200,161,799438,Sen; George L,9999,0,9999,0
1731504838089,BGRD 200,162,799439,Shah; Sameer B,9999,0,9999,0
1731504838089,BGRD 200,163,799440,Shaner; Nathan C.,9999,0,9999,0
1731504838089,BGRD 200,164,799441,Sharpee; Tatyana,9999,0,9999,0
1731504838089,BGRD 200,165,799442,Shaw; Reuben,9999,0,9999,0
1731504838089,BGRD 200,166,799443,Shurin; Jonathan,9997,0,9999,2
1731504838089,BGRD 200,167,799444,Sicklick; Jason Keith,9999,0,9999,0
1731504838089,BGRD 200,168,799445,Signer; Robert,9999,0,9999,0
1731504838089,BGRD 200,169,799446,Simonson; Tatum Sasha Summ,9998,0,9999,1
1731504838089,BGRD 200,170,799447,Soncin; Francesca,9999,0,9999,0
1731504838089,BGRD 200,171,799448,Steinmetz; Nicole F,9999,0,9999,0
1731504838089,BGRD 200,172,799449,Su; Chih-Ying,9998,0,9999,1
1731504838089,BGRD 200,173,799450,Suel; Gurol Mehmet,9997,0,9999,2
1731504838089,BGRD 200,174,799451,Sun; Xin,9998,0,9999,1
1731504838089,BGRD 200,175,799452,Telese; Francesca,9998,0,9999,1
1731504838089,BGRD 200,176,799453,Towers; Christina Garlingt,9995,0,9999,4
1731504838089,BGRD 200,177,799454,Traver; David,9999,0,9999,0
1731504838089,BGRD 200,178,799455,Troemel; Emily Ruth,9998,0,9999,1
1731504838089,BGRD 200,179,799456,Valdez-Jasso; Daniela,9999,0,9999,0
1731504838089,BGRD 200,180,799457,Vijayanand; Pandurangan,9999,0,9999,0
1731504838089,BGRD 200,181,799458,Villa Rodriguez; Elizabeth,9999,0,9999,0
1731504838089,BGRD 200,182,799459,Wahlin; Karl Jonas,9997,0,9999,2
1731504838089,BGRD 200,183,799460,Wang; Jean Yin Jen,9999,0,9999,0
1731504838089,BGRD 200,184,799461,Webster; Nicholas J G,9999,0,9999,0
1731504838089,BGRD 200,185,799462,Welsbie; Derek,9999,0,9999,0
1731504838089,BGRD 200,186,799463,Wildonger; Jill Cathleen,9996,0,9999,3
1731504838089,BGRD 200,187,799464,Winzeler; Elizabeth A,9999,0,9999,0
1731504838089,BGRD 200,188,799465,Yaksh; Tony L.,9999,0,9999,0
1731504838089,BGRD 200,189,799466,Yelon; Deborah,9997,0,9999,2
1731504838089,BGRD 200,190,799467,Yeo; Eugene Wei-Ming,9998,0,9999,1
1731504838089,BGRD 200,191,799468,Ying; Wei,9997,0,9999,2
1731504838089,BGRD 200,192,799469,Young; Jared W.,9999,0,9999,0
1731504838089,BGRD 200,193,799470,Zage; Peter,9999,0,9999,0
1731504838089,BGRD 200,194,799471,Zengler; Karsten B,9997,0,9999,2
1731504838089,BGRD 200,195,799472,Zhang; Dong-Er,9999,0,9999,0
1731504838089,BGRD 200,196,799473,Zhang; Jin,9999,0,9999,0
1731504838089,BGRD 200,197,799474,Zhao; Yunde,9999,0,9999,0
1731504838089,BGRD 200,198,799475,Zheng; Binhai,9999,0,9999,0
1731504838089,BGRD 200,199,799476,Zheng; Ye,9998,0,9999,1
1731504838089,BGRD 200,200,799477,Zhou; Huilin,9999,0,9999,0
1731504838089,BGRD 200,201,799478,Zou; Yimin,9998,0,9999,1
1731504838089,BGRD 200,202,799479,Zuniga; Elina I,9998,0,9999,1
1731504839117,BGSE 200,A00,765304,Tour; Ella & Petrie; Katherine Lynn,9987,0,9999,12
1731504840145,BGSE 205,A00,765321,Bennett; Eric J,43,0,50,7
1731504840145,BGSE 205,B00,765322,Bennett; Eric J,46,0,50,4
1731504840145,BGSE 205,C00,765369,Bennett; Eric J,36,0,50,14
1731504840145,BGSE 205,D00,765470,Bennett; Eric J,40,0,50,10
1731504840145,BGSE 205,E00,765471,Bennett; Eric J,45,0,50,5
1731504841180,BIBC 100,A01,786720,Hui; Enfu,70,0,73,3
1731504841180,BIBC 100,A02,786721,Hui; Enfu,64,0,73,9
1731504841180,BIBC 100,A03,786723,Hui; Enfu,67,0,73,6
1731504841180,BIBC 100,A04,786775,Hui; Enfu,67,0,73,6
1731504842208,BIBC 102,A01,786782,Feng; Gen-Sheng,72,0,73,1
1731504842208,BIBC 102,A02,786783,Feng; Gen-Sheng,71,0,73,2
1731504842208,BIBC 102,A03,786784,Feng; Gen-Sheng,73,0,73,0
1731504842208,BIBC 102,A04,786790,Feng; Gen-Sheng,73,0,73,0
1731504842208,BIBC 102,B01,786791,Dickinson; Alexandra Jazz,61,0,73,12
1731504842208,BIBC 102,B02,786792,Dickinson; Alexandra Jazz,64,0,73,9
1731504842208,BIBC 102,B03,786845,Dickinson; Alexandra Jazz,68,0,73,5
1731504842208,BIBC 102,B04,786859,Dickinson; Alexandra Jazz,50,0,73,23
1731504843237,BIBC 103,A01,757720,Coleman; Aaron B.,21,0,24,3
1731504843237,BIBC 103,A02,757773,Coleman; Aaron B.,22,0,24,2
1731504843237,BIBC 103,B01,757783,Coleman; Aaron B.,18,0,24,6
1731504843237,BIBC 103,B02,757784,Coleman; Aaron B.,21,0,24,3
1731504843237,BIBC 103,C01,758001,Burg; Michael,17,0,24,7
1731504843237,BIBC 103,C02,758019,Burg; Michael,24,0,24,0
1731504844264,BIBC 120,A01,758029,Hampton; Randolph Y.,61,0,87,26
1731504844264,BIBC 120,A02,758032,Hampton; Randolph Y.,65,0,87,22
1731504844264,BIBC 120,A03,758038,Hampton; Randolph Y.,77,0,87,10
1731504844264,BIBC 120,A04,758119,Hampton; Randolph Y.,74,0,87,13
1731504845290,BIBC 194,A00,758136,Hui; Enfu,25,0,32,7
1731504845290,BIBC 194,B00,758137,Niwa; Maho,25,0,32,7
1731504845290,BIBC 194,C00,758138,Corbett; Kevin Daniel,25,0,32,7
1731504846320,BICD 100,A01,786869,Troemel; Emily Ruth,72,0,73,1
1731504846320,BICD 100,A02,786870,Troemel; Emily Ruth,73,0,73,0
1731504846320,BICD 100,A03,786871,Troemel; Emily Ruth,73,0,73,0
1731504846320,BICD 100,A04,786872,Troemel; Emily Ruth,73,0,73,0
1731504846320,BICD 100,B01,786873,Grossman; Emily N,66,0,73,7
1731504846320,BICD 100,B02,786874,Grossman; Emily N,66,0,73,7
1731504846320,BICD 100,B03,786875,Grossman; Emily N,71,0,73,2
1731504846320,BICD 100,B04,786876,Grossman; Emily N,70,0,73,3
1731504846320,BICD 100,C01,786877,Grossman; Emily N,64,0,73,9
1731504846320,BICD 100,C02,786878,Grossman; Emily N,71,0,73,2
1731504846320,BICD 100,C03,786879,Grossman; Emily N,70,0,73,3
1731504846320,BICD 100,C04,786880,Grossman; Emily N,71,0,73,2
1731504847348,BICD 110,A01,758191,Chaim; Isaac,54,0,63,9
1731504847348,BICD 110,A02,758193,Chaim; Isaac,42,0,63,21
1731504847348,BICD 110,A03,758194,Chaim; Isaac,61,0,63,2
1731504847348,BICD 110,A04,758196,Chaim; Isaac,56,0,61,5
1731504847348,BICD 110,B01,758200,Manor; Uri,60,0,63,3
1731504847348,BICD 110,B02,758201,Manor; Uri,63,0,63,0
1731504847348,BICD 110,B03,758202,Manor; Uri,55,0,63,8
1731504847348,BICD 110,B04,758204,Manor; Uri,56,0,61,5
1731504848378,BICD 120,A01,758206,Estelle; Mark,20,0,23,3
1731504848378,BICD 120,A02,758208,Estelle; Mark,22,0,23,1
1731504848378,BICD 120,A03,758209,Estelle; Mark,23,0,23,0
1731504848378,BICD 120,A04,758214,Estelle; Mark,17,0,21,4
1731504849405,BICD 194,A00,758215,Hueschen; Christina Lynn,29,0,32,3
1731504850437,BIEB 102,A01,758218,Jackrel; Sara,46,0,48,2
1731504850437,BIEB 102,A02,758219,Jackrel; Sara,47,0,48,1
1731504850437,BIEB 102,A03,758220,Jackrel; Sara,48,0,48,0
1731504850437,BIEB 102,A04,758222,Jackrel; Sara,48,0,48,0
1731504851469,BIEB 121,A00,758224,Butler; Shannon Rhey,8,0,32,24
1731504851469,BIEB 121,B00,758225,Butler; Shannon Rhey,20,0,32,12
1731504852497,BIEB 134,A01,758227,Barton; Andrew David,10,0,11,1
1731504852497,BIEB 134,A02,758230,Barton; Andrew David,11,0,11,0
1731504852497,BIEB 134,A03,758231,Barton; Andrew David,9,0,11,2
1731504852497,BIEB 134,A04,758232,Barton; Andrew David,11,0,11,0
1731504852497,BIEB 134,A05,758233,Barton; Andrew David,7,0,11,4
1731504852497,BIEB 134,A06,758236,Barton; Andrew David,9,0,10,1
1731504852497,BIEB 134,A07,758237,Barton; Andrew David,10,0,10,0
1731504852497,BIEB 134,A08,758239,Barton; Andrew David,10,0,10,0
1731504853527,BIEB 135,A01,758241,Shurin; Jonathan,20,0,36,16
1731504854560,BIEB 140,A01,758243,Roy; Kaustuv,35,0,40,5
1731504854560,BIEB 140,A02,758248,Roy; Kaustuv,36,0,40,4
1731504854560,BIEB 140,A03,758250,Roy; Kaustuv,35,0,40,5
1731504854560,BIEB 140,A04,758251,Roy; Kaustuv,32,0,40,8
1731504855593,BIEB 152,A01,758255,Wodarz; Dominik Franz Xave,57,0,63,6
1731504855593,BIEB 152,A02,758256,Wodarz; Dominik Franz Xave,62,0,63,1
1731504855593,BIEB 152,A03,758257,Wodarz; Dominik Franz Xave,54,0,63,9
1731504855593,BIEB 152,A04,758260,Wodarz; Dominik Franz Xave,50,0,61,11
1731504856621,BIEB 156,A01,758262,Rose; Noah Hartmann & Rennison; Diana,26,0,29,3
1731504856621,BIEB 156,A02,758267,Rose; Noah Hartmann & Rennison; Diana,26,0,29,3
1731504856621,BIEB 156,A03,758269,Rose; Noah Hartmann & Rennison; Diana,29,0,29,0
1731504856621,BIEB 156,A04,758272,Rose; Noah Hartmann & Rennison; Diana,28,0,28,0
1731504857662,BILD 1,A01,786580,Ochoa Mikrut; Stacy Daniel,93,0,100,7
1731504857662,BILD 1,A02,786585,Ochoa Mikrut; Stacy Daniel,100,0,100,0
1731504857662,BILD 1,A03,786589,Ochoa Mikrut; Stacy Daniel,98,0,100,2
1731504857662,BILD 1,A04,786591,Ochoa Mikrut; Stacy Daniel,96,0,100,4
1731504857662,BILD 1,B01,786593,Madigan; Cressida Ariana,85,0,100,15
1731504857662,BILD 1,B02,786612,Madigan; Cressida Ariana,73,0,100,27
1731504857662,BILD 1,B03,786613,Madigan; Cressida Ariana,93,0,100,7
1731504857662,BILD 1,B04,786614,Madigan; Cressida Ariana,97,0,100,3
1731504857662,BILD 1,C01,786630,Cooper; Andrew Michael,97,0,100,3
1731504857662,BILD 1,C02,786631,Cooper; Andrew Michael,99,0,100,1
1731504857662,BILD 1,C03,786669,Cooper; Andrew Michael,100,0,100,0
1731504857662,BILD 1,C04,786704,Cooper; Andrew Michael,99,0,100,1
1731504858703,BILD 2,A01,786707,Owens; Melinda Tsao-Ying,64,0,65,1
1731504858703,BILD 2,A02,786708,Owens; Melinda Tsao-Ying,58,0,60,2
1731504858703,BILD 2,A03,786709,Owens; Melinda Tsao-Ying,57,0,60,3
1731504858703,BILD 2,A04,786710,Owens; Melinda Tsao-Ying,60,0,60,0
1731504858703,BILD 2,B01,786920,Owens; Melinda Tsao-Ying,59,0,60,1
1731504858703,BILD 2,B02,786975,Owens; Melinda Tsao-Ying,60,0,60,0
1731504858703,BILD 2,B03,786976,Owens; Melinda Tsao-Ying,64,0,65,1
1731504858703,BILD 2,B04,786979,Owens; Melinda Tsao-Ying,64,0,65,1
1731504858703,BILD 2,C01,786980,Su; Chih-Ying,61,0,63,2
1731504858703,BILD 2,C02,786981,Su; Chih-Ying,58,0,63,5
1731504858703,BILD 2,C03,786983,Su; Chih-Ying,60,0,63,3
1731504858703,BILD 2,C04,786985,Su; Chih-Ying,61,0,61,0
1731504859733,BILD 3,A01,786711,Hammond; LaTisha Marie,49,0,60,11
1731504859733,BILD 3,A02,786712,Hammond; LaTisha Marie,44,0,60,16
1731504859733,BILD 3,A03,786713,Hammond; LaTisha Marie,59,0,60,1
1731504859733,BILD 3,A04,786714,Hammond; LaTisha Marie,54,0,60,6
1731504859733,BILD 3,B01,786715,Hammond; LaTisha Marie,58,0,60,2
1731504859733,BILD 3,B02,786716,Hammond; LaTisha Marie,60,0,60,0
1731504859733,BILD 3,B03,786717,Hammond; LaTisha Marie,55,0,60,5
1731504859733,BILD 3,B04,786719,Hammond; LaTisha Marie,59,0,60,1
1731504859733,BILD 3,D01,786997,Pirino; Giorgia,58,0,60,2
1731504859733,BILD 3,D02,786998,Pirino; Giorgia,58,0,60,2
1731504859733,BILD 3,D03,786999,Pirino; Giorgia,58,0,60,2
1731504859733,BILD 3,D04,787001,Pirino; Giorgia,60,0,60,0
1731504860775,BILD 4,A01,757384,Gonzalez Gamboa; Ivonne,20,0,24,4
1731504860775,BILD 4,A02,757387,Gonzalez Gamboa; Ivonne,22,0,24,2
1731504860775,BILD 4,A03,757388,Gonzalez Gamboa; Ivonne,24,0,24,0
1731504860775,BILD 4,A04,757396,Gonzalez Gamboa; Ivonne,24,0,24,0
1731504860775,BILD 4,A05,757397,Gonzalez Gamboa; Ivonne,22,0,24,2
1731504860775,BILD 4,A06,757399,Gonzalez Gamboa; Ivonne,24,0,24,0
1731504860775,BILD 4,A07,757403,Gonzalez Gamboa; Ivonne,23,0,24,1
1731504860775,BILD 4,A08,757404,Gonzalez Gamboa; Ivonne,22,0,24,2
1731504860775,BILD 4,B01,757410,Gonzalez Gamboa; Ivonne,15,0,24,9
1731504860775,BILD 4,B02,757413,Gonzalez Gamboa; Ivonne,21,0,24,3
1731504860775,BILD 4,B03,757416,Gonzalez Gamboa; Ivonne,23,0,24,1
1731504860775,BILD 4,B04,757417,Gonzalez Gamboa; Ivonne,23,0,24,1
1731504860775,BILD 4,B05,757419,Gonzalez Gamboa; Ivonne,23,0,24,1
1731504860775,BILD 4,B06,757421,Gonzalez Gamboa; Ivonne,23,0,24,1
1731504860775,BILD 4,B07,757423,Gonzalez Gamboa; Ivonne,23,0,24,1
1731504860775,BILD 4,B08,757434,Gonzalez Gamboa; Ivonne,23,0,24,1
1731504860775,BILD 4,C01,757437,Ochoa Mikrut; Stacy Daniel,22,0,24,2
1731504860775,BILD 4,C02,757439,Ochoa Mikrut; Stacy Daniel,23,0,24,1
1731504860775,BILD 4,C03,757440,Ochoa Mikrut; Stacy Daniel,24,0,24,0
1731504860775,BILD 4,C04,757495,Ochoa Mikrut; Stacy Daniel,23,0,24,1
1731504860775,BILD 4,C05,757496,Ochoa Mikrut; Stacy Daniel,24,0,24,0
1731504860775,BILD 4,C06,757497,Ochoa Mikrut; Stacy Daniel,24,0,24,0
1731504860775,BILD 4,C07,757498,Ochoa Mikrut; Stacy Daniel,24,0,24,0
1731504860775,BILD 4,C08,757499,Ochoa Mikrut; Stacy Daniel,24,0,24,0
1731504860775,BILD 4,D01,757501,Lo; Stanley M.,14,0,24,10
1731504860775,BILD 4,D02,757502,Lo; Stanley M.,22,0,24,2
1731504860775,BILD 4,D03,757503,Lo; Stanley M.,24,0,24,0
1731504860775,BILD 4,D04,757504,Lo; Stanley M.,22,0,24,2
1731504860775,BILD 4,D05,757505,Lo; Stanley M.,22,0,24,2
1731504860775,BILD 4,D06,757506,Lo; Stanley M.,22,0,24,2
1731504860775,BILD 4,D07,757507,Lo; Stanley M.,24,0,24,0
1731504860775,BILD 4,D08,757508,Lo; Stanley M.,22,0,24,2
1731504861805,BILD 5,A01,786885,Mueller; Liam O'Connor,60,0,65,5
1731504861805,BILD 5,A02,786886,Mueller; Liam O'Connor,58,0,65,7
1731504861805,BILD 5,A03,786887,Mueller; Liam O'Connor,64,0,65,1
1731504861805,BILD 5,A04,786888,Mueller; Liam O'Connor,64,0,65,1
1731504861805,BILD 5,B01,786889,Reuther; Keefe,65,0,65,0
1731504861805,BILD 5,B02,786890,Reuther; Keefe,60,0,65,5
1731504861805,BILD 5,B03,786891,Reuther; Keefe,64,0,65,1
1731504861805,BILD 5,B04,786892,Reuther; Keefe,65,0,65,0
1731504862831,BILD 12,A01,757527,Komiyama; Takaki,24,0,24,0
1731504862831,BILD 12,A02,757530,Komiyama; Takaki,24,0,24,0
1731504862831,BILD 12,A03,757531,Komiyama; Takaki,21,0,24,3
1731504862831,BILD 12,A04,757532,Komiyama; Takaki,24,0,24,0
1731504863858,BILD 22,A01,757534,Strause; Linda G.,69,0,75,6
1731504863858,BILD 22,A02,757535,Strause; Linda G.,70,0,75,5
1731504863858,BILD 22,A03,757544,Strause; Linda G.,75,0,75,0
1731504863858,BILD 22,A04,757547,Strause; Linda G.,74,0,75,1
1731504864885,BILD 28,A01,757549,Idoyaga; Juliana,30,0,30,0
1731504864885,BILD 28,A02,757550,Idoyaga; Juliana,30,0,30,0
1731504864885,BILD 28,A03,757551,Idoyaga; Juliana,30,0,30,0
1731504864885,BILD 28,A04,757552,Idoyaga; Juliana,30,0,30,0
1731504865912,BILD 60,A01,757569,Meharena; Hiruy Sibhatu,16,0,16,0
1731504865912,BILD 60,A02,757570,Meharena; Hiruy Sibhatu,16,0,16,0
1731504865912,BILD 60,A03,757571,Meharena; Hiruy Sibhatu,16,0,16,0
1731504865912,BILD 60,A04,757572,Meharena; Hiruy Sibhatu,16,0,16,0
1731504866940,BILD 62,A01,757574,Juavinett; Ashley Lauren,22,0,24,2
1731504866940,BILD 62,A02,757575,Juavinett; Ashley Lauren,23,0,24,1
1731504866940,BILD 62,A03,757576,Juavinett; Ashley Lauren,21,0,24,3
1731504866940,BILD 62,A04,757712,Juavinett; Ashley Lauren,22,0,24,2
1731504867964,BILD 87,A00,757714,Saier; Milton H.,20,0,20,0
1731504867964,BILD 87,B00,757715,Saier; Milton H.,19,0,20,1
1731504869003,BIMM 100,A01,785694,Cook-Andersen; Heidi Leigh,46,0,48,2
1731504869003,BIMM 100,A02,785696,Cook-Andersen; Heidi Leigh,48,0,48,0
1731504869003,BIMM 100,A03,785706,Cook-Andersen; Heidi Leigh,42,0,48,6
1731504869003,BIMM 100,A04,785714,Cook-Andersen; Heidi Leigh,48,0,48,0
1731504869003,BIMM 100,B01,785715,Akbari; Omar Sultan,45,0,48,3
1731504869003,BIMM 100,B02,785716,Akbari; Omar Sultan,39,0,48,9
1731504869003,BIMM 100,B03,785717,Akbari; Omar Sultan,46,0,48,2
1731504869003,BIMM 100,B04,785718,Akbari; Omar Sultan,46,0,48,2
1731504870033,BIMM 101,A01,758279,Meaders; Clara Leigh,0,0,24,24
1731504870033,BIMM 101,A02,758280,Meaders; Clara Leigh,0,0,24,24
1731504870033,BIMM 101,B01,758282,Tour; Ella,8,0,24,16
1731504870033,BIMM 101,B02,758283,Tour; Ella,14,0,24,10
1731504870033,BIMM 101,C01,758285,Day; Christopher D,19,0,24,5
1731504870033,BIMM 101,C02,758286,Day; Christopher D,22,0,24,2
1731504870033,BIMM 101,D01,758293,Cooper; Andrew Michael,19,0,24,5
1731504870033,BIMM 101,D02,758323,Cooper; Andrew Michael,20,0,24,4
1731504870033,BIMM 101,E01,758342,Rusert; Jessica Marie,21,0,24,3
1731504870033,BIMM 101,E02,758343,Rusert; Jessica Marie,24,0,24,0
1731504870033,BIMM 101,F01,758345,Rusert; Jessica Marie,23,0,24,1
1731504870033,BIMM 101,F02,758346,Rusert; Jessica Marie,24,0,24,0
1731504871063,BIMM 112,A01,758422,Kadonaga; James T,38,0,40,2
1731504871063,BIMM 112,A02,758427,Kadonaga; James T,33,0,40,7
1731504871063,BIMM 112,A03,758428,Kadonaga; James T,35,0,40,5
1731504871063,BIMM 112,A04,758429,Kadonaga; James T,39,0,40,1
1731504872091,BIMM 114,A01,758433,Daugherty; Matthew Dorton,39,0,48,9
1731504872091,BIMM 114,A02,758434,Daugherty; Matthew Dorton,46,0,48,2
1731504872091,BIMM 114,A03,758441,Daugherty; Matthew Dorton,45,0,48,3
1731504872091,BIMM 114,A04,758449,Daugherty; Matthew Dorton,42,0,48,6
1731504873123,BIMM 121,A01,758694,Gustafson-Brown; Cindy,13,0,24,11
1731504873123,BIMM 121,A02,758695,Gustafson-Brown; Cindy,20,0,24,4
1731504873123,BIMM 121,B01,758854,Gustafson-Brown; Cindy,18,0,24,6
1731504873123,BIMM 121,B02,758855,Gustafson-Brown; Cindy,19,0,24,5
1731504873123,BIMM 121,C01,758859,Pirino; Giorgia,4,0,24,20
1731504873123,BIMM 121,C02,758860,Pirino; Giorgia,11,0,24,13
1731504874458,BIMM 134,A01,758866,Burg; Michael,76,0,103,27
1731504874458,BIMM 134,A02,758867,Burg; Michael,102,0,103,1
1731504874458,BIMM 134,A03,758868,Burg; Michael,84,0,103,19
1731504874458,BIMM 134,A04,758870,Burg; Michael,97,0,101,4
1731504875485,BIMM 143,A01,758872,Grant; Barry J,12,0,40,28
1731504875485,BIMM 143,B01,759109,Bozinovic; Goran,30,0,40,10
1731504876511,BIMM 143R,A01,759111,Bozinovic; Goran,23,0,40,17
1731504877539,BIMM 172,A01,759115,Briggs; Steven,10,0,15,5
1731504877539,BIMM 172,A02,759116,Briggs; Steven,11,0,15,4
1731504877539,BIMM 172,A03,759117,Briggs; Steven,5,0,15,10
1731504877539,BIMM 172,A04,759119,Briggs; Steven,10,0,15,5
1731504878566,BIMM 181,A01,759121,Pevzner; Pavel Arkadjevich,31,0,60,29
1731504879597,BIMM 194,A00,759122,Akbari; Omar Sultan,31,0,32,1
1731504879597,BIMM 194,B00,759123,Lykke-Andersen; Jens,11,0,32,21
1731504879597,BIMM 194,C00,759125,Hasty; Jeff M,29,0,32,3
1731504880623,BIOM 200C,A00,734458,Benner; Christopher William,2,0,28,26
1731504881653,BIOM 202,A01,734460,Corbett; Kevin Daniel,23,0,35,12
1731504882680,BIOM 203B,A00,800936,Gustafsson; Asa Birgitta,35,0,35,0
1731504883709,BIOM 218,A00,734462,Gagneux; Pascal,12,0,12,0
1731504884744,BIOM 246,A00,796600,Gordts; Philip & Lewis; Amanda Lark & Godula; Kamil & Gagneux; Pascal & Esko; Jeffrey D. & Bode; Lars,0,0,0,0
1731504885770,BIOM 253,A00,734463,Nizet; Victor F.,7,0,15,8
1731504886797,BIOM 255,A00,734466,Joiner; William J.,0,0,0,0
1731504887826,BIOM 256,A00,734467,Yang; Jing,0,0,0,0
1731504888853,BIOM 262,A01,734469,Goren; Alon M,19,0,20,1
1731504889890,BIOM 275,A01,734471,Antal; Corina Elena & Obara; Christopher & Mendiola; Andrew & Gonzalez; David J,1,0,28,27
1731504890921,BIOM 277,A01,797835,Klemke; Richard,0,0,0,0
1731504891949,BIOM 287,A00,734472,Khojah; Reem I,0,0,0,0
1731504892979,BIOM 295,A00,734474,Joiner; William J.,0,0,0,0
1731504894020,BIPN 100,A01,787002,Maita; Isabella Vincenza,57,0,61,4
1731504894020,BIPN 100,A02,787005,Maita; Isabella Vincenza,58,0,61,3
1731504894020,BIPN 100,A03,787008,Maita; Isabella Vincenza,58,0,61,3
1731504894020,BIPN 100,A04,787009,Maita; Isabella Vincenza,60,0,62,2
1731504894020,BIPN 100,B01,786881,Reyes Gonzalez; Catalina,61,0,61,0
1731504894020,BIPN 100,B02,786882,Reyes Gonzalez; Catalina,60,0,61,1
1731504894020,BIPN 100,B03,786883,Reyes Gonzalez; Catalina,55,0,61,6
1731504894020,BIPN 100,B04,786884,Reyes Gonzalez; Catalina,55,0,62,7
1731504894020,BIPN 100,C01,787011,Marino; Marc J,53,0,61,8
1731504894020,BIPN 100,C02,787013,Marino; Marc J,56,0,61,5
1731504894020,BIPN 100,C03,787014,Marino; Marc J,59,0,61,2
1731504894020,BIPN 100,C04,787015,Marino; Marc J,53,0,62,9
1731504894020,BIPN 100,D01,794575,Yang; Mingyu,35,0,36,1
1731504894020,BIPN 100,D02,794600,Yang; Mingyu,35,0,36,1
1731504894020,BIPN 100,D03,794576,Yang; Mingyu,35,0,36,1
1731504894020,BIPN 100,D04,794601,Yang; Mingyu,37,0,37,0
1731504895050,BIPN 102,A01,759131,Reyes Gonzalez; Catalina,36,0,61,25
1731504895050,BIPN 102,A02,759133,Reyes Gonzalez; Catalina,56,0,61,5
1731504895050,BIPN 102,A03,759134,Reyes Gonzalez; Catalina,56,0,61,5
1731504895050,BIPN 102,A04,759135,Reyes Gonzalez; Catalina,59,0,62,3
1731504896084,BIPN 105,A01,759139,Armour; Jon Christopher,4,0,21,17
1731504896084,BIPN 105,A02,759140,Armour; Jon Christopher,15,0,21,6
1731504896084,BIPN 105,B01,759144,Armour; Jon Christopher,14,0,21,7
1731504896084,BIPN 105,B02,759147,Armour; Jon Christopher,21,0,21,0
1731504897115,BIPN 140,A01,759149,Lovett-Barron; Matthew Rod,31,0,40,9
1731504897115,BIPN 140,A02,759150,Lovett-Barron; Matthew Rod,40,0,40,0
1731504897115,BIPN 140,A03,759152,Lovett-Barron; Matthew Rod,38,0,40,2
1731504897115,BIPN 140,A04,759154,Lovett-Barron; Matthew Rod,37,0,38,1
1731504898150,BIPN 145,A01,759171,Juavinett; Ashley Lauren,34,0,42,8
1731504898150,BIPN 145,B01,759173,Maita; Isabella Vincenza,40,0,42,2
1731504898150,BIPN 145,C01,759176,Marino; Marc J,30,0,42,12
1731504899177,BIPN 154,A01,759178,Lim; Byungkook,26,0,30,4
1731504899177,BIPN 154,A02,759179,Lim; Byungkook,28,0,30,2
1731504899177,BIPN 154,A03,759180,Lim; Byungkook,28,0,30,2
1731504899177,BIPN 154,A04,759181,Lim; Byungkook,26,0,31,5
1731504900204,BIPN 160,A01,759183,Root; Cory Matthew,45,0,62,17
1731504900204,BIPN 160,A02,759186,Root; Cory Matthew,58,0,62,4
1731504900204,BIPN 160,A03,759187,Root; Cory Matthew,61,0,62,1
1731504900204,BIPN 160,A04,759188,Root; Cory Matthew,51,0,61,10
1731504901232,BIPN 162,A01,759190,Benna; Marcus K,4,0,7,3
1731504901232,BIPN 162,A02,759191,Benna; Marcus K,2,0,7,5
1731504901232,BIPN 162,A03,759192,Benna; Marcus K,4,0,7,3
1731504901232,BIPN 162,A04,759194,Benna; Marcus K,8,0,9,1
1731504902260,BIPN 194,A00,759195,Ackerman; Susan,31,0,32,1
1731504902260,BIPN 194,B00,759196,Leutgeb; Jill K.,14,0,32,18
1731504902260,BIPN 194,C00,759197,Banghart; Matthew Ryan,28,0,32,4
1731504902260,BIPN 194,E00,759201,Meharena; Hiruy Sibhatu,32,0,32,0
1731504903286,BISP 193,001,795783,Maita; Isabella Vincenza,9999,0,9999,0
1731504904314,BISP 194,A00,759202,Newsam; John,14,0,32,18
1731504904314,BISP 194,B00,759203,Cooper; Kimberly Lynn,20,0,32,12
1731504905342,BNFO 262,A01,734447,Goren; Alon M,4,0,5,1
1731504906375,BNFO 281,A00,734448,Gaasterland; Theresa,74,0,100,26
1731504907410,BNFO 283,A00,734456,Fisch; Kathleen Marie & Sahoo; Debashis,7,0,23,16
1731504907410,BNFO 283,B00,734457,Abagyan; Ruben & Bansal; Vikas,11,0,23,12
1731504908440,BNFO 286,A00,734451,Ideker; Trey,26,0,30,4
1731504909466,BNFO 294,A01,734453,Ross; Camille,45,0,50,5
1731504910506,CAT 2,A01,740617,Bronstein; Phoebe Malan,16,0,16,0
1731504910506,CAT 2,A02,740618,Bronstein; Phoebe Malan,9,0,16,7
1731504910506,CAT 2,A03,740619,Bronstein; Phoebe Malan,0,0,16,16
1731504910506,CAT 2,A04,740620,Bronstein; Phoebe Malan,9,0,16,7
1731504910506,CAT 2,A05,740621,Bronstein; Phoebe Malan,8,0,16,8
1731504910506,CAT 2,A06,740623,Bronstein; Phoebe Malan,12,0,16,4
1731504910506,CAT 2,A07,740625,Bronstein; Phoebe Malan,14,0,16,2
1731504910506,CAT 2,A08,740628,Bronstein; Phoebe Malan,15,0,16,1
1731504910506,CAT 2,A09,740629,Bronstein; Phoebe Malan,16,0,16,0
1731504910506,CAT 2,A10,740679,Bronstein; Phoebe Malan,16,0,16,0
1731504910506,CAT 2,A11,740681,Bronstein; Phoebe Malan,13,0,16,3
1731504910506,CAT 2,A12,740686,Bronstein; Phoebe Malan,13,0,16,3
1731504910506,CAT 2,A13,740698,Bronstein; Phoebe Malan,12,0,16,4
1731504910506,CAT 2,A14,740703,Bronstein; Phoebe Malan,12,0,16,4
1731504910506,CAT 2,A15,740704,Bronstein; Phoebe Malan,15,0,16,1
1731504910506,CAT 2,A16,740709,Bronstein; Phoebe Malan,13,0,16,3
1731504910506,CAT 2,B01,740715,Bigham; David Joseph,15,0,16,1
1731504910506,CAT 2,B02,740761,Bigham; David Joseph,14,0,16,2
1731504910506,CAT 2,B03,740762,Bigham; David Joseph,12,0,16,4
1731504910506,CAT 2,B04,740763,Bigham; David Joseph,12,0,16,4
1731504910506,CAT 2,B05,740764,Bigham; David Joseph,16,0,16,0
1731504910506,CAT 2,B06,740765,Bigham; David Joseph,13,0,16,3
1731504910506,CAT 2,B07,740767,Bigham; David Joseph,16,0,16,0
1731504910506,CAT 2,B08,740768,Bigham; David Joseph,16,0,16,0
1731504910506,CAT 2,B09,740770,Bigham; David Joseph,16,0,16,0
1731504910506,CAT 2,B10,740772,Bigham; David Joseph,12,0,16,4
1731504910506,CAT 2,B11,740773,Bigham; David Joseph,15,0,16,1
1731504910506,CAT 2,B12,740774,Bigham; David Joseph,16,0,16,0
1731504910506,CAT 2,B13,740777,Bigham; David Joseph,14,0,16,2
1731504910506,CAT 2,B14,740780,Bigham; David Joseph,12,0,16,4
1731504910506,CAT 2,B15,740781,Bigham; David Joseph,16,0,16,0
1731504910506,CAT 2,B16,740848,Bigham; David Joseph,16,0,16,0
1731504910506,CAT 2,C01,740895,Marchisotto; Jennifer Anne,16,0,16,0
1731504910506,CAT 2,C02,740896,Marchisotto; Jennifer Anne,13,0,16,3
1731504910506,CAT 2,C03,740908,Marchisotto; Jennifer Anne,12,0,16,4
1731504910506,CAT 2,C04,740944,Marchisotto; Jennifer Anne,14,0,16,2
1731504910506,CAT 2,C05,740945,Marchisotto; Jennifer Anne,15,0,16,1
1731504910506,CAT 2,C06,740946,Marchisotto; Jennifer Anne,16,0,16,0
1731504910506,CAT 2,C07,740947,Marchisotto; Jennifer Anne,14,0,16,2
1731504910506,CAT 2,C08,740949,Marchisotto; Jennifer Anne,16,0,16,0
1731504910506,CAT 2,C09,740960,Marchisotto; Jennifer Anne,16,0,16,0
1731504910506,CAT 2,C10,740966,Marchisotto; Jennifer Anne,15,0,16,1
1731504910506,CAT 2,C11,741017,Marchisotto; Jennifer Anne,15,0,16,1
1731504910506,CAT 2,C12,741018,Marchisotto; Jennifer Anne,14,0,16,2
1731504910506,CAT 2,C13,741019,Marchisotto; Jennifer Anne,16,0,16,0
1731504910506,CAT 2,C14,741024,Marchisotto; Jennifer Anne,15,0,16,1
1731504910506,CAT 2,D01,741027,Nguyen; Hoang A.,14,0,16,2
1731504910506,CAT 2,D02,741028,Nguyen; Hoang A.,6,0,16,10
1731504910506,CAT 2,D03,741029,Nguyen; Hoang A.,9,0,16,7
1731504910506,CAT 2,D04,741031,Nguyen; Hoang A.,15,0,16,1
1731504910506,CAT 2,D05,741033,Nguyen; Hoang A.,16,0,16,0
1731504910506,CAT 2,D06,741034,Nguyen; Hoang A.,15,0,16,1
1731504910506,CAT 2,D07,741035,Nguyen; Hoang A.,16,0,16,0
1731504910506,CAT 2,D08,741036,Nguyen; Hoang A.,16,0,16,0
1731504910506,CAT 2,D09,741039,Nguyen; Hoang A.,14,0,16,2
1731504910506,CAT 2,D10,741042,Nguyen; Hoang A.,14,0,16,2
1731504910506,CAT 2,D11,741045,Nguyen; Hoang A.,15,0,16,1
1731504910506,CAT 2,D12,741047,Nguyen; Hoang A.,15,0,16,1
1731504910506,CAT 2,D13,741049,Nguyen; Hoang A.,15,0,16,1
1731504910506,CAT 2,D14,741054,Nguyen; Hoang A.,15,0,16,1
1731504911534,CAT 2CE,A01,741072,Popko; Elizabeth Ashley,24,0,25,1
1731504912559,CAT 87,A00,741105,Bronstein; Phoebe Malan,20,0,20,0
1731504912559,CAT 87,B00,795240,Delaville; Romain,20,0,20,0
1731504913592,CAT 124,A01,741118,Geibel; William,20,0,20,0
1731504913592,CAT 124,B01,799621,Staff,20,0,20,0
1731504914634,CAT 125,001,741143,Bigham; David Joseph,20,0,20,0
1731504914634,CAT 125,002,741149,Bigham; David Joseph,16,0,20,4
1731504914634,CAT 125,003,741152,Marchisotto; Jennifer Anne,20,0,20,0
1731504914634,CAT 125,004,741162,Marchisotto; Jennifer Anne,16,0,20,4
1731504914634,CAT 125,006,741164,Delaville; Romain,19,0,20,1
1731504914634,CAT 125,007,741180,Vanderschuit; Maya Alysia,19,0,20,1
1731504914634,CAT 125,008,741192,Vanderschuit; Maya Alysia,20,0,20,0
1731504914634,CAT 125,009,741193,Vanderschuit; Maya Alysia,19,0,20,1
1731504914634,CAT 125,010,741205,Morales; Celeste Georgianna,19,0,20,1
1731504914634,CAT 125,011,741207,Morales; Celeste Georgianna,20,0,20,0
1731504914634,CAT 125,012,741208,Morales; Celeste Georgianna,20,0,20,0
1731504914634,CAT 125,013,741209,Rose; Becca Rae,18,0,20,2
1731504914634,CAT 125,014,741215,Rose; Becca Rae,20,0,20,0
1731504914634,CAT 125,015,741222,Rose; Becca Rae,20,0,20,0
1731504914634,CAT 125,016,741224,Tosun; Adriana,18,0,20,2
1731504914634,CAT 125,017,741225,Tosun; Adriana,19,0,20,1
1731504915664,CAT 125R,A00,741229,Smith; Lauryn Alissa,17,0,20,3
1731504915664,CAT 125R,B00,741230,Smith; Lauryn Alissa,18,0,20,2
1731504915664,CAT 125R,C00,741231,Smith; Lauryn Alissa,16,0,20,4
1731504915664,CAT 125R,D00,741237,Hyland; Tina Mae,16,0,20,4
1731504915664,CAT 125R,E00,741240,Hyland; Tina Mae,17,0,20,3
1731504915664,CAT 125R,F00,741242,Hyland; Tina Mae,18,0,20,2
1731504915664,CAT 125R,G00,741243,Tosun; Adriana,15,0,20,5
1731504916696,CCE 1,001,744105,Labat Ii; Michael Luis,38,0,40,2
1731504916696,CCE 1,002,744106,Garcia; Kathryn Mary,37,0,40,3
1731504916696,CCE 1,003,744107,Lee; Kassandra,38,0,40,2
1731504916696,CCE 1,004,744108,Crawford; James,36,0,40,4
1731504916696,CCE 1,005,744109,Merryman; Ashley,39,0,40,1
1731504916696,CCE 1,006,744110,Santos; Vabianna Daria,39,0,40,1
1731504916696,CCE 1,007,744125,Bigley; Michele Heather,37,0,40,3
1731504917723,CCE 2,001,744126,Staff,19,0,20,1
1731504917723,CCE 2,002,744127,Garcia; Kathryn Mary,20,0,20,0
1731504917723,CCE 2,003,744128,Labat Ii; Michael Luis,20,0,20,0
1731504917723,CCE 2,004,744129,Labat Ii; Michael Luis,20,0,20,0
1731504917723,CCE 2,005,744130,Garcia; Kathryn Mary,20,0,20,0
1731504917723,CCE 2,006,744131,Lee; Kassandra,20,0,20,0
1731504917723,CCE 2,007,744132,Lee; Kassandra,20,0,20,0
1731504917723,CCE 2,008,744133,Santos; Vabianna Daria,20,0,20,0
1731504917723,CCE 2,009,744134,Santos; Vabianna Daria,19,0,20,1
1731504917723,CCE 2,010,744135,Bigley; Michele Heather,20,0,20,0
1731504917723,CCE 2,011,744167,Merryman; Ashley,20,0,20,0
1731504917723,CCE 2,012,744168,Merryman; Ashley,20,0,20,0
1731504918752,CCS 102,A00,795242,Werner; Bradley T.,15,0,20,5
1731504919785,CCS 123,A00,794510,Staff,25,0,25,0
1731504920813,CENG 15,A01,734482,Yang; Kesong,25,0,25,0
1731504921843,CENG 101A,A00,734483,Staff,49,0,50,1
1731504922867,CENG 101B,A00,734484,Liu; Ping,99,0,100,1
1731504923897,CENG 102,A00,734485,Powell; Alyssa,69,0,70,1
1731504923897,CENG 102,B00,734486,Powell; Alyssa,68,0,70,2
1731504924926,CENG 114,A00,734487,Jahed Motlagh; Zeinab,97,0,100,3
1731504925954,CENG 124A,A00,734488,Drews; Aaron,42,0,60,18
1731504925954,CENG 124A,B00,734489,Russ; Benjamin Edward,53,0,60,7
1731504926983,CENG 134,A00,734490,Pokorski; Jonathan Kyle,63,0,70,7
1731504928012,CENG 176A,A01,734492,Opatkiewicz; Justin Paul,11,0,48,37
1731504928012,CENG 176A,B01,734494,Zhang; Liangfang,55,0,60,5
1731504929039,CENG 205,A00,734495,Jahed Motlagh; Zeinab,40,0,60,20
1731504930074,CENG 213,A00,734496,Fenning; David,6,0,10,4
1731504931105,CENG 214,A00,734497,Li; Wan-Lu,10,0,10,0
1731504932132,CENG 215,A00,734498,Jokerst; Jesse Vincent,10,0,10,0
1731504933157,CENG 221B,A00,734499,Staff,28,0,50,22
1731504934184,CENG 251,A00,734500,Pascal; Tod A,29,0,50,21
1731504935211,CENG 252,A00,734501,Chen; Zheng,28,0,50,22
1731504936243,CENG 256,A00,734502,Meyers; Marc,10,0,10,0
1731504937272,CGS 101,A00,740473,Cuong; Marisol,35,0,35,0
1731504938297,CGS 108,A00,740486,Lu; Lillian,20,0,20,0
1731504939325,CGS 111,A00,740518,Martin Sandino; Amanda Maria Yoland,31,0,35,4
1731504940352,CGS 116,A00,740521,Cuong; Marisol,31,0,32,1
1731504941378,CGS 124,A00,740524,Martin Sandino; Amanda Maria Yoland,14,0,15,1
1731504942404,CGS 125,A00,740528,Browne; Errol Tsekani,19,0,20,1
1731504943432,CGS 135,A00,740534,Okonkwo; Holly,15,0,15,0
1731504944460,CGS 136,A00,740538,Chatti; Deepti,15,0,15,0
1731504945491,CGS 137,A00,740541,Martin Sandino; Amanda Maria Yoland,19,0,20,1
1731504946520,CGS 165,A00,740547,Browne; Errol Tsekani,13,0,15,2
1731504947547,CGS 167A,A00,740604,Patel; Shaista,11,0,12,1
1731504948573,CGS 187,A00,740608,Cuong; Marisol,13,0,15,2
1731504949600,CGS 196A,A00,740611,Taylor-Garcia; Daphne,1,0,1,0
1731504949600,CGS 196A,B00,799481,Hankins; Joseph D.,1,0,1,0
1731504949600,CGS 196A,C00,799482,Yapp; Hentyle T,1,0,1,0
1731504950627,CHEM 1,A00,734503,Brydges; Stacey,39,0,40,1
1731504951660,CHEM 6A,A01,784433,Lam; Tin Yiu,38,0,40,2
1731504951660,CHEM 6A,A02,784434,Lam; Tin Yiu,40,0,40,0
1731504951660,CHEM 6A,A03,784436,Lam; Tin Yiu,39,0,40,1
1731504951660,CHEM 6A,A04,784437,Lam; Tin Yiu,35,0,40,5
1731504951660,CHEM 6A,A05,784438,Lam; Tin Yiu,40,0,40,0
1731504951660,CHEM 6A,A06,784440,Lam; Tin Yiu,40,0,40,0
1731504951660,CHEM 6A,A07,784441,Lam; Tin Yiu,0,0,0,0
1731504951660,CHEM 6A,B01,784443,Lam; Tin Yiu,40,0,40,0
1731504951660,CHEM 6A,B02,784445,Lam; Tin Yiu,34,0,36,2
1731504951660,CHEM 6A,B03,784446,Lam; Tin Yiu,34,0,40,6
1731504951660,CHEM 6A,B04,784449,Lam; Tin Yiu,38,0,40,2
1731504951660,CHEM 6A,B05,784454,Lam; Tin Yiu,37,0,40,3
1731504951660,CHEM 6A,B06,784455,Lam; Tin Yiu,39,0,40,1
1731504951660,CHEM 6A,B07,784456,Lam; Tin Yiu,0,0,0,0
1731504951660,CHEM 6A,C01,784457,Ternansky; Robert J.,40,0,40,0
1731504951660,CHEM 6A,C02,784458,Ternansky; Robert J.,33,0,40,7
1731504951660,CHEM 6A,C03,784460,Ternansky; Robert J.,33,0,40,7
1731504951660,CHEM 6A,C04,784461,Ternansky; Robert J.,40,0,40,0
1731504951660,CHEM 6A,C05,784462,Ternansky; Robert J.,40,0,40,0
1731504951660,CHEM 6A,C06,784465,Ternansky; Robert J.,40,0,40,0
1731504951660,CHEM 6A,C07,784468,Ternansky; Robert J.,0,0,0,0
1731504952721,CHEM 6B,A01,784469,Kummel; Andrew C,40,0,40,0
1731504952721,CHEM 6B,A02,784470,Kummel; Andrew C,40,0,40,0
1731504952721,CHEM 6B,A03,784471,Kummel; Andrew C,39,0,40,1
1731504952721,CHEM 6B,A04,784472,Kummel; Andrew C,38,0,40,2
1731504952721,CHEM 6B,A05,784473,Kummel; Andrew C,37,0,40,3
1731504952721,CHEM 6B,A06,784474,Kummel; Andrew C,39,0,40,1
1731504952721,CHEM 6B,A07,784475,Kummel; Andrew C,0,0,0,0
1731504952721,CHEM 6B,B01,784481,Sailor; Michael Joseph,39,0,40,1
1731504952721,CHEM 6B,B02,784482,Sailor; Michael Joseph,39,0,40,1
1731504952721,CHEM 6B,B03,784483,Sailor; Michael Joseph,39,0,40,1
1731504952721,CHEM 6B,B04,784484,Sailor; Michael Joseph,40,0,40,0
1731504952721,CHEM 6B,B05,784485,Sailor; Michael Joseph,40,0,40,0
1731504952721,CHEM 6B,B06,784486,Sailor; Michael Joseph,40,0,40,0
1731504952721,CHEM 6B,B07,784487,Sailor; Michael Joseph,0,0,0,0
1731504952721,CHEM 6B,C01,784489,Stallings; Dontarie M,33,0,40,7
1731504952721,CHEM 6B,C02,784490,Stallings; Dontarie M,20,0,24,4
1731504952721,CHEM 6B,C03,784491,Stallings; Dontarie M,37,0,40,3
1731504952721,CHEM 6B,C04,784525,Stallings; Dontarie M,36,0,40,4
1731504952721,CHEM 6B,C05,784529,Stallings; Dontarie M,40,0,40,0
1731504952721,CHEM 6B,C06,784532,Stallings; Dontarie M,39,0,40,1
1731504952721,CHEM 6B,C07,784534,Stallings; Dontarie M,0,0,0,0
1731504952721,CHEM 6B,D01,784537,Stallings; Dontarie M,29,0,40,11
1731504952721,CHEM 6B,D02,784540,Stallings; Dontarie M,33,0,40,7
1731504952721,CHEM 6B,D03,784543,Stallings; Dontarie M,37,0,40,3
1731504952721,CHEM 6B,D04,784544,Stallings; Dontarie M,37,0,40,3
1731504952721,CHEM 6B,D05,784546,Stallings; Dontarie M,38,0,40,2
1731504952721,CHEM 6B,D06,784547,Stallings; Dontarie M,38,0,40,2
1731504952721,CHEM 6B,D07,784553,Stallings; Dontarie M,0,0,0,0
1731504952721,CHEM 6B,E01,784556,Young; Mark,40,0,40,0
1731504952721,CHEM 6B,E02,784557,Young; Mark,40,0,40,0
1731504952721,CHEM 6B,E03,784566,Young; Mark,40,0,40,0
1731504952721,CHEM 6B,E04,784568,Young; Mark,40,0,40,0
1731504952721,CHEM 6B,E05,784571,Young; Mark,40,0,40,0
1731504952721,CHEM 6B,E06,784572,Young; Mark,39,0,40,1
1731504952721,CHEM 6B,E07,784574,Young; Mark,0,0,0,0
1731504952721,CHEM 6B,F01,784578,Young; Mark,40,0,40,0
1731504952721,CHEM 6B,F02,784581,Young; Mark,40,0,40,0
1731504952721,CHEM 6B,F03,784582,Young; Mark,40,0,40,0
1731504952721,CHEM 6B,F04,784584,Young; Mark,40,0,40,0
1731504952721,CHEM 6B,F05,784585,Young; Mark,40,0,40,0
1731504952721,CHEM 6B,F06,784589,Young; Mark,40,0,40,0
1731504952721,CHEM 6B,F07,784591,Young; Mark,0,0,0,0
1731504952721,CHEM 6B,G01,785227,Schurmeier; Kimberly,35,0,40,5
1731504952721,CHEM 6B,G02,785228,Schurmeier; Kimberly,37,0,40,3
1731504952721,CHEM 6B,G03,785229,Schurmeier; Kimberly,35,0,40,5
1731504952721,CHEM 6B,G04,785230,Schurmeier; Kimberly,0,0,0,0
1731504952721,CHEM 6B,G05,785231,Schurmeier; Kimberly,39,0,40,1
1731504952721,CHEM 6B,G06,785233,Schurmeier; Kimberly,34,0,40,6
1731504952721,CHEM 6B,G07,785234,Schurmeier; Kimberly,39,0,40,1
1731504953750,CHEM 6BH,A01,785675,Yuen Zhou; Joel,49,0,50,1
1731504954790,CHEM 6C,A01,785073,Ternansky; Robert J.,40,0,40,0
1731504954790,CHEM 6C,A02,785074,Ternansky; Robert J.,37,0,40,3
1731504954790,CHEM 6C,A03,785148,Ternansky; Robert J.,38,0,40,2
1731504954790,CHEM 6C,A04,785155,Ternansky; Robert J.,40,0,40,0
1731504954790,CHEM 6C,A05,785158,Ternansky; Robert J.,0,0,0,0
1731504954790,CHEM 6C,A06,785159,Ternansky; Robert J.,36,0,40,4
1731504954790,CHEM 6C,A07,785160,Ternansky; Robert J.,40,0,40,0
1731504954790,CHEM 6C,B01,784597,Albizati; Kim F.,26,0,40,14
1731504954790,CHEM 6C,B02,784600,Albizati; Kim F.,38,0,40,2
1731504954790,CHEM 6C,B03,784603,Albizati; Kim F.,34,0,40,6
1731504954790,CHEM 6C,B04,784604,Albizati; Kim F.,34,0,40,6
1731504954790,CHEM 6C,B05,784606,Albizati; Kim F.,39,0,40,1
1731504954790,CHEM 6C,B06,784607,Albizati; Kim F.,38,0,40,2
1731504954790,CHEM 6C,B07,784610,Albizati; Kim F.,0,0,0,0
1731504955825,CHEM 7L,A01,734519,Leigh; Brian,24,0,24,0
1731504955825,CHEM 7L,A02,734520,Leigh; Brian,23,0,24,1
1731504955825,CHEM 7L,A03,734521,Leigh; Brian,24,0,24,0
1731504955825,CHEM 7L,A04,734522,Leigh; Brian,21,0,21,0
1731504955825,CHEM 7L,A05,734523,Leigh; Brian,22,0,24,2
1731504955825,CHEM 7L,A06,734524,Leigh; Brian,24,0,24,0
1731504955825,CHEM 7L,A07,734525,Leigh; Brian,23,0,24,1
1731504955825,CHEM 7L,A08,734526,Leigh; Brian,23,0,24,1
1731504955825,CHEM 7L,A09,734527,Leigh; Brian,23,0,24,1
1731504955825,CHEM 7L,A10,734528,Leigh; Brian,19,0,21,2
1731504955825,CHEM 7L,B01,734530,Leigh; Brian,14,0,24,10
1731504955825,CHEM 7L,B02,734531,Leigh; Brian,22,0,24,2
1731504955825,CHEM 7L,B03,734532,Leigh; Brian,24,0,24,0
1731504955825,CHEM 7L,B04,734533,Leigh; Brian,24,0,24,0
1731504955825,CHEM 7L,B05,734534,Leigh; Brian,24,0,24,0
1731504955825,CHEM 7L,B06,734535,Leigh; Brian,22,0,24,2
1731504955825,CHEM 7L,B07,734536,Leigh; Brian,20,0,21,1
1731504955825,CHEM 7L,B08,734537,Leigh; Brian,13,0,24,11
1731504955825,CHEM 7L,B09,734538,Leigh; Brian,21,0,24,3
1731504955825,CHEM 7L,B10,734539,Leigh; Brian,22,0,24,2
1731504955825,CHEM 7L,C01,734541,Leigh; Brian,21,0,24,3
1731504955825,CHEM 7L,C02,734542,Leigh; Brian,23,0,24,1
1731504955825,CHEM 7L,C03,734543,Leigh; Brian,23,0,24,1
1731504955825,CHEM 7L,C04,734624,Leigh; Brian,24,0,24,0
1731504955825,CHEM 7L,C05,734625,Leigh; Brian,20,0,24,4
1731504955825,CHEM 7L,C06,734626,Leigh; Brian,23,0,24,1
1731504955825,CHEM 7L,C07,734658,Leigh; Brian,21,0,24,3
1731504955825,CHEM 7L,C08,734668,Leigh; Brian,23,0,24,1
1731504955825,CHEM 7L,C09,734754,Leigh; Brian,24,0,24,0
1731504955825,CHEM 7L,C10,734758,Leigh; Brian,19,0,21,2
1731504956855,CHEM 11,A01,785161,Huang; Xuemei,36,0,40,4
1731504956855,CHEM 11,A02,785164,Huang; Xuemei,39,0,40,1
1731504956855,CHEM 11,A03,785168,Huang; Xuemei,39,0,40,1
1731504956855,CHEM 11,A04,785169,Huang; Xuemei,40,0,40,0
1731504956855,CHEM 11,A05,785175,Huang; Xuemei,39,0,40,1
1731504956855,CHEM 11,A06,785177,Huang; Xuemei,35,0,40,5
1731504956855,CHEM 11,A07,785178,Huang; Xuemei,39,0,40,1
1731504956855,CHEM 11,A08,785179,Huang; Xuemei,39,0,40,1
1731504957890,CHEM 40A,A01,784614,Cohen; Seth M,29,0,40,11
1731504957890,CHEM 40A,A02,784615,Cohen; Seth M,38,0,40,2
1731504957890,CHEM 40A,A03,784617,Cohen; Seth M,32,0,39,7
1731504957890,CHEM 40A,A04,784632,Cohen; Seth M,38,0,40,2
1731504957890,CHEM 40A,A05,784657,Cohen; Seth M,36,0,40,4
1731504957890,CHEM 40A,A06,784658,Cohen; Seth M,38,0,40,2
1731504957890,CHEM 40A,A07,784689,Cohen; Seth M,40,0,40,0
1731504957890,CHEM 40A,A08,784695,Cohen; Seth M,40,0,40,0
1731504958929,CHEM 40B,A01,785501,Weizman; Haim,38,0,40,2
1731504958929,CHEM 40B,A02,785503,Weizman; Haim,30,0,40,10
1731504958929,CHEM 40B,A03,785504,Weizman; Haim,25,0,40,15
1731504958929,CHEM 40B,A04,785505,Weizman; Haim,38,0,40,2
1731504958929,CHEM 40B,A05,785506,Weizman; Haim,39,0,40,1
1731504958929,CHEM 40B,A06,785507,Weizman; Haim,0,0,0,0
1731504958929,CHEM 40B,A07,798353,Weizman; Haim,35,0,40,5
1731504958929,CHEM 40B,A08,798354,Weizman; Haim,38,0,40,2
1731504958929,CHEM 40B,B01,785184,Romero; Erik Anthony,37,0,40,3
1731504958929,CHEM 40B,B02,785185,Romero; Erik Anthony,39,0,40,1
1731504958929,CHEM 40B,B03,785186,Romero; Erik Anthony,40,0,40,0
1731504958929,CHEM 40B,B04,785187,Romero; Erik Anthony,37,0,40,3
1731504958929,CHEM 40B,B05,785190,Romero; Erik Anthony,40,0,40,0
1731504958929,CHEM 40B,B06,785191,Romero; Erik Anthony,0,0,0,0
1731504958929,CHEM 40B,B07,795158,Romero; Erik Anthony,40,0,40,0
1731504958929,CHEM 40B,B08,795161,Romero; Erik Anthony,40,0,40,0
1731504958929,CHEM 40B,C01,785509,Pun; Andrew Brian,31,0,38,7
1731504958929,CHEM 40B,C02,785510,Pun; Andrew Brian,31,0,40,9
1731504958929,CHEM 40B,C03,785512,Pun; Andrew Brian,38,0,40,2
1731504958929,CHEM 40B,C04,785513,Pun; Andrew Brian,37,0,40,3
1731504958929,CHEM 40B,C05,785514,Pun; Andrew Brian,39,0,40,1
1731504958929,CHEM 40B,C06,785515,Pun; Andrew Brian,34,0,40,6
1731504958929,CHEM 40B,C07,795106,Pun; Andrew Brian,29,0,40,11
1731504958929,CHEM 40B,C08,795148,Pun; Andrew Brian,0,0,0,0
1731504959958,CHEM 41A,A01,785193,Yang; Jerry,35,0,36,1
1731504959958,CHEM 41A,A02,785220,Yang; Jerry,31,0,36,5
1731504959958,CHEM 41A,A03,785221,Yang; Jerry,35,0,37,2
1731504959958,CHEM 41A,A04,785222,Yang; Jerry,37,0,37,0
1731504960986,CHEM 41B,A01,785594,Theodorakis; Emmanuel,35,0,40,5
1731504960986,CHEM 41B,A02,785595,Theodorakis; Emmanuel,40,0,40,0
1731504960986,CHEM 41B,A03,785598,Theodorakis; Emmanuel,36,0,40,4
1731504960986,CHEM 41B,A04,785599,Theodorakis; Emmanuel,24,0,24,0
1731504960986,CHEM 41B,A05,785656,Theodorakis; Emmanuel,39,0,40,1
1731504960986,CHEM 41B,A06,785657,Theodorakis; Emmanuel,40,0,40,0
1731504960986,CHEM 41B,A07,785658,Theodorakis; Emmanuel,37,0,40,3
1731504962020,CHEM 43A,A01,734984,Figueroa; Joshua,13,0,24,11
1731504962020,CHEM 43A,A02,734985,Figueroa; Joshua,22,0,24,2
1731504962020,CHEM 43A,A03,734986,Figueroa; Joshua,24,0,24,0
1731504962020,CHEM 43A,A04,734987,Figueroa; Joshua,22,0,24,2
1731504962020,CHEM 43A,A05,734988,Figueroa; Joshua,0,0,0,0
1731504962020,CHEM 43A,A06,735039,Figueroa; Joshua,0,0,0,0
1731504962020,CHEM 43A,A07,735040,Figueroa; Joshua,0,0,0,0
1731504962020,CHEM 43A,A08,735130,Figueroa; Joshua,0,0,0,0
1731504962020,CHEM 43A,B01,735277,Tor; Yitzhak,0,0,24,24
1731504962020,CHEM 43A,B02,735279,Tor; Yitzhak,12,0,24,12
1731504962020,CHEM 43A,B03,735281,Tor; Yitzhak,19,0,24,5
1731504962020,CHEM 43A,B04,735282,Tor; Yitzhak,16,0,24,8
1731504962020,CHEM 43A,B05,735284,Tor; Yitzhak,0,0,0,0
1731504962020,CHEM 43A,B06,735288,Tor; Yitzhak,0,0,0,0
1731504962020,CHEM 43A,B07,735289,Tor; Yitzhak,0,0,0,0
1731504962020,CHEM 43A,B08,735290,Tor; Yitzhak,0,0,0,0
1731504962020,CHEM 43A,C01,735300,Klosterman; Jeremy K,0,0,0,0
1731504962020,CHEM 43A,C02,735304,Klosterman; Jeremy K,0,0,0,0
1731504962020,CHEM 43A,C03,735308,Klosterman; Jeremy K,0,0,0,0
1731504962020,CHEM 43A,C04,735312,Klosterman; Jeremy K,20,0,24,4
1731504962020,CHEM 43A,C05,735317,Klosterman; Jeremy K,23,0,24,1
1731504962020,CHEM 43A,C06,735319,Klosterman; Jeremy K,24,0,24,0
1731504962020,CHEM 43A,C07,735320,Klosterman; Jeremy K,16,0,17,1
1731504962020,CHEM 43A,C08,735331,Klosterman; Jeremy K,24,0,24,0
1731504963051,CHEM 100A,A01,735347,Slade; Jonathan,19,0,23,4
1731504963051,CHEM 100A,A02,735632,Slade; Jonathan,21,0,24,3
1731504963051,CHEM 100A,A03,735636,Slade; Jonathan,19,0,23,4
1731504963051,CHEM 100A,A04,735637,Slade; Jonathan,21,0,24,3
1731504963051,CHEM 100A,A05,735638,Slade; Jonathan,19,0,24,5
1731504963051,CHEM 100A,A06,735639,Slade; Jonathan,22,0,23,1
1731504964078,CHEM 100B,A01,735649,Pomeroy; Robert S.,18,0,26,8
1731504965110,CHEM 105A,A01,735653,Sinha; Amitabha,31,0,42,11
1731504966137,CHEM 108,A01,735655,Jennings; Patricia A.,9,0,20,11
1731504966137,CHEM 108,A02,735658,Jennings; Patricia A.,23,0,24,1
1731504966137,CHEM 108,B01,735663,Jennings; Patricia A.,13,0,20,7
1731504966137,CHEM 108,B02,735666,Jennings; Patricia A.,21,0,24,3
1731504967171,CHEM 109,A01,735680,Piercy; Marc Anthony,6,0,20,14
1731504967171,CHEM 109,A02,735689,Piercy; Marc Anthony,19,0,24,5
1731504967171,CHEM 109,B01,735768,Piercy; Marc Anthony,17,0,20,3
1731504967171,CHEM 109,B02,735769,Piercy; Marc Anthony,23,0,24,1
1731504968199,CHEM 114A,A01,784696,Komor; Alexis C,39,0,40,1
1731504968199,CHEM 114A,A02,784723,Komor; Alexis C,38,0,40,2
1731504968199,CHEM 114A,A03,784725,Komor; Alexis C,38,0,40,2
1731504969238,CHEM 114B,A01,785242,Budin; Itay,26,0,40,14
1731504969238,CHEM 114B,A02,785299,Budin; Itay,40,0,40,0
1731504969238,CHEM 114B,A03,785306,Budin; Itay,37,0,40,3
1731504969238,CHEM 114B,A04,785309,Budin; Itay,39,0,40,1
1731504969238,CHEM 114B,B01,785313,Ghosh; Partho,39,0,40,1
1731504969238,CHEM 114B,B02,785375,Ghosh; Partho,38,0,40,2
1731504969238,CHEM 114B,B03,785407,Ghosh; Partho,40,0,40,0
1731504969238,CHEM 114B,B04,785410,Ghosh; Partho,40,0,40,0
1731504970266,CHEM 115,A00,735864,Komor; Alexis C,1,0,30,29
1731504971303,CHEM 120A,A01,785412,Stauber; Julia Megan,28,0,40,12
1731504971303,CHEM 120A,A02,785415,Stauber; Julia Megan,37,0,40,3
1731504971303,CHEM 120A,A03,785417,Stauber; Julia Megan,39,0,39,0
1731504971303,CHEM 120A,A04,785423,Stauber; Julia Megan,38,0,39,1
1731504972335,CHEM 126A,A01,784731,Yong; Haiwang,39,0,40,1
1731504972335,CHEM 126A,A02,784732,Yong; Haiwang,38,0,40,2
1731504972335,CHEM 126A,A03,784737,Yong; Haiwang,38,0,40,2
1731504973363,CHEM 126B,A01,785659,Tauber; Michael,14,0,40,26
1731504973363,CHEM 126B,A02,785664,Tauber; Michael,32,0,40,8
1731504973363,CHEM 126B,A03,785665,Tauber; Michael,20,0,40,20
1731504973363,CHEM 126B,A04,785668,Tauber; Michael,39,0,40,1
1731504973363,CHEM 126B,A05,785669,Tauber; Michael,35,0,40,5
1731504973363,CHEM 126B,A06,785671,Tauber; Michael,33,0,40,7
1731504974413,CHEM 131,A01,785425,Galperin; Michael,37,0,40,3
1731504974413,CHEM 131,A02,785499,Galperin; Michael,38,0,40,2
1731504974413,CHEM 131,A03,785500,Galperin; Michael,39,0,40,1
1731504975439,CHEM 134,A00,735869,Pokorski; Jonathan Kyle,16,0,18,2
1731504976475,CHEM 143B,A01,735871,Weizman; Haim,21,0,24,3
1731504976475,CHEM 143B,A02,735872,Weizman; Haim,20,0,24,4
1731504976475,CHEM 143B,A03,735914,Weizman; Haim,11,0,24,13
1731504976475,CHEM 143B,A04,735916,Weizman; Haim,0,0,0,0
1731504976475,CHEM 143B,A05,735918,Weizman; Haim,0,0,0,0
1731504977505,CHEM 151,A00,735919,Donoghue; Daniel J.,86,0,100,14
1731504978538,CHEM 154,A00,735922,Romero; Nathan A & Schmidt; Valerie A,29,0,30,1
1731504979566,CHEM 155,A00,735925,Theodorakis; Emmanuel,10,0,10,0
1731504980595,CHEM 168,A01,785516,Devaraj; Neal Krishna,39,0,40,1
1731504980595,CHEM 168,A02,785551,Devaraj; Neal Krishna,39,0,40,1
1731504980595,CHEM 168,A03,785554,Devaraj; Neal Krishna,37,0,40,3
1731504980595,CHEM 168,A04,785557,Devaraj; Neal Krishna,37,0,40,3
1731504980595,CHEM 168,A05,785559,Devaraj; Neal Krishna,34,0,40,6
1731504980595,CHEM 168,A06,785566,Devaraj; Neal Krishna,36,0,40,4
1731504981624,CHEM 169,A00,794456,Jinich; Adrian,48,0,50,2
1731504982651,CHEM 172,A01,785676,Pomeroy; Robert S.,46,0,50,4
1731504983676,CHEM 187,A00,735955,Brydges; Stacey,19,0,20,1
1731504984701,CHEM 194,A00,735956,Newsam; John,13,0,18,5
1731504985732,CHEM 200B,A00,735957,Pomeroy; Robert S.,8,0,20,12
1731504986759,CHEM 212,A00,735958,Budin; Itay,14,0,30,16
1731504987785,CHEM 213B,A00,735990,Debelouchina; Galia T,32,0,50,18
1731504988812,CHEM 215,A00,735991,Komor; Alexis C,12,0,30,18
1731504989839,CHEM 219C,A00,735992,Jennings; Patricia A.,9,0,15,6
1731504990868,CHEM 223,A00,735993,Oconnor; Joseph M.,25,0,30,5
1731504991893,CHEM 227,A00,735994,Stauber; Julia Megan,28,0,30,2
1731504992920,CHEM 229,A00,735995,Cohen; Seth M,15,0,20,5
1731504993950,CHEM 232A,A00,735996,Yuen Zhou; Joel,13,0,15,2
1731504994977,CHEM 254,A00,735997,Romero; Nathan A & Schmidt; Valerie A,27,0,30,3
1731504996001,CHEM 255,A00,735998,Theodorakis; Emmanuel,18,0,20,2
1731504997035,CHEM 269,A00,794455,Jinich; Adrian,8,0,25,17
1731504998062,CHEM 291,A00,735999,Debelouchina; Galia T,30,0,30,0
1731504999088,CHEM 294,A00,736000,Romero; Nathan A,48,0,50,2
1731505000113,CHIN 10BD,A01,736053,Liu; Mingming,16,0,16,0
1731505000113,CHIN 10BD,A02,736054,Liu; Mingming,16,0,16,0
1731505001141,CHIN 10BM,A01,736056,Chen; Pei-Chia,18,0,20,2
1731505001141,CHIN 10BM,A02,736057,Chen; Pei-Chia,14,0,15,1
1731505002176,CHIN 10BN,A01,736063,Xu; Li,13,0,13,0
1731505002176,CHIN 10BN,A02,736064,Xu; Li,11,0,13,2
1731505002176,CHIN 10BN,B01,736084,Xu; Li,10,0,13,3
1731505002176,CHIN 10BN,B02,736097,Xu; Li,12,0,13,1
1731505002176,CHIN 10BN,C01,736345,Xu; Li,9,0,13,4
1731505002176,CHIN 10BN,C02,736346,Xu; Li,0,0,0,0
1731505003204,CHIN 20BD,A01,795569,Liu; Mingming,14,0,14,0
1731505003204,CHIN 20BD,A02,795570,Liu; Mingming,14,0,14,0
1731505004230,CHIN 20BM,A01,736414,Wang; Xiao,15,0,16,1
1731505004230,CHIN 20BM,A02,736421,Wang; Xiao,16,0,16,0
1731505005264,CHIN 20BN,A01,736427,Anderson; Qin-Hong,13,0,14,1
1731505005264,CHIN 20BN,A02,736430,Anderson; Qin-Hong,13,0,14,1
1731505005264,CHIN 20BN,B01,736434,Anderson; Qin-Hong,0,0,0,0
1731505005264,CHIN 20BN,B02,736440,Anderson; Qin-Hong,0,0,0,0
1731505006290,CHIN 100BM,A00,736443,Wang; Xiao,20,0,20,0
1731505007319,CHIN 100BN,A00,736444,Chen; Pei-Chia,20,0,21,1
1731505008346,CHIN 169A,A00,736447,Wang; Xiao,20,0,20,0
1731505009381,CHIN 182A,A00,736468,Liu; Mingming,19,0,20,1
1731505010412,CLAS 87,A00,736801,Herbst; Matthew,20,0,20,0
1731505011438,CLIN 227A,A01,799589,Gold; Jeffrey Joseph,20,0,20,0
1731505012467,CLIN 227B,A00,799590,Gold; Jeffrey Joseph,20,0,20,0
1731505013499,CLIN 228,A01,799594,Gold; Jeffrey Joseph,20,0,20,0
1731505014525,CLIN 294B,A00,799595,Thomas; Kelsey Rae,10,0,10,0
1731505015552,CLIN 296,001,799596,Brookman; Lauren Irene,100,0,100,0
1731505015552,CLIN 296,002,799597,Brookman; Lauren Irene,10,0,10,0
1731505016580,CLRE 236R,A00,736762,Mehta; Ravindra L.,9994,0,9999,5
1731505017608,CLRE 237,A00,736763,Morris; Sheldon,9994,0,9999,5
1731505018639,CLRE 250R,A01,736787,Graves; Jennifer Sharon Ol,9999,0,9999,0
1731505019666,CLRE 251R,A00,795042,Mehta; Ravindra L.,9999,0,9999,0
1731505020693,CLRE 253,A00,736792,Vaida; Florin,9998,0,9999,1
1731505021726,CLRE 259,A00,736793,Patel; Hemal,9996,0,9999,3
1731505022753,CLRE 260,A00,736795,Cuomo; Raphael Eduardo,9996,0,9999,3
1731505022753,CLRE 260,B00,800937,Cuomo; Raphael Eduardo,9999,0,9999,0
1731505023781,CLRE 267,A00,795044,Vaida; Florin,9995,0,9999,4
1731505024806,CLRE 295B,A00,736798,Cuomo; Raphael Eduardo,9999,0,9999,0
1731505025833,CLRE 297,001,736799,Cuomo; Raphael Eduardo,9999,0,9999,0
1731505026865,CMM 246,A00,796595,Gordts; Philip & Lewis; Amanda Lark & Godula; Kamil & Gagneux; Pascal & Esko; Jeffrey D. & Bode; Lars,10,0,10,0
1731505027896,COGR 200B,A00,738801,Cordoba Azcarate; Matilde,5,0,5,0
1731505028923,COGR 200C,A00,738803,Geiger; Richard Stuart,5,0,5,0
1731505029952,COGR 201J,A00,738804,Hallin; Daniel C,8,0,10,2
1731505031038,COGR 225C,A00,738805,McKenzie; Kerry V.,4,0,5,1
1731505032066,COGR 225D,A00,738806,Lampland; Martha,5,0,5,0
1731505033098,COGR 237,A00,738807,Anderson; Patrick W.,3,0,10,7
1731505034123,COGR 275,A00,738808,Dominguez Rubio; Fernando,10,0,10,0
1731505035151,COGS 1,A01,737008,Kiyonaga; Anastasia,55,0,62,7
1731505035151,COGS 1,A02,737010,Kiyonaga; Anastasia,62,0,65,3
1731505035151,COGS 1,A03,737011,Kiyonaga; Anastasia,65,0,66,1
1731505035151,COGS 1,A04,737014,Kiyonaga; Anastasia,56,0,56,0
1731505035151,COGS 1,A05,737015,Kiyonaga; Anastasia,56,0,56,0
1731505035151,COGS 1,A06,737016,Kiyonaga; Anastasia,50,0,56,6
1731505035151,COGS 1,A07,737018,Kiyonaga; Anastasia,55,0,56,1
1731505036182,COGS 9,A01,737025,Staff,55,0,56,1
1731505036182,COGS 9,A02,737028,Staff,54,0,56,2
1731505036182,COGS 9,A03,737029,Staff,55,0,56,1
1731505036182,COGS 9,A04,737030,Staff,53,0,56,3
1731505036182,COGS 9,A05,737031,Staff,54,0,56,2
1731505036182,COGS 9,A06,737033,Staff,45,0,48,3
1731505037216,COGS 10,A01,737044,Morgan; Eric,48,0,56,8
1731505037216,COGS 10,A02,737045,Morgan; Eric,51,0,58,7
1731505037216,COGS 10,A03,737047,Morgan; Eric,52,0,56,4
1731505037216,COGS 10,A04,737049,Morgan; Eric,53,0,56,3
1731505037216,COGS 10,A05,737050,Morgan; Eric,51,0,52,1
1731505037216,COGS 10,A06,737051,Morgan; Eric,48,0,50,2
1731505038280,COGS 11,A01,737077,Boyle; Mary E. T.,46,0,50,4
1731505038280,COGS 11,A02,737078,Boyle; Mary E. T.,50,0,50,0
1731505038280,COGS 11,A03,737135,Boyle; Mary E. T.,44,0,47,3
1731505039312,COGS 13,A01,737138,Staff,63,0,65,2
1731505039312,COGS 13,A02,737139,Staff,53,0,56,3
1731505039312,COGS 13,A03,737142,Staff,54,0,56,2
1731505039312,COGS 13,A04,737144,Staff,56,0,56,0
1731505039312,COGS 13,A05,737145,Staff,53,0,56,3
1731505039312,COGS 13,A06,737148,Staff,56,0,56,0
1731505039312,COGS 13,A07,737149,Staff,65,0,65,0
1731505040341,COGS 14A,A01,737151,Barrera; Steven James,57,0,60,3
1731505040341,COGS 14A,A02,737152,Barrera; Steven James,55,0,60,5
1731505040341,COGS 14A,A03,737153,Barrera; Steven James,59,0,60,1
1731505040341,COGS 14A,A04,737154,Barrera; Steven James,58,0,60,2
1731505040341,COGS 14A,A05,737155,Barrera; Steven James,59,0,60,1
1731505041371,COGS 14B,A01,737157,Hoffman; Drew Ellen,46,0,50,4
1731505041371,COGS 14B,A02,737158,Hoffman; Drew Ellen,48,0,50,2
1731505041371,COGS 14B,A03,737159,Hoffman; Drew Ellen,48,0,50,2
1731505041371,COGS 14B,A04,737160,Hoffman; Drew Ellen,49,0,50,1
1731505041371,COGS 14B,A05,737189,Hoffman; Drew Ellen,50,0,50,0
1731505042397,COGS 17,A01,737193,Johnson; Christine M.,56,0,60,4
1731505042397,COGS 17,A02,737200,Johnson; Christine M.,57,0,60,3
1731505042397,COGS 17,A03,737210,Johnson; Christine M.,57,0,60,3
1731505042397,COGS 17,A04,737211,Johnson; Christine M.,59,0,60,1
1731505042397,COGS 17,A05,737234,Johnson; Christine M.,57,0,60,3
1731505042397,COGS 17,A06,737237,Johnson; Christine M.,58,0,60,2
1731505043430,COGS 18,A01,737254,Morgan; Eric,32,0,35,3
1731505043430,COGS 18,A02,737255,Morgan; Eric,33,0,35,2
1731505043430,COGS 18,A03,737256,Morgan; Eric,31,0,35,4
1731505043430,COGS 18,A04,737257,Morgan; Eric,31,0,35,4
1731505043430,COGS 18,A05,737264,Morgan; Eric,28,0,35,7
1731505043430,COGS 18,A06,737265,Morgan; Eric,32,0,35,3
1731505043430,COGS 18,A07,737288,Morgan; Eric,32,0,35,3
1731505043430,COGS 18,A08,737333,Morgan; Eric,35,0,35,0
1731505043430,COGS 18,A09,737334,Morgan; Eric,33,0,35,2
1731505044461,COGS 87,A00,737335,Deak; Gedeon O.,19,0,20,1
1731505045494,COGS 100,A01,737386,Allen; Michael Gordon,49,0,56,7
1731505045494,COGS 100,A02,737387,Allen; Michael Gordon,56,0,56,0
1731505045494,COGS 100,A03,737390,Allen; Michael Gordon,55,0,56,1
1731505045494,COGS 100,A04,737392,Allen; Michael Gordon,55,0,56,1
1731505045494,COGS 100,A05,737393,Allen; Michael Gordon,58,0,61,3
1731505045494,COGS 100,A06,737394,Allen; Michael Gordon,65,0,65,0
1731505046527,COGS 101A,A01,737396,Barrera; Steven James,57,0,61,4
1731505046527,COGS 101A,A02,737399,Barrera; Steven James,61,0,65,4
1731505046527,COGS 101A,A03,737400,Barrera; Steven James,53,0,56,3
1731505046527,COGS 101A,A04,737401,Barrera; Steven James,53,0,56,3
1731505046527,COGS 101A,A05,737404,Barrera; Steven James,54,0,56,2
1731505046527,COGS 101A,A06,737405,Barrera; Steven James,56,0,56,0
1731505047559,COGS 101B,A01,737408,Allen; Michael Gordon,46,0,50,4
1731505047559,COGS 101B,A02,737412,Allen; Michael Gordon,49,0,50,1
1731505047559,COGS 101B,A03,737413,Allen; Michael Gordon,49,0,50,1
1731505047559,COGS 101B,A04,737414,Allen; Michael Gordon,50,0,50,0
1731505047559,COGS 101B,A05,737415,Allen; Michael Gordon,49,0,50,1
1731505047559,COGS 101B,A06,737417,Allen; Michael Gordon,50,0,50,0
1731505048591,COGS 107A,A01,737419,Boyle; Mary E. T.,51,0,56,5
1731505048591,COGS 107A,A02,737421,Boyle; Mary E. T.,44,0,56,12
1731505048591,COGS 107A,A03,737423,Boyle; Mary E. T.,43,0,56,13
1731505048591,COGS 107A,A04,737424,Boyle; Mary E. T.,49,0,56,7
1731505048591,COGS 107A,A05,737425,Boyle; Mary E. T.,50,0,56,6
1731505048591,COGS 107A,A06,737426,Boyle; Mary E. T.,56,0,65,9
1731505048591,COGS 107A,A07,737429,Boyle; Mary E. T.,51,0,65,14
1731505049619,COGS 107B,A01,737431,Mooshagian; Eric Frederick,49,0,50,1
1731505049619,COGS 107B,A02,737435,Mooshagian; Eric Frederick,49,0,50,1
1731505049619,COGS 107B,A03,737436,Mooshagian; Eric Frederick,55,0,65,10
1731505049619,COGS 107B,A04,737438,Mooshagian; Eric Frederick,61,0,63,2
1731505049619,COGS 107B,A05,737439,Mooshagian; Eric Frederick,47,0,50,3
1731505049619,COGS 107B,A06,737440,Mooshagian; Eric Frederick,50,0,50,0
1731505050652,COGS 108,A01,737442,Ellis; Shannon Elizabeth,46,0,56,10
1731505050652,COGS 108,A02,737447,Ellis; Shannon Elizabeth,52,0,56,4
1731505050652,COGS 108,A03,737450,Ellis; Shannon Elizabeth,54,0,56,2
1731505050652,COGS 108,A04,737451,Ellis; Shannon Elizabeth,52,0,56,4
1731505050652,COGS 108,A05,737452,Ellis; Shannon Elizabeth,52,0,56,4
1731505050652,COGS 108,A06,737454,Ellis; Shannon Elizabeth,59,0,65,6
1731505050652,COGS 108,A07,737455,Ellis; Shannon Elizabeth,61,0,65,4
1731505050652,COGS 108,B01,737457,Ellis; Shannon Elizabeth,47,0,56,9
1731505050652,COGS 108,B02,737459,Ellis; Shannon Elizabeth,48,0,56,8
1731505050652,COGS 108,B03,737460,Ellis; Shannon Elizabeth,47,0,56,9
1731505050652,COGS 108,B04,737461,Ellis; Shannon Elizabeth,41,0,56,15
1731505050652,COGS 108,B05,737462,Ellis; Shannon Elizabeth,35,0,56,21
1731505050652,COGS 108,B06,737471,Ellis; Shannon Elizabeth,62,0,65,3
1731505050652,COGS 108,B07,737472,Ellis; Shannon Elizabeth,64,0,65,1
1731505051679,COGS 109,A01,737475,Staff,34,0,35,1
1731505051679,COGS 109,A02,737476,Staff,33,0,35,2
1731505051679,COGS 109,A03,737477,Staff,35,0,35,0
1731505051679,COGS 109,A04,737478,Staff,31,0,35,4
1731505052708,COGS 111,A01,737480,Hoffman; Drew Ellen,49,0,50,1
1731505052708,COGS 111,A02,737482,Hoffman; Drew Ellen,49,0,50,1
1731505052708,COGS 111,A03,737483,Hoffman; Drew Ellen,49,0,50,1
1731505052708,COGS 111,A04,737485,Hoffman; Drew Ellen,45,0,50,5
1731505053735,COGS 115,A01,737487,Deak; Gedeon O.,52,0,60,8
1731505054761,COGS 116,A01,737490,Greene; Deanna Jacquelyn,42,0,49,7
1731505054761,COGS 116,A02,737491,Greene; Deanna Jacquelyn,45,0,49,4
1731505055787,COGS 118C,A01,737493,Mukamel; Eran A,47,0,75,28
1731505056822,COGS 120,A01,737503,Xia; Haijun,44,0,50,6
1731505056822,COGS 120,A02,737763,Xia; Haijun,40,0,50,10
1731505056822,COGS 120,A03,737765,Xia; Haijun,50,0,50,0
1731505056822,COGS 120,A04,737766,Xia; Haijun,44,0,50,6
1731505056822,COGS 120,A05,737775,Xia; Haijun,50,0,50,0
1731505056822,COGS 120,A06,737781,Xia; Haijun,37,0,50,13
1731505057854,COGS 122,A01,737787,Dow; Steven P,0,0,0,5
1731505058882,COGS 126,A01,737795,Hollan; James D.,47,0,50,3
1731505059909,COGS 127,A01,737801,Guo; Philip J,46,0,50,4
1731505059909,COGS 127,A02,737805,Guo; Philip J,41,0,50,9
1731505059909,COGS 127,A03,737806,Guo; Philip J,44,0,50,6
1731505059909,COGS 127,A04,737811,Guo; Philip J,40,0,50,10
1731505059909,COGS 127,A05,737818,Guo; Philip J,3,0,50,47
1731505060939,COGS 144,A01,737824,Rossano; Federico,48,0,50,2
1731505061966,COGS 153,A00,737829,Staff,139,0,149,10
1731505062993,COGS 155,A01,737836,Cooperrider; Kensy A,48,0,50,2
1731505064019,COGS 156,A01,737841,Creel; Sarah,69,0,75,6
1731505065054,COGS 160,A00,737849,Kirsh; David Joel,25,0,25,0
1731505065054,COGS 160,B00,796034,Beatty-Martinez; Anne,74,0,75,1
1731505065054,COGS 160,C00,796035,Staff,149,0,149,0
1731505066086,COGS 164,A01,737961,Chiba; Andrea,40,0,45,5
1731505066086,COGS 164,A02,796040,Chiba; Andrea,28,0,45,17
1731505067112,COGS 177,A00,737964,Staff,110,0,120,10
1731505068142,COGS 181,A01,796038,Tu; Zhuowen,37,0,50,13
1731505068142,COGS 181,A02,796039,Tu; Zhuowen,31,0,50,19
1731505069174,COGS 187B,A01,737972,Kirsh; David Joel,47,0,50,3
1731505069174,COGS 187B,A02,738380,Kirsh; David Joel,17,0,50,33
1731505070206,COGS 188,A01,738029,Fleischer; Jason G,39,0,60,21
1731505070206,COGS 188,A02,738030,Fleischer; Jason G,56,0,60,4
1731505071231,COGS 189,A00,738031,De Sa; Virginia,165,0,200,35
1731505072270,COGS 190B,:00,796056,Staff,20,0,20,0
1731505072270,COGS 190B,A00,738176,Chiba; Andrea,9999,0,9999,0
1731505072270,COGS 190B,B00,738177,Fleischer; Jason G,20,0,20,0
1731505072270,COGS 190B,C00,738258,Hoffman; Drew Ellen,20,0,20,0
1731505072270,COGS 190B,D00,738259,Voytek; Bradley Thomas,20,0,20,0
1731505072270,COGS 190B,E00,738272,Kirsh; David Joel,20,0,20,0
1731505072270,COGS 190B,F00,738287,Kiyonaga; Anastasia,20,0,20,0
1731505072270,COGS 190B,G00,796051,Beatty-Martinez; Anne,20,0,20,0
1731505072270,COGS 190B,H00,796052,Nitz; Douglas A.,20,0,20,0
1731505072270,COGS 190B,I00,796053,De Sa; Virginia,20,0,20,0
1731505072270,COGS 190B,J00,796054,Rangel; Lara M,20,0,20,0
1731505072270,COGS 190B,K00,796055,Boyle; Mary E. T.,20,0,20,0
1731505072270,COGS 190B,L00,796058,Jernigan; Terry Lynne,20,0,20,0
1731505072270,COGS 190B,M00,796059,Deak; Gedeon O.,20,0,20,0
1731505072270,COGS 190B,N00,796060,Tu; Zhuowen,20,0,20,0
1731505072270,COGS 190B,O00,796061,Creel; Sarah,20,0,20,0
1731505073301,COGS 194,A00,738288,Hill; Seth J,9999,0,9999,0
1731505074330,COGS 198,001,738361,Voytek; Bradley Thomas,20,0,20,0
1731505075359,COGS 205,A00,738365,Chiba; Andrea,17,0,20,3
1731505076390,COGS 210B,001,736818,Nitz; Douglas A.,9998,0,9999,1
1731505076390,COGS 210B,002,736819,Xia; Haijun,9999,0,9999,0
1731505076390,COGS 210B,003,736820,Bergen; Benjamin,9998,0,9999,1
1731505076390,COGS 210B,004,736822,Kirsh; David Joel,9999,0,9999,0
1731505076390,COGS 210B,005,736824,Rangel; Lara M,9998,0,9999,1
1731505076390,COGS 210B,006,736825,Rossano; Federico,9999,0,9999,0
1731505076390,COGS 210B,007,736826,Guo; Philip J,9999,0,9999,0
1731505076390,COGS 210B,008,736829,De Sa; Virginia,9999,0,9999,0
1731505076390,COGS 210B,009,796069,Greene; Deanna Jacquelyn,9999,0,9999,0
1731505076390,COGS 210B,010,796070,Hollan; James D.,9999,0,9999,0
1731505076390,COGS 210B,011,796071,Kiyonaga; Anastasia,9999,0,9999,0
1731505076390,COGS 210B,012,796073,Coulson; Seana M,9999,0,9999,0
1731505076390,COGS 210B,013,796074,Dow; Steven P,9999,0,9999,0
1731505077438,COGS 211B,A00,736830,Coulson; Seana M,17,0,20,3
1731505078465,COGS 219,A01,736835,Zettersten; Martin,0,0,0,17
1731505079500,COGS 223,A00,736836,Dow; Steven P,18,0,25,7
1731505080533,COGS 229,A00,736842,Vaccaro; Kristen Marie,9,0,10,1
1731505081562,COGS 260,A00,736843,Kiyonaga; Anastasia,16,0,25,9
1731505082594,COMM 10,A01,738505,Armenta; John E,21,0,25,4
1731505082594,COMM 10,A02,738683,Armenta; John E,21,0,25,4
1731505082594,COMM 10,A03,738685,Armenta; John E,18,0,25,7
1731505082594,COMM 10,A04,738686,Armenta; John E,23,0,25,2
1731505082594,COMM 10,A05,738687,Armenta; John E,23,0,25,2
1731505082594,COMM 10,A06,738688,Armenta; John E,23,0,25,2
1731505082594,COMM 10,A07,738689,Armenta; John E,25,0,25,0
1731505082594,COMM 10,A08,738690,Armenta; John E,25,0,25,0
1731505082594,COMM 10,A09,738691,Armenta; John E,25,0,25,0
1731505082594,COMM 10,A10,738693,Armenta; John E,25,0,25,0
1731505082594,COMM 10,A11,738694,Armenta; John E,25,0,25,0
1731505082594,COMM 10,A12,738695,Armenta; John E,24,0,25,1
1731505083620,COMM 20,A01,738704,McKenna; Denise,73,0,75,2
1731505084653,COMM 30,A00,738705,Schmidt; Thomas Rainer,72,0,75,3
1731505085678,COMM 50,A00,738706,Armenta; John E,24,0,25,1
1731505086703,COMM 80,A01,738710,Campbell; Robert Harold,79,0,80,1
1731505087732,COMM 87,A00,795241,Serlin; David,20,0,20,0
1731505088760,COMM 100C,A01,738712,Dewaard; Andrew Michael,22,0,25,3
1731505088760,COMM 100C,A02,738713,Dewaard; Andrew Michael,25,0,25,0
1731505088760,COMM 100C,A03,738714,Dewaard; Andrew Michael,22,0,25,3
1731505088760,COMM 100C,A04,738715,Dewaard; Andrew Michael,21,0,25,4
1731505088760,COMM 100C,A05,738716,Dewaard; Andrew Michael,24,0,25,1
1731505088760,COMM 100C,A06,738718,Dewaard; Andrew Michael,23,0,25,2
1731505088760,COMM 100C,A07,738720,Dewaard; Andrew Michael,24,0,25,1
1731505088760,COMM 100C,A09,738724,Dewaard; Andrew Michael,24,0,25,1
1731505088760,COMM 100C,A11,738726,Dewaard; Andrew Michael,24,0,25,1
1731505088760,COMM 100C,A12,738727,Dewaard; Andrew Michael,24,0,25,1
1731505089789,COMM 101,A01,738730,Ahn; Patricia Jeehyun,14,0,15,1
1731505089789,COMM 101,A02,738731,Ahn; Patricia Jeehyun,15,0,15,0
1731505089789,COMM 101,A03,738732,Ahn; Patricia Jeehyun,12,0,15,3
1731505089789,COMM 101,A04,738733,Ahn; Patricia Jeehyun,13,0,15,2
1731505090822,COMM 101D,A00,738737,Martinico; Daniel J,16,0,16,0
1731505091849,COMM 101K,A00,738743,Ahn; Patricia Jeehyun,13,0,16,3
1731505092875,COMM 101N,A00,738746,Martinico; Daniel J,16,0,16,0
1731505093913,COMM 101T,A00,738749,Halm; Gavin Patrick,14,0,18,4
1731505093913,COMM 101T,B00,738752,Halm; Gavin Patrick,18,0,18,0
1731505093913,COMM 101T,C00,795163,Dewey; Matthew D,10,0,10,0
1731505094945,COMM 102B,A01,738754,Peacher; Amanda M,8,0,9,1
1731505094945,COMM 102B,A02,738755,Peacher; Amanda M,9,0,9,0
1731505095973,COMM 102C,A01,738757,Campion; Camille E,3,0,6,3
1731505095973,COMM 102C,A02,738758,Campion; Camille E,6,0,6,0
1731505095973,COMM 102C,A03,738759,Campion; Camille E,6,0,6,0
1731505097000,COMM 103D,A00,799575,Davis; Zeinabu I.,30,0,30,0
1731505098025,COMM 103E,A00,738763,Dewey; Matthew D,29,0,30,1
1731505099051,COMM 106,A00,738764,Kidman; Shawna F,138,0,140,2
1731505100082,COMM 106M,A00,738765,Whitworth-Smith; Andrew C,67,0,75,8
1731505101108,COMM 106N,A00,738766,Schmidt; Thomas Rainer,21,0,30,9
1731505102135,COMM 107,A00,738767,Serlin; David,30,0,30,0
1731505103161,COMM 111A,A00,738769,Pavon Aramburu; Maria Laur,29,0,30,1
1731505104187,COMM 111B,A00,738770,Zilberg; Elana,38,0,40,2
1731505105215,COMM 111P,A00,738771,Ruskiewicz; Eva Marie,29,0,30,1
1731505106249,COMM 113T,A00,738774,Abuelhiga; Soraya Jill,28,0,30,2
1731505106249,COMM 113T,B00,738775,Fields; Gary,30,0,30,0
1731505106249,COMM 113T,C00,738776,McKenna; Denise,29,0,30,1
1731505107276,COMM 114I,A00,738780,Leuning; Grant Maurstad,30,0,30,0
1731505108304,COMM 114T,A00,738781,Walkover; Lillian B,29,0,30,1
1731505109336,COMM 120M,A00,738783,Lazitski Torres; Olga,30,0,30,0
1731505110363,COMM 124A,A00,738784,Irani; Lilly C,73,0,75,2
1731505111391,COMM 134,A00,738785,Kidman; Shawna F,29,0,30,1
1731505113443,COMM 138,A00,738786,Boateng; Boatema,30,0,30,0
1731505114469,COMM 145,A00,738788,Rojo Solis; Juan Jose,29,0,30,1
1731505115497,COMM 146,A00,738789,Ybarra; Megan,28,0,30,2
1731505116524,COMM 156,A00,738791,Staff,30,0,30,0
1731505117551,COMM 159,A00,738792,Cordoba Azcarate; Matilde,23,0,30,7
1731505118580,COMM 164,A00,738793,Dominguez Rubio; Fernando,25,0,25,0
1731505119606,COMM 177,A00,795164,Rojo Solis; Juan Jose,25,0,25,0
1731505120636,COMM 190,A00,738795,Boateng; Boatema,23,0,23,0
1731505120636,COMM 190,B00,738797,Staff,19,0,23,4
1731505120636,COMM 190,C00,738798,Wiering; Liesbeth,21,0,23,2
1731505121666,COMM 194,A00,770727,Hill; Seth J,9999,0,9999,0
1731505122692,COMM 196B,A00,738800,Dewaard; Andrew Michael,10,0,10,0
1731505123735,CSE 8A,A50,738815,Alvarado; Christine J.,39,0,40,1
1731505123735,CSE 8A,A51,738819,Alvarado; Christine J.,40,0,40,0
1731505123735,CSE 8A,A52,738823,Alvarado; Christine J.,40,0,40,0
1731505123735,CSE 8A,A53,738825,Alvarado; Christine J.,35,0,40,5
1731505123735,CSE 8A,A54,738826,Alvarado; Christine J.,37,0,40,3
1731505123735,CSE 8A,A55,799488,Alvarado; Christine J.,0,0,0,0
1731505124768,CSE 8B,A01,788635,Ochoa; Benjamin Lawrence,59,0,70,11
1731505125802,CSE 11,A01,788660,Cao; Yingjun,161,0,175,14
1731505126828,CSE 12,A01,788668,Cao; Yingjun,25,0,50,25
1731505127864,CSE 20,A01,786527,Jones; Miles E,18,0,25,7
1731505127864,CSE 20,A02,786528,Jones; Miles E,19,0,25,6
1731505128892,CSE 21,A01,786539,Jones; Miles E,46,0,50,4
1731505128892,CSE 21,A02,786540,Jones; Miles E,49,0,50,1
1731505129920,CSE 29,A50,738835,Soosai Raj; Adalbert Geral,0,0,5,5
1731505129920,CSE 29,A51,738840,Soosai Raj; Adalbert Geral,4,0,5,1
1731505129920,CSE 29,A52,738842,Soosai Raj; Adalbert Geral,3,0,5,2
1731505129920,CSE 29,A53,738844,Soosai Raj; Adalbert Geral,4,0,4,0
1731505129920,CSE 29,B50,738846,Soosai Raj; Adalbert Geral,0,0,5,5
1731505129920,CSE 29,B51,738847,Soosai Raj; Adalbert Geral,0,0,5,5
1731505129920,CSE 29,B52,738848,Soosai Raj; Adalbert Geral,1,0,5,4
1731505129920,CSE 29,B53,738849,Soosai Raj; Adalbert Geral,3,0,4,1
1731505130947,CSE 30,A01,788669,Chin; Bryan W.,42,0,50,8
1731505131978,CSE 87,A00,738901,Moshiri; Niema,19,0,20,1
1731505131978,CSE 87,B00,739036,Cottrell; Garrison W,20,0,20,0
1731505133012,CSE 95,A00,739094,Minnes Kemp; Mor Mia,100,0,100,0
1731505134043,CSE 100,A01,788682,Moshiri; Niema,21,0,50,29
1731505135125,CSE 100R,A01,739414,Moshiri; Niema,25,0,50,25
1731505136153,CSE 101,A01,788685,Saha; Barna,0,0,20,20
1731505136153,CSE 101,B01,788713,Saha; Barna,0,0,20,20
1731505137179,CSE 105,A01,786574,Minnes Kemp; Mor Mia,113,0,150,37
1731505138206,CSE 107,A01,786529,Heninger; Nadia A,136,0,146,10
1731505139233,CSE 110,A50,739705,Griswold; William G.,58,0,75,17
1731505139233,CSE 110,A51,739706,Griswold; William G.,74,0,75,1
1731505139233,CSE 110,A52,739707,Griswold; William G.,70,0,75,5
1731505140259,CSE 120,A01,786531,Pasquale; Joseph,88,0,146,58
1731505141289,CSE 122,A01,739739,Pannuto; Patrick William,0,0,25,25
1731505142321,CSE 127,A01,788718,Munyaka; Imani N. S.,174,0,192,18
1731505143352,CSE 130,A01,788720,Jhala; Ranjit,172,0,192,20
1731505144383,CSE 132A,A01,788721,Vianu; Victor Dan,163,0,196,33
1731505145412,CSE 134B,A01,788723,Powell; Thomas Allan,172,0,192,20
1731505146438,CSE 140,A01,786577,Rosing; Tajana Simunic,274,0,300,26
1731505147468,CSE 140L,A01,739761,Eldon; John,148,0,196,48
1731505148497,CSE 142,A01,788724,Swanson; Steven James,179,0,196,17
1731505149526,CSE 147,A00,739766,Rosing; Tajana Simunic,0,0,60,60
1731505150554,CSE 148,A01,785688,Tullsen; Dean Michael,13,0,20,7
1731505151580,CSE 150A,A01,788727,Solares; Edwin A,182,0,196,14
1731505152607,CSE 151A,A01,788728,Shang; Jingbo,171,0,250,79
1731505153638,CSE 151B,A01,787804,Cottrell; Garrison W,163,0,192,29
1731505154669,CSE 152A,A01,788729,Chandraker; Manmohan Krishna,163,0,192,29
1731505155703,CSE 156,A01,786532,Qin; Lianhui,133,0,146,13
1731505156732,CSE 160,A01,788730,Kastner; Ryan Charles,195,0,250,55
1731505157766,CSE 167,A01,788731,Chern; Albert Ren-Haur,176,0,192,16
1731505158799,CSE 169,A01,785224,Rotenberg; Steven Paul,0,0,0,0
1731505159826,CSE 181,A01,770733,Pevzner; Pavel Arkadjevich,31,0,35,4
1731505160867,CSE 190,A00,739790,Bandeira; Nuno Filipe Cabrita,45,0,50,5
1731505160867,CSE 190,B00,739791,Shalev; Aaron D,43,0,50,7
1731505160867,CSE 190,C00,739821,Ousterhout; Amy,36,0,50,14
1731505160867,CSE 190,D00,739834,McAuley; Julian John,189,0,196,7
1731505161893,CSE 191,A00,739839,Minnes Kemp; Mor Mia,9999,0,9999,0
1731505162917,CSE 197,001,799832,Minnes Kemp; Mor Mia,9999,0,9999,0
1731505163945,CSE 202,A00,739848,Impagliazzo; Russell,0,0,0,0
1731505164970,CSE 203B,A01,788732,Cheng; Chung Kuan,0,0,0,0
1731505166004,CSE 207A,A00,739858,Bellare; Mihir,0,0,0,0
1731505167029,CSE 209A,A00,739859,Grier; Daniel T,0,0,0,0
1731505168060,CSE 210,A00,739873,Coblenz; Michael J,0,0,0,0
1731505169089,CSE 219,A00,739901,Vaccaro; Kristen Marie,0,0,0,0
1731505170116,CSE 220,A01,796042,Staff,0,0,0,0
1731505171144,CSE 222C,A01,739906,Pannuto; Patrick William,0,0,0,0
1731505172171,CSE 227,A00,739923,Kumar; Deepak,0,0,0,0
1731505173199,CSE 229A,A00,739925,Zhang; Yiying,0,0,0,0
1731505174229,CSE 230,A00,740210,Jhala; Ranjit,0,0,0,0
1731505175255,CSE 232B,A00,740214,Deutsch; Alin Bernard,0,0,0,0
1731505176282,CSE 234,A01,788733,Zhang; Hao,0,0,0,0
1731505177312,CSE 237A,A00,740218,Rosing; Tajana Simunic,0,0,0,0
1731505178338,CSE 239A,A00,740222,Deutsch; Alin Bernard,0,0,0,0
1731505179364,CSE 240A,A00,740228,Tullsen; Dean Michael,0,0,0,0
1731505180392,CSE 240B,A00,740234,Zhao; Jishen,0,0,0,0
1731505181420,CSE 244A,A00,740240,Orailoglu; Alex,0,0,0,0
1731505182447,CSE 251A,A01,788735,Berg-Kirkpatrick; Taylor D,0,0,0,0
1731505183473,CSE 251B,A01,787805,Cottrell; Garrison W,0,0,0,0
1731505184500,CSE 251C,A01,785687,Dasgupta; Sanjoy,0,0,0,0
1731505185526,CSE 252A,A00,740250,Ochoa; Benjamin Lawrence,0,0,0,0
1731505186552,CSE 257,A01,788739,Gao; Sicun,0,0,0,0
1731505187579,CSE 272,A00,740254,Li; Tzumao,0,0,0,0
1731505188606,CSE 280A,A00,740297,Bafna; Vineet,0,0,0,0
1731505189633,CSE 282,A00,740308,Pevzner; Pavel Arkadjevich,0,0,0,0
1731505190663,CSE 290,A00,740312,Chandraker; Manmohan Krishna,0,0,0,0
1731505190663,CSE 290,C00,740327,Christensen; Henrik I,0,0,0,0
1731505190663,CSE 290,D00,740402,Pevzner; Pavel Arkadjevich,0,0,0,0
1731505190663,CSE 290,E00,740403,Munyaka; Imani N. S.,0,0,0,0
1731505190663,CSE 290,G00,740411,Qin; Lianhui,0,0,0,0
1731505190663,CSE 290,H00,740413,Shalev; Aaron D,0,0,0,0
1731505190663,CSE 290,I00,796145,Lovett; Shachar,0,0,0,0
1731505190663,CSE 290,J00,796174,Yu; Qi,0,0,0,0
1731505190663,CSE 290,B00,740325,Orailoglu; Alex,0,0,0,0
1731505191696,CSE 291,A00,740416,Liu; Qipeng,0,0,0,0
1731505191696,CSE 291,B00,740420,Pasquale; Joseph,0,0,0,0
1731505191696,CSE 291,C00,740421,Savage; Stefan & Voelker; Geoffrey M.,0,0,0,0
1731505191696,CSE 291,D00,740441,Ding; Yufei,0,0,0,0
1731505191696,CSE 291,E00,740442,Vaccaro; Kristen Marie,0,0,0,0
1731505191696,CSE 291,F00,740443,Fernandes; Earlence T,0,0,0,0
1731505191696,CSE 291,G00,740447,Paturi; Ramamohan,0,0,0,0
1731505191696,CSE 291,H00,740448,Prithviraj; Ammanabrolu,0,0,0,0
1731505191696,CSE 291,I00,740468,Zhang; Yiying,0,0,0,0
1731505191696,CSE 291,J00,740469,McAuley; Julian John,0,0,0,0
1731505192739,CSE 293,001,796628,Bafna; Vineet,9999,0,9999,0
1731505192739,CSE 293,002,796638,Bellare; Mihir,9999,0,9999,0
1731505192739,CSE 293,003,796645,Berg-Kirkpatrick; Taylor D,9999,0,9999,0
1731505192739,CSE 293,004,796646,Chandraker; Manmohan Krishna,9999,0,9999,0
1731505192739,CSE 293,005,796647,Cheng; Chung Kuan,9999,0,9999,0
1731505192739,CSE 293,006,796648,Christensen; Henrik I,9998,0,9999,1
1731505192739,CSE 293,007,796649,Coblenz; Michael J,9999,0,9999,0
1731505192739,CSE 293,008,796650,Cottrell; Garrison W,9999,0,9999,0
1731505192739,CSE 293,009,796651,Deutsch; Alin Bernard,9999,0,9999,0
1731505192739,CSE 293,010,796652,Esmaeilzadeh; Hadi,9999,0,9999,0
1731505192739,CSE 293,011,796653,Freund; Yoav,9999,0,9999,0
1731505192739,CSE 293,012,796654,Griswold; William G.,9999,0,9999,0
1731505192739,CSE 293,013,796655,Gymrek; Melissa Ann,9999,0,9999,0
1731505192739,CSE 293,014,796656,Heninger; Nadia A,9999,0,9999,0
1731505192739,CSE 293,015,796657,Impagliazzo; Russell,9999,0,9999,0
1731505192739,CSE 293,016,796658,Jhala; Ranjit,9999,0,9999,0
1731505192739,CSE 293,017,796659,Kahng; Andrew Byun,9999,0,9999,0
1731505192739,CSE 293,018,796660,Kane; Daniel Mertz,9999,0,9999,0
1731505192739,CSE 293,019,796661,Kriegman; David J,9999,0,9999,0
1731505192739,CSE 293,020,796662,Kumar; Arun Kumar,9999,0,9999,0
1731505192739,CSE 293,021,796663,Lerner; Sorin,9999,0,9999,0
1731505192739,CSE 293,022,796664,Lovett; Shachar,9999,0,9999,0
1731505192739,CSE 293,023,796665,McAuley; Julian John,9998,0,9999,1
1731505192739,CSE 293,024,796666,Micciancio; Daniele,9999,0,9999,0
1731505192739,CSE 293,025,796667,Orailoglu; Alex,9999,0,9999,0
1731505192739,CSE 293,026,796668,Pannuto; Patrick William,9999,0,9999,0
1731505192739,CSE 293,027,796669,Paturi; Ramamohan,9999,0,9999,0
1731505192739,CSE 293,028,796670,Polikarpova; Nadezhda,9999,0,9999,0
1731505192739,CSE 293,029,796671,Politz; Joseph Gibbs,9999,0,9999,0
1731505192739,CSE 293,030,796672,Porter; George M,9998,0,9999,1
1731505192739,CSE 293,031,796673,Porter; Leonard Emerson,9999,0,9999,0
1731505192739,CSE 293,032,796674,Ramamoorthi; Ravi,9999,0,9999,0
1731505192739,CSE 293,033,796675,Riek; Laurel D,9999,0,9999,0
1731505192739,CSE 293,034,796676,Sahoo; Debashis,9999,0,9999,0
1731505192739,CSE 293,035,796677,Saul; Lawrence,9999,0,9999,0
1731505192739,CSE 293,036,796678,Savage; Stefan,9999,0,9999,0
1731505192739,CSE 293,037,796679,Schulze; Jurgen P.,9999,0,9999,0
1731505192739,CSE 293,038,796680,Snoeren; Alex C.,9999,0,9999,0
1731505192739,CSE 293,039,796681,Shang; Jingbo,9997,0,9999,2
1731505192739,CSE 293,040,796682,Stefan; Deian,9999,0,9999,0
1731505192739,CSE 293,041,796683,Su; Hao,9999,0,9999,0
1731505192739,CSE 293,042,796684,Swanson; Steven James,9999,0,9999,0
1731505192739,CSE 293,043,796685,Tullsen; Dean Michael,9999,0,9999,0
1731505192739,CSE 293,044,796686,Vaccaro; Kristen Marie,9999,0,9999,0
1731505192739,CSE 293,045,796687,Voelker; Geoffrey M.,9999,0,9999,0
1731505192739,CSE 293,046,796688,Zhao; Jishen,9999,0,9999,0
1731505192739,CSE 293,047,796689,Zhou; Yuan-Yuan,9999,0,9999,0
1731505192739,CSE 293,048,796690,Gao; Sicun,9999,0,9999,0
1731505192739,CSE 293,049,796691,Weibel; Nadir,9998,0,9999,1
1731505192739,CSE 293,050,796692,Gupta; Rajesh K.,9999,0,9999,0
1731505192739,CSE 293,051,796693,Soosai Raj; Adalbert Geral,9999,0,9999,0
1731505192739,CSE 293,052,800753,Wang; Xiaolong,9999,0,9999,0
1731505193766,CSE 294,A00,740471,Snoeren; Alex C.,0,0,0,0
1731505194793,CSS 2,A01,785225,Mignozzetti; Umberto,42,0,45,3
1731505194793,CSS 2,A02,785226,Mignozzetti; Umberto,42,0,45,3
1731505195824,CSS 205,A00,738810,Ahlquist; John S.,4,0,24,20
1731505196848,CSS 209,A00,738811,Mignozzetti; Umberto,17,0,40,23
1731505197878,CSS 296,001,796149,Mignozzetti; Umberto,0,0,0,5
1731505197878,CSS 296,002,796150,Mignozzetti; Umberto,0,0,0,2
1731505197878,CSS 296,003,796157,Leas; Eric Craig,0,0,0,0
1731505197878,CSS 296,004,796158,Okonkwo; Holly,0,0,0,1
1731505197878,CSS 296,005,796159,Fleischer; Jason G,0,0,0,1
1731505197878,CSS 296,006,796162,Creel; Sarah,0,0,0,1
1731505197878,CSS 296,007,796165,Patel; Hemal,0,0,0,1
1731505197878,CSS 296,008,796168,Martin; Isaac,0,0,0,1
1731505197878,CSS 296,009,796169,Styler; William Francis,0,0,0,1
1731505197878,CSS 296,010,796171,Grigoryan; Aram,0,0,0,3
1731505197878,CSS 296,011,796172,Bonjour; Trevor,0,0,0,1
1731505197878,CSS 296,012,796173,Martin; Isaac,0,0,0,0
1731505198905,DDPM 204,A00,742646,Ma; Joseph David,30,0,35,5
1731505199932,DDPM 208,A00,742647,Ma; Joseph David,30,0,35,5
1731505200958,DDPM 213,A00,742648,Cuomo; Raphael Eduardo,30,0,35,5
1731505201990,DERM 296,001,791572,Hightower; George Kimet,9,0,10,1
1731505201990,DERM 296,002,791573,Eichenfield; Dawn Zhang,9,0,10,1
1731505201990,DERM 296,003,791575,Staff,10,0,10,0
1731505203029,DOC 2,A01,741984,Strom; Megan C.,0,0,0,0
1731505203029,DOC 2,A02,741987,Strom; Megan C.,0,0,0,0
1731505203029,DOC 2,A03,741989,Strom; Megan C.,0,0,0,0
1731505203029,DOC 2,A04,741990,Strom; Megan C.,0,0,0,0
1731505203029,DOC 2,A05,741993,Strom; Megan C.,0,0,0,0
1731505203029,DOC 2,A06,741994,Strom; Megan C.,0,0,0,0
1731505203029,DOC 2,A07,741995,Strom; Megan C.,0,0,0,0
1731505203029,DOC 2,A08,741996,Strom; Megan C.,0,0,0,0
1731505203029,DOC 2,A09,741999,Strom; Megan C.,0,0,0,0
1731505203029,DOC 2,A10,742000,Strom; Megan C.,0,0,0,0
1731505203029,DOC 2,A11,742002,Strom; Megan C.,0,0,0,0
1731505203029,DOC 2,A12,742005,Strom; Megan C.,0,0,0,0
1731505203029,DOC 2,A13,742007,Strom; Megan C.,0,0,0,0
1731505203029,DOC 2,A14,742009,Strom; Megan C.,0,0,0,0
1731505203029,DOC 2,A15,742010,Strom; Megan C.,0,0,0,0
1731505203029,DOC 2,A16,742153,Strom; Megan C.,0,0,0,0
1731505203029,DOC 2,B01,742170,Strom; Megan C.,0,0,0,0
1731505203029,DOC 2,B02,742175,Strom; Megan C.,0,0,0,0
1731505203029,DOC 2,B03,742192,Strom; Megan C.,0,0,0,0
1731505203029,DOC 2,B04,742193,Strom; Megan C.,0,0,0,0
1731505203029,DOC 2,B05,742197,Strom; Megan C.,0,0,0,0
1731505203029,DOC 2,B06,742198,Strom; Megan C.,0,0,0,0
1731505203029,DOC 2,B07,742201,Strom; Megan C.,0,0,0,0
1731505203029,DOC 2,B08,742204,Strom; Megan C.,0,0,0,0
1731505203029,DOC 2,B09,742206,Strom; Megan C.,0,0,0,0
1731505203029,DOC 2,B10,742211,Strom; Megan C.,0,0,0,0
1731505203029,DOC 2,B11,742214,Strom; Megan C.,0,0,0,0
1731505203029,DOC 2,B12,742215,Strom; Megan C.,0,0,0,0
1731505203029,DOC 2,B13,742224,Strom; Megan C.,0,0,0,0
1731505203029,DOC 2,B14,742230,Strom; Megan C.,0,0,0,0
1731505203029,DOC 2,B15,742290,Strom; Megan C.,0,0,0,0
1731505203029,DOC 2,B16,742292,Strom; Megan C.,0,0,0,0
1731505203029,DOC 2,C01,742295,Solomon; Amanda Lee Albaniel,0,0,0,0
1731505203029,DOC 2,C02,742296,Solomon; Amanda Lee Albaniel,0,0,0,0
1731505203029,DOC 2,C03,742297,Solomon; Amanda Lee Albaniel,0,0,0,0
1731505203029,DOC 2,C04,742303,Solomon; Amanda Lee Albaniel,0,0,0,0
1731505203029,DOC 2,C05,742304,Solomon; Amanda Lee Albaniel,0,0,0,0
1731505203029,DOC 2,C06,742306,Solomon; Amanda Lee Albaniel,0,0,0,0
1731505203029,DOC 2,C07,742309,Solomon; Amanda Lee Albaniel,0,0,0,0
1731505203029,DOC 2,C08,742310,Solomon; Amanda Lee Albaniel,0,0,0,0
1731505203029,DOC 2,C09,742352,Solomon; Amanda Lee Albaniel,0,0,0,0
1731505203029,DOC 2,C10,742363,Solomon; Amanda Lee Albaniel,0,0,0,0
1731505203029,DOC 2,C11,742372,Solomon; Amanda Lee Albaniel,0,0,0,0
1731505203029,DOC 2,C12,742381,Solomon; Amanda Lee Albaniel,0,0,0,0
1731505203029,DOC 2,C13,742382,Solomon; Amanda Lee Albaniel,0,0,0,0
1731505203029,DOC 2,C14,742383,Solomon; Amanda Lee Albaniel,0,0,0,0
1731505203029,DOC 2,C15,798384,Solomon; Amanda Lee Albaniel,0,0,0,0
1731505203029,DOC 2,C16,798386,Solomon; Amanda Lee Albaniel,0,0,0,0
1731505203029,DOC 2,D01,742489,Villegas; Karen Eliza,0,0,0,0
1731505203029,DOC 2,D02,742493,Villegas; Karen Eliza,0,0,0,0
1731505203029,DOC 2,D03,742551,Villegas; Karen Eliza,0,0,0,0
1731505203029,DOC 2,D04,742552,Villegas; Karen Eliza,0,0,0,0
1731505203029,DOC 2,D05,742553,Villegas; Karen Eliza,0,0,0,0
1731505203029,DOC 2,D06,742556,Villegas; Karen Eliza,0,0,0,0
1731505203029,DOC 2,D07,742559,Villegas; Karen Eliza,0,0,0,0
1731505203029,DOC 2,D08,742560,Villegas; Karen Eliza,0,0,0,0
1731505203029,DOC 2,D09,742608,Villegas; Karen Eliza,0,0,0,0
1731505203029,DOC 2,D10,742635,Villegas; Karen Eliza,0,0,0,0
1731505203029,DOC 2,D11,742636,Villegas; Karen Eliza,0,0,0,0
1731505203029,DOC 2,D12,742637,Villegas; Karen Eliza,0,0,0,0
1731505203029,DOC 2,D13,742638,Villegas; Karen Eliza,0,0,0,0
1731505203029,DOC 2,D14,742639,Villegas; Karen Eliza,0,0,0,0
1731505203029,DOC 2,D15,742640,Villegas; Karen Eliza,0,0,0,0
1731505203029,DOC 2,D16,742641,Villegas; Karen Eliza,0,0,0,0
1731505203029,DOC 2,D17,742642,Villegas; Karen Eliza,0,0,0,0
1731505204058,DOC 100D,A00,742643,Pass; Natalye,25,0,25,0
1731505204058,DOC 100D,B00,742644,Pass; Natalye,24,0,25,1
1731505205093,DSC 10,A01,741312,Tiefenbruck; Janine LoBue,136,0,145,9
1731505205093,DSC 10,B01,741322,Tiefenbruck; Janine LoBue,143,0,145,2
1731505206122,DSC 20,A01,741392,Langlois; Marina,192,0,192,0
1731505206122,DSC 20,B01,741530,Langlois; Marina,192,0,192,0
1731505207150,DSC 30,A01,741532,Liao; Soohyun Nam,70,0,70,0
1731505207150,DSC 30,B01,741538,Liao; Soohyun Nam,69,0,70,1
1731505208176,DSC 40A,A01,741544,Shannon; Kyle Michael,187,0,192,5
1731505209207,DSC 40B,A01,741549,Wang; Yusu,143,0,145,2
1731505210238,DSC 80,A01,741553,Watson-Parris; Duncan,149,0,149,0
1731505211267,DSC 95,A01,741617,Langlois; Marina,35,0,35,0
1731505212297,DSC 96,A00,741618,Quer; Giorgio,39,0,40,1
1731505213338,DSC 100,A01,741627,Salimi; Babak,141,0,145,4
1731505214367,DSC 106,A01,741636,Lau; Samuel Ethan,144,0,146,2
1731505214367,DSC 106,B01,741638,Lau; Samuel Ethan,144,0,146,2
1731505215394,DSC 140A,A01,741642,Eldridge; Justin Matthew,136,0,145,9
1731505215394,DSC 140A,B01,741646,Eldridge; Justin Matthew,143,0,145,2
1731505216420,DSC 140B,A01,741682,Huang; Biwei,137,0,145,8
1731505217452,DSC 148,A01,794521,Shang; Jingbo,122,0,125,3
1731505218486,DSC 170,A01,741684,Zaslavsky; Ilya,28,0,40,12
1731505219518,DSC 180B,A01,741686,Bellur; Umesh,8,0,8,0
1731505219518,DSC 180B,A02,741687,Bellur; Umesh,4,0,4,0
1731505219518,DSC 180B,A03,741688,Bellur; Umesh,8,0,8,0
1731505219518,DSC 180B,A04,741707,Bellur; Umesh,6,0,6,0
1731505219518,DSC 180B,A05,741708,Bellur; Umesh,6,0,6,0
1731505219518,DSC 180B,A06,741709,Bellur; Umesh,8,0,8,0
1731505219518,DSC 180B,A07,741710,Bellur; Umesh,6,0,6,0
1731505219518,DSC 180B,A08,741711,Bellur; Umesh,4,0,4,0
1731505219518,DSC 180B,A09,741712,Bellur; Umesh,10,0,10,0
1731505219518,DSC 180B,A10,741713,Bellur; Umesh,10,0,10,0
1731505219518,DSC 180B,A11,741714,Bellur; Umesh,6,0,6,0
1731505219518,DSC 180B,A12,741715,Bellur; Umesh,4,0,4,0
1731505219518,DSC 180B,A13,741716,Bellur; Umesh,6,0,6,0
1731505219518,DSC 180B,A14,741717,Bellur; Umesh,6,0,6,0
1731505219518,DSC 180B,A15,741718,Bellur; Umesh,8,0,8,0
1731505219518,DSC 180B,A16,741719,Bellur; Umesh,10,0,10,0
1731505219518,DSC 180B,A17,741720,Bellur; Umesh,4,0,4,0
1731505219518,DSC 180B,B01,741724,Bellur; Umesh,8,0,8,0
1731505219518,DSC 180B,B02,741725,Bellur; Umesh,10,0,10,0
1731505219518,DSC 180B,B03,741733,Bellur; Umesh,6,0,6,0
1731505219518,DSC 180B,B04,741734,Bellur; Umesh,6,0,6,0
1731505219518,DSC 180B,B05,741736,Bellur; Umesh,4,0,4,0
1731505219518,DSC 180B,B06,741778,Bellur; Umesh,6,0,6,0
1731505219518,DSC 180B,B07,741780,Bellur; Umesh,8,0,8,0
1731505219518,DSC 180B,B08,741782,Bellur; Umesh,6,0,6,0
1731505219518,DSC 180B,B09,741785,Bellur; Umesh,6,0,6,0
1731505219518,DSC 180B,B10,741786,Bellur; Umesh,6,0,6,0
1731505219518,DSC 180B,B11,741788,Bellur; Umesh,4,0,4,0
1731505219518,DSC 180B,B12,741789,Bellur; Umesh,10,0,10,0
1731505219518,DSC 180B,B13,741791,Bellur; Umesh,6,0,6,0
1731505219518,DSC 180B,B14,741793,Bellur; Umesh,8,0,8,0
1731505219518,DSC 180B,B15,741794,Bellur; Umesh,8,0,8,0
1731505219518,DSC 180B,B16,741797,Bellur; Umesh,8,0,8,0
1731505219518,DSC 180B,B17,741855,Bellur; Umesh,4,0,4,0
1731505219518,DSC 180B,B18,741857,Bellur; Umesh,4,0,4,0
1731505220551,DSC 190,A01,741874,Silberman; Jack,19,0,20,1
1731505220551,DSC 190,B01,741877,Smarr; Benjamin,36,0,40,4
1731505220551,DSC 190,C01,741879,Mishne; Gal,18,0,20,2
1731505221579,DSC 197,001,741880,Eldridge; Justin Matthew,9999,0,9999,0
1731505222612,DSC 202,A00,741881,Gupta; Amarnath,0,0,70,70
1731505223638,DSC 206,A00,741883,Mazumdar; Arya,16,0,100,84
1731505224663,DSC 207R,A01,741885,Staff,77,0,80,3
1731505225687,DSC 208R,A01,741887,Salimi; Babak,36,0,80,44
1731505226714,DSC 211,A00,741888,Wang; Jun-Kun,16,0,70,54
1731505227741,DSC 215R,A01,741890,Staff,77,0,80,3
1731505228771,DSC 240,A00,741892,Wang; Yuxiang,33,0,100,67
1731505229799,DSC 244,A00,741893,Schwartzman; Armin,76,0,90,14
1731505230829,DSC 250,A00,741894,Hu; Zhiting,0,0,90,90
1731505231858,DSC 255R,A01,741898,Dasgupta; Sanjoy,39,0,80,41
1731505232887,DSC 266R,A01,741900,Weibel; Nadir,39,0,60,21
1731505233914,DSC 288R,A01,741902,Bellur; Umesh,38,0,60,22
1731505234952,DSC 291,A00,741904,Smarr; Benjamin,0,0,30,30
1731505234952,DSC 291,B00,741905,Freund; Yoav,47,0,60,13
1731505234952,DSC 291,C00,741906,Belkin; Mikhail,59,0,80,21
1731505234952,DSC 291,D00,741907,Li; Aobo,31,0,40,9
1731505234952,DSC 291,E00,741908,Ma; Yian,39,0,60,21
1731505234952,DSC 291,F00,794449,Jin; Haojian,55,0,60,5
1731505234952,DSC 291,G00,797963,Mishne; Gal,0,0,20,20
1731505234952,DSC 291,H00,797964,Zhang; Hao,32,0,80,48
1731505235979,DSC 293,A00,741911,Ustun; Tevfik Berk,9990,0,9999,9
1731505237004,DSE 201,A00,741279,Deutsch; Alin Bernard,25,0,25,0
1731505238029,DSE 210,A00,741281,Staff,25,0,25,0
1731505239112,DSE 241,A00,741286,Staff,25,0,25,0
1731505240139,DSE 260A,A00,741290,Altintas De Callaf; Ilkay,25,0,25,0
1731505241175,DSGN 1,A01,737377,Meyer; Michael Wayne,47,0,50,3
1731505241175,DSGN 1,A02,737382,Meyer; Michael Wayne,35,0,50,15
1731505242202,DSGN 100,A01,736806,Rill; Bryan,24,0,25,1
1731505242202,DSGN 100,A02,736809,Rill; Bryan,24,0,25,1
1731505242202,DSGN 100,A03,736810,Rill; Bryan,23,0,25,2
1731505242202,DSGN 100,A04,736812,Rill; Bryan,18,0,25,7
1731505243229,DSGN 119,A00,736813,Vaccaro; Kristen Marie,85,0,100,15
1731505244258,DSGN 219,A00,736817,Vaccaro; Kristen Marie,14,0,15,1
1731505245291,ECE 5,A01,744925,Morris; Karcher William,22,0,26,4
1731505245291,ECE 5,A02,744926,Morris; Karcher William,23,0,26,3
1731505245291,ECE 5,A03,744927,Morris; Karcher William,26,0,26,0
1731505245291,ECE 5,A04,744929,Morris; Karcher William,26,0,26,0
1731505246319,ECE 15,A01,744931,Sahay; Rajeev,188,0,192,4
1731505247351,ECE 16,A01,744935,Khoshabeh; Ramsin,25,0,30,5
1731505248381,ECE 25,A50,744939,Morris; Karcher William,26,0,30,4
1731505248381,ECE 25,A51,744940,Morris; Karcher William,29,0,30,1
1731505248381,ECE 25,A52,744941,Morris; Karcher William,27,0,30,3
1731505248381,ECE 25,A53,744942,Morris; Karcher William,28,0,30,2
1731505248381,ECE 25,A54,744944,Morris; Karcher William,30,0,30,0
1731505249408,ECE 35,A50,744954,Schurgers; Curt,27,0,30,3
1731505249408,ECE 35,A51,744955,Schurgers; Curt,30,0,30,0
1731505249408,ECE 35,A52,745033,Schurgers; Curt,30,0,30,0
1731505249408,ECE 35,A53,745037,Schurgers; Curt,25,0,30,5
1731505249408,ECE 35,A54,745046,Schurgers; Curt,30,0,30,0
1731505249408,ECE 35,A55,745047,Schurgers; Curt,30,0,30,0
1731505250439,ECE 45,A01,745170,Heath Jr.; Robert Wendell,90,0,98,8
1731505250439,ECE 45,A02,745252,Heath Jr.; Robert Wendell,94,0,98,4
1731505251465,ECE 65,A50,745256,Baghdadchi; Saharnaz,28,0,30,2
1731505251465,ECE 65,A51,745257,Baghdadchi; Saharnaz,29,0,30,1
1731505251465,ECE 65,A52,745258,Baghdadchi; Saharnaz,26,0,30,4
1731505251465,ECE 65,A53,745259,Baghdadchi; Saharnaz,29,0,30,1
1731505251465,ECE 65,A54,745260,Baghdadchi; Saharnaz,29,0,30,1
1731505251465,ECE 65,A55,745261,Baghdadchi; Saharnaz,29,0,30,1
1731505252491,ECE 101,A01,745263,Gonzalez Prelcic; Nuria,83,0,90,7
1731505252491,ECE 101,A02,745264,Gonzalez Prelcic; Nuria,88,0,90,2
1731505253524,ECE 102,A00,745265,Le; Hanh-Phuc,91,0,100,9
1731505254551,ECE 103,A01,745273,Lo; Yu-Hwa,50,0,60,10
1731505255579,ECE 107,A01,745309,Fullerton; Eric E,93,0,100,7
1731505256610,ECE 109,A01,745315,Poveda Fonseca; Jorge,168,0,180,12
1731505257635,ECE 111,A01,745319,Eldon; John,201,0,220,19
1731505258662,ECE 115,A01,745321,Yip; Michael,22,0,28,6
1731505259689,ECE 121B,A50,745324,Esmaili; Gholamreza,11,0,12,1
1731505259689,ECE 121B,A51,745326,Esmaili; Gholamreza,12,0,12,0
1731505259689,ECE 121B,A52,745327,Esmaili; Gholamreza,9,0,12,3
1731505259689,ECE 121B,A53,745328,Esmaili; Gholamreza,12,0,12,0
1731505260716,ECE 125A,A50,745332,Le; Hanh-Phuc,9,0,12,3
1731505260716,ECE 125A,A51,745333,Le; Hanh-Phuc,11,0,12,1
1731505260716,ECE 125A,A52,745334,Le; Hanh-Phuc,9,0,12,3
1731505260716,ECE 125A,A53,745336,Le; Hanh-Phuc,11,0,12,1
1731505261746,ECE 128B,A00,745337,Esmaili; Gholamreza,70,0,75,5
1731505262773,ECE 135B,A00,745339,Dayeh; Shadi Ahmad,19,0,25,6
1731505263803,ECE 140A,A01,745345,Khoshabeh; Ramsin,0,0,0,0
1731505263803,ECE 140A,A02,745346,Khoshabeh; Ramsin,0,0,0,0
1731505263803,ECE 140A,A03,745347,Khoshabeh; Ramsin,0,0,0,0
1731505263803,ECE 140A,A04,745348,Khoshabeh; Ramsin,0,0,0,0
1731505264834,ECE 141A,A01,745351,Gessner; Richard K.,64,0,75,11
1731505265861,ECE 143,A00,745352,Unpingco; Jose H.,0,0,0,3
1731505266887,ECE 148,A01,745355,Silberman; Jack,22,0,24,2
1731505267917,ECE 158B,A01,745357,Zhang; Xinyu,19,0,25,6
1731505268944,ECE 161B,A00,745361,Nguyen; Truong Quang,62,0,65,3
1731505269972,ECE 172A,A01,745372,Parhi; Rahul,115,0,120,5
1731505271004,ECE 175A,A01,745378,Vasconcelos; Nuno,82,0,90,8
1731505272029,ECE 176,A00,745379,Wang; Xiaolong,158,0,196,38
1731505273059,ECE 181,A01,745381,Antipa; Nicholas A,18,0,25,7
1731505274086,ECE 184,A00,745382,Fainman; Yeshaiahu,10,0,15,5
1731505275113,ECE 191,A00,745387,Zhang; Xinyu,39,0,40,1
1731505276139,ECE 197,001,745394,Mercier; Patrick Philip,9999,0,9999,0
1731505277168,ECE 198,001,745395,Nguyen; Truong Quang,9999,0,9999,0
1731505277168,ECE 198,002,800722,Fullerton; Eric E,9999,0,9999,0
1731505278193,ECE 212BN,A00,745419,Ng; Tse Nga,0,0,0,0
1731505279220,ECE 222B,A00,745501,Lomakin; Vitaliy,0,0,0,0
1731505280246,ECE 226,A00,745504,Koushanfar; Farinaz,0,0,0,0
1731505281273,ECE 230B,A00,745505,Taur; Yuan,0,0,0,0
1731505282302,ECE 238A,A00,745507,Luo; Jian,0,0,0,0
1731505283330,ECE 240B,A00,745510,Rubin; Noah,0,0,0,0
1731505284363,ECE 247B,A00,745512,Wang; Joseph,0,0,0,0
1731505285392,ECE 250,A00,745515,Siegel; Paul H.,0,0,0,0
1731505286421,ECE 251A,A00,745518,Meyer; Florian,0,0,0,0
1731505287448,ECE 257B,A00,745519,Bharadia; Dinesh,0,0,0,0
1731505288475,ECE 258A,A00,745524,Milstein; Laurence B.,0,0,0,0
1731505289513,ECE 260B,A00,745525,Kang; Mingu,0,0,0,0
1731505290540,ECE 264A,A00,745526,Galton; Ian A,0,0,0,0
1731505291568,ECE 265A,A00,745530,Gudem; Prasad S.S.,0,0,0,0
1731505292596,ECE 265D,A00,745531,Gudem; Prasad S.S.,0,0,0,0
1731505293623,ECE 269,A01,745540,Pal; Piya,0,0,0,0
1731505294664,ECE 271B,A00,745541,Vasconcelos; Manuela,0,0,0,0
1731505295691,ECE 276A,A00,745543,Atanasov; Nikolay A.,0,0,0,0
1731505296721,ECE 277,A00,745544,An; Cheolhong,0,0,0,0
1731505297754,ECE 283,A00,745547,Hsueh; Tzu-Chien,0,0,0,0
1731505298785,ECE 285,A00,745548,Zheng; Yang,0,0,0,0
1731505299812,ECE 286,B00,795641,Poveda Fonseca; Jorge,0,0,0,0
1731505300845,ECON 1,A01,742650,Crane; Meredith Helen,143,0,150,7
1731505300845,ECON 1,B01,742652,Crane; Meredith Helen,149,0,150,1
1731505300845,ECON 1,C01,742655,Newhouse; Herbert S,71,0,75,4
1731505300845,ECON 1,C02,742656,Newhouse; Herbert S,75,0,75,0
1731505301872,ECON 2,A01,742660,Crane; Meredith Helen,78,0,78,0
1731505301872,ECON 2,A02,742661,Crane; Meredith Helen,80,0,80,0
1731505302905,ECON 3,A01,742663,Rondina; Giacomo,113,0,125,12
1731505302905,ECON 3,A02,742664,Rondina; Giacomo,125,0,125,0
1731505302905,ECON 3,B01,742667,Rondina; Giacomo,121,0,125,4
1731505302905,ECON 3,B02,742669,Rondina; Giacomo,125,0,125,0
1731505303935,ECON 4,A01,742672,Levkoff; Steven B.,73,0,75,2
1731505303935,ECON 4,A02,742673,Levkoff; Steven B.,71,0,75,4
1731505303935,ECON 4,A03,742674,Levkoff; Steven B.,73,0,75,2
1731505303935,ECON 4,B01,798340,Brooks; Marcus Raymond,2,0,3,1
1731505304964,ECON 5,A01,742676,Dai; Yinlin,51,0,54,3
1731505304964,ECON 5,A02,742677,Dai; Yinlin,53,0,54,1
1731505304964,ECON 5,A03,742678,Dai; Yinlin,51,0,54,3
1731505304964,ECON 5,A04,742679,Dai; Yinlin,54,0,54,0
1731505304964,ECON 5,A05,742680,Dai; Yinlin,54,0,54,0
1731505304964,ECON 5,B01,742682,Dai; Yinlin,53,0,54,1
1731505304964,ECON 5,B02,742684,Dai; Yinlin,52,0,54,2
1731505304964,ECON 5,B03,742686,Dai; Yinlin,53,0,54,1
1731505304964,ECON 5,B04,742687,Dai; Yinlin,50,0,54,4
1731505304964,ECON 5,B05,742723,Dai; Yinlin,51,0,54,3
1731505305997,ECON 86,A00,795622,Muendler; Marc,98,0,100,2
1731505307024,ECON 100A,A01,742728,Grigoryan; Aram,98,0,100,2
1731505307024,ECON 100A,A02,742730,Grigoryan; Aram,94,0,100,6
1731505307024,ECON 100A,A03,742733,Grigoryan; Aram,93,0,100,7
1731505307024,ECON 100A,A04,742735,Grigoryan; Aram,97,0,100,3
1731505308051,ECON 100B,A01,742738,Levkoff; Steven B.,90,0,96,6
1731505308051,ECON 100B,A02,742742,Levkoff; Steven B.,102,0,104,2
1731505308051,ECON 100B,A03,742744,Levkoff; Steven B.,99,0,100,1
1731505308051,ECON 100B,A04,742745,Levkoff; Steven B.,98,0,100,2
1731505309083,ECON 100C,A01,742757,Newhouse; Herbert S,100,0,100,0
1731505309083,ECON 100C,B01,742768,Newhouse; Herbert S,92,0,100,8
1731505310112,ECON 102,A01,742785,Muendler; Marc,109,0,120,11
1731505311138,ECON 105,A00,742834,Vespa; Emanuel Ignacio,97,0,100,3
1731505312166,ECON 109,A01,742838,Watson; Joel Christopher,107,0,120,13
1731505312166,ECON 109,A02,742841,Watson; Joel Christopher,118,0,120,2
1731505312166,ECON 109,A03,742843,Watson; Joel Christopher,0,0,0,0
1731505313195,ECON 109T,A00,742844,Watson; Joel Christopher,18,0,20,2
1731505314226,ECON 110A,A01,742847,Jaimovich; Nir,95,0,100,5
1731505314226,ECON 110A,B01,742852,Jaimovich; Nir,99,0,100,1
1731505315255,ECON 110B,A01,742854,Hamilton; James D.,93,0,98,5
1731505315255,ECON 110B,A02,742858,Hamilton; James D.,98,0,98,0
1731505315255,ECON 110B,B01,742861,Hamilton; James D.,90,0,98,8
1731505315255,ECON 110B,B02,742863,Hamilton; James D.,98,0,98,0
1731505316281,ECON 110BH,A00,742865,Hamilton; James D.,20,0,20,0
1731505317313,ECON 116,A00,742866,Lowes; Sara Rachel,69,0,70,1
1731505317313,ECON 116,B00,742868,Lowes; Sara Rachel,43,0,44,1
1731505318351,ECON 120A,A01,742871,Idoux; Clemence Marie,97,0,100,3
1731505318351,ECON 120A,B01,742873,Candido; Maria Teresa,91,0,95,4
1731505318351,ECON 120A,B02,742877,Candido; Maria Teresa,88,0,90,2
1731505318351,ECON 120A,C01,742879,Candido; Maria Teresa,109,0,115,6
1731505319378,ECON 120B,A01,742884,Berman; Eli,26,0,30,4
1731505319378,ECON 120B,B01,742889,Dahl; Gordon B.,18,0,30,12
1731505319378,ECON 120B,C01,742892,Dahl; Gordon B.,109,0,120,11
1731505319378,ECON 120B,C02,742893,Dahl; Gordon B.,116,0,120,4
1731505320404,ECON 120BH,A00,742895,Dahl; Gordon B.,20,0,20,0
1731505321430,ECON 120C,A01,742902,Candido; Maria Teresa,66,0,70,4
1731505321430,ECON 120C,A02,742905,Candido; Maria Teresa,69,0,70,1
1731505322457,ECON 138,A00,742908,Bharadwaj; Prashant,188,0,200,12
1731505323484,ECON 145,A00,742909,Squires; Dale E,144,0,150,6
1731505324512,ECON 149,A00,742910,Grigoryan; Aram,98,0,100,2
1731505325539,ECON 175,A00,742911,Wu; Pak Yeung,44,0,50,6
1731505325539,ECON 175,B00,742912,Wu; Pak Yeung,42,0,44,2
1731505326565,ECON 178,A01,742915,Zhu; Ying,48,0,60,12
1731505327591,ECON 181,A00,742916,Staff,99,0,100,1
1731505328621,ECON 185,A01,742919,Bharadwaj; Prashant,13,0,18,5
1731505329650,ECON 186,A00,742966,Ross; Stephen Geoffrey,92,0,100,8
1731505330678,ECON 190,A00,742967,Vespa; Emanuel Ignacio,47,0,50,3
1731505330678,ECON 190,B00,742968,Vespa; Emanuel Ignacio,50,0,50,0
1731505331706,ECON 200B,A00,742971,Watson; Joel Christopher,33,0,35,2
1731505332733,ECON 208,A00,742972,Vespa; Emanuel Ignacio & Watson; Joel Christopher,17,0,20,3
1731505333759,ECON 210B,A00,742979,Rondina; Giacomo,34,0,35,1
1731505334791,ECON 220B,A00,743008,Ma; Xinwei,32,0,35,3
1731505335820,ECON 220E,A00,743012,Ma; Xinwei,24,0,30,6
1731505336848,ECON 231,A00,743013,Cullen; Julie,8,0,12,4
1731505337880,ECON 237,A00,743015,Lowes; Sara Rachel & Bazzi; Samuel A,16,0,20,4
1731505338909,ECON 250B,A00,743043,Dahl; Gordon B.,24,0,25,1
1731505339938,ECON 267,A00,743122,Graff Zivin; Joshua,21,0,25,4
1731505340964,ECON 284,A00,743123,Niehaus; Paul,21,0,25,4
1731505341993,ECON 286,A00,743124,Wu; Pak Yeung,19,0,20,1
1731505343076,EDS 23,A01,743187,Staff,0,0,0,0
1731505343076,EDS 23,B01,743239,Staff,0,0,0,0
1731505344102,EDS 39,A01,743242,Heinzman; Erica M.,24,0,25,1
1731505345130,EDS 103,A01,743244,Halter; Christopher P.,33,0,35,2
1731505346159,EDS 111,A00,743245,Staff,58,0,60,2
1731505347185,EDS 112,A01,743247,Chapman; Thandeka K,22,0,30,8
1731505347185,EDS 112,A02,743248,Chapman; Thandeka K,30,0,30,0
1731505348212,EDS 114,A01,743280,Eguchi; Emi,17,0,18,1
1731505348212,EDS 114,A02,743307,Eguchi; Emi,17,0,17,0
1731505349238,EDS 115,A00,743316,Mamas; Christoforos,52,0,60,8
1731505350266,EDS 117,A01,743398,Jones; Gabrielle Anastasia,20,0,23,3
1731505350266,EDS 117,A02,743402,Jones; Gabrielle Anastasia,23,0,23,0
1731505350266,EDS 117,A03,743403,Jones; Gabrielle Anastasia,22,0,22,0
1731505350266,EDS 117,A04,743404,Jones; Gabrielle Anastasia,22,0,22,0
1731505350266,EDS 117,B01,743428,Aragon; Maria Jose,23,0,25,2
1731505350266,EDS 117,B02,743429,Aragon; Maria Jose,25,0,25,0
1731505351292,EDS 122,A00,743489,Brydges; Stacey,10,0,10,0
1731505352324,EDS 124AR,A00,743510,Simon; Elizabeth A,86,0,100,14
1731505352324,EDS 124AR,B00,743511,Simon; Elizabeth A,195,0,200,5
1731505352324,EDS 124AR,C00,794870,Simon; Elizabeth A,40,0,40,0
1731505353350,EDS 124BR,A00,743513,Eguchi; Emi,65,0,75,10
1731505353350,EDS 124BR,B00,795833,Eguchi; Emi,25,0,25,0
1731505354376,EDS 125,A00,743515,Jones; Gabrielle Anastasia,49,0,60,11
1731505355407,EDS 126,A01,743522,Jones; Makeba,30,0,33,3
1731505355407,EDS 126,A02,743617,Jones; Makeba,33,0,33,0
1731505355407,EDS 126,A03,743688,Jones; Makeba,34,0,34,0
1731505356435,EDS 128A,A01,743693,Fargason; Sharon Gayle,11,0,15,4
1731505356435,EDS 128A,A02,743694,Fargason; Sharon Gayle,14,0,15,1
1731505356435,EDS 128A,A03,743695,Fargason; Sharon Gayle,18,0,20,2
1731505357463,EDS 129B,A01,743702,Black; Alison Michelle,42,0,45,3
1731505358490,EDS 130,A01,743709,Choi; Bailey Miyeon,17,0,20,3
1731505358490,EDS 130,A02,743710,Choi; Bailey Miyeon,20,0,20,0
1731505358490,EDS 130,A03,743711,Choi; Bailey Miyeon,19,0,20,1
1731505359521,EDS 131,A01,743718,Cohen; Shana R,20,0,20,0
1731505359521,EDS 131,A02,743722,Cohen; Shana R,20,0,20,0
1731505360546,EDS 133,A01,743741,Bintliff; Amy S.V.,23,0,25,2
1731505360546,EDS 133,A02,743748,Bintliff; Amy S.V.,20,0,20,0
1731505361580,EDS 139,A00,743749,Fargason; Sharon Gayle,43,0,50,7
1731505361580,EDS 139,B00,743825,Black; Alison Michelle,41,0,45,4
1731505361580,EDS 139,C00,743847,Choi; Bailey Miyeon,56,0,60,4
1731505361580,EDS 139,D00,743848,Cohen; Shana R,40,0,40,0
1731505361580,EDS 139,E00,743849,Bintliff; Amy S.V.,43,0,45,2
1731505361580,EDS 139,F00,743851,Bintliff; Amy S.V.,19,0,20,1
1731505361580,EDS 139,G00,743853,Hemans; Patricia Ann Benitez,31,0,35,4
1731505361580,EDS 139,H00,743854,Hemans; Patricia Ann Benitez,20,0,20,0
1731505362605,EDS 140,A00,743898,Hemans; Patricia Ann Benitez,30,0,35,5
1731505363632,EDS 146,A01,743953,Hemans; Patricia Ann Benitez,24,0,25,1
1731505363632,EDS 146,A02,794684,Hemans; Patricia Ann Benitez,0,0,0,0
1731505364659,EDS 149,A00,799976,Millstone; Rachel Diana,20,0,20,0
1731505364659,EDS 149,B00,799977,Heinzman; Erica M.,20,0,20,0
1731505365691,EDS 162,A01,797962,Phuong; Andrew,19,0,20,1
1731505366721,EDS 205A,A00,743983,Halter; Christopher P.,33,0,40,7
1731505367747,EDS 205B,A00,744003,Halter; Christopher P.,32,0,45,13
1731505368772,EDS 232,A00,744009,Clarke; Sherice Nicole,14,0,15,1
1731505369800,EDS 256,A00,744012,Mamas; Christoforos,15,0,15,0
1731505370826,EDS 259A,A00,744013,Aragon; Maria Jose,14,0,15,1
1731505371851,EDS 259B,A00,744014,Aragon; Maria Jose,14,0,15,1
1731505372878,EDS 264,A00,744016,Clarke; Sherice Nicole,14,0,15,1
1731505373908,EDS 280,A00,744017,Datnow; Amanda Lee,11,0,18,7
1731505374934,EDS 287A,A00,744018,Daly; Alan J.,9,0,15,6
1731505375958,EDS 287C,A00,744019,Daly; Alan J.,15,0,15,0
1731505376984,EDS 288B,A00,744020,Fine; Sarah,15,0,15,0
1731505378009,EDS 289A,A01,744022,Hofstetter; Carolyn,15,0,15,0
1731505379035,EDS 291A,A01,744024,Daly; Alan J.,9,0,15,6
1731505380061,EDS 293A,A01,744026,Burrell; Sade Renee,15,0,15,0
1731505381087,EDS 294A,A00,744027,Meyerott; Theresa Ann,15,0,15,0
1731505382119,EDS 296,001,773835,Aragon; Maria Jose,10,0,10,0
1731505382119,EDS 296,002,773846,Bintliff; Amy S.V.,10,0,10,0
1731505382119,EDS 296,003,773906,Clarke; Sherice Nicole,10,0,10,0
1731505382119,EDS 296,004,773907,Chapman; Thandeka K,10,0,10,0
1731505382119,EDS 296,005,773910,Cohen; Shana R,10,0,10,0
1731505382119,EDS 296,006,773911,Datnow; Amanda Lee,10,0,10,0
1731505382119,EDS 296,007,773913,Halter; Christopher P.,10,0,10,0
1731505382119,EDS 296,008,773916,Hopkins; Megan Beth,9,0,10,1
1731505382119,EDS 296,009,773922,Jones; Makeba,10,0,10,0
1731505382119,EDS 296,010,773923,Jones; Gabrielle Anastasia,10,0,10,0
1731505382119,EDS 296,011,773924,Daly; Alan J.,10,0,10,0
1731505382119,EDS 296,012,773925,Simon; Elizabeth A,10,0,10,0
1731505382119,EDS 296,013,773933,Eguchi; Emi,10,0,10,0
1731505382119,EDS 296,014,773977,Hofstetter; Carolyn,10,0,10,0
1731505382119,EDS 296,015,800629,Wishard Guerra; Alison G.,10,0,10,0
1731505382119,EDS 296,016,800644,Mamas; Christoforos,10,0,10,0
1731505382119,EDS 296,017,800654,Fine; Sarah,10,0,10,0
1731505382119,EDS 296,018,800656,Pollock; Mica,10,0,10,0
1731505382119,EDS 296,019,800657,Cohen; Shana R,10,0,10,0
1731505383146,EMED 296,001,791584,Staff,10,0,10,0
1731505383146,EMED 296,002,791585,Staff,10,0,10,0
1731505383146,EMED 296,003,791586,Staff,10,0,10,0
1731505384178,ENG 10,A00,741913,Evdokimenko; Ekaterina,59,0,60,1
1731505385204,ENG 100D,A00,741921,Ngo; Anh-Thu T.,36,0,40,4
1731505385204,ENG 100D,B00,794892,Ngo; Anh-Thu T.,38,0,40,2
1731505386254,ENG 100L,A00,741969,Kleissl; Jan,6,0,6,0
1731505386254,ENG 100L,B00,741970,Bratton; Maryann,6,0,6,0
1731505386254,ENG 100L,C00,741972,Yu; Paul K L,8,0,8,0
1731505386254,ENG 100L,D00,741973,Bratton; Maryann,6,0,6,0
1731505386254,ENG 100L,E00,741974,de Oliveira; Mauricio,6,0,6,0
1731505386254,ENG 100L,F00,741975,Bratton; Maryann,6,0,6,0
1731505386254,ENG 100L,G00,741976,Boyle; Mary E. T.,19,0,20,1
1731505386254,ENG 100L,H00,795155,Boyle; Mary E. T.,14,0,15,1
1731505387284,ENVR 102,A00,744170,Staff,25,0,25,0
1731505387284,ENVR 102,C00,744214,Staff,24,0,25,1
1731505388311,ENVR 120,A00,744215,Uyeda; Kellie Ann,13,0,16,3
1731505389338,ENVR 141,A00,744320,Siapno; Jacqueline A,10,0,10,0
1731505389338,ENVR 141,B00,744328,Siapno; Jacqueline A,15,0,15,0
1731505390370,ENVR 144,A01,744490,Herbst; Matthew,10,0,10,0
1731505392425,ERC 20,A00,744169,Evans; Ivan T,39,0,40,1
1731505393450,ESYS 10,A01,799973,Staff,35,0,35,0
1731505393450,ESYS 10,A02,799974,Staff,35,0,35,0
1731505394482,ESYS 102,A01,744506,Haase; Jennifer Susan,29,0,30,1
1731505394482,ESYS 102,A02,744507,Haase; Jennifer Susan,28,0,30,2
1731505394482,ESYS 102,A03,744520,Haase; Jennifer Susan,27,0,30,3
1731505394482,ESYS 102,A04,744534,Haase; Jennifer Susan,29,0,30,1
1731505395508,ESYS 187B,A01,744536,Hetherington; Elizabeth Dorsey,42,0,45,3
1731505395508,ESYS 187B,B01,794869,Hetherington; Elizabeth Dorsey,41,0,45,4
1731505396536,ETHN 2R,A01,744558,Perreira; Christopher Michael,21,0,25,4
1731505396536,ETHN 2R,A02,744559,Perreira; Christopher Michael,24,0,25,1
1731505396536,ETHN 2R,A03,744560,Perreira; Christopher Michael,22,0,25,3
1731505396536,ETHN 2R,A04,744561,Perreira; Christopher Michael,25,0,25,0
1731505396536,ETHN 2R,A05,744562,Perreira; Christopher Michael,25,0,25,0
1731505396536,ETHN 2R,A06,744563,Perreira; Christopher Michael,24,0,25,1
1731505396536,ETHN 2R,A07,744639,Perreira; Christopher Michael,24,0,25,1
1731505396536,ETHN 2R,A08,744644,Perreira; Christopher Michael,21,0,25,4
1731505396536,ETHN 2R,A09,744646,Perreira; Christopher Michael,24,0,25,1
1731505396536,ETHN 2R,A10,744651,Perreira; Christopher Michael,25,0,25,0
1731505396536,ETHN 2R,A11,744657,Perreira; Christopher Michael,25,0,25,0
1731505396536,ETHN 2R,A12,744664,Perreira; Christopher Michael,25,0,25,0
1731505396536,ETHN 2R,A13,744665,Perreira; Christopher Michael,24,0,25,1
1731505396536,ETHN 2R,A14,744673,Perreira; Christopher Michael,24,0,25,1
1731505396536,ETHN 2R,A15,744749,Perreira; Christopher Michael,24,0,25,1
1731505396536,ETHN 2R,A16,744751,Perreira; Christopher Michael,23,0,25,2
1731505397564,ETHN 100B,A00,744761,Streeby; Shelley,29,0,32,3
1731505398589,ETHN 100H,A00,744765,Frank; Ross H.,0,0,0,0
1731505399616,ETHN 101TV,A01,744838,Marez; Curtis F.,21,0,23,2
1731505399616,ETHN 101TV,A02,744842,Marez; Curtis F.,23,0,23,0
1731505399616,ETHN 101TV,A03,796142,Marez; Curtis F.,23,0,23,0
1731505399616,ETHN 101TV,A04,796143,Marez; Curtis F.,22,0,23,1
1731505400643,ETHN 102,A00,744846,Okonkwo; Holly,38,0,40,2
1731505401669,ETHN 112B,A00,744847,Klann; Mary Cameron,22,0,30,8
1731505402699,ETHN 119,A00,744849,Fuste; Jose Ignacio,31,0,35,4
1731505403724,ETHN 122,A00,744853,Tran; Ly Thi Hai,32,0,35,3
1731505404752,ETHN 125R,A00,744875,Sasaki; Christen T,31,0,50,19
1731505405784,ETHN 133,A00,744880,Power; Jade Yukana,3,0,5,2
1731505406810,ETHN 134,A00,744905,Gosin; Monika N.,19,0,20,1
1731505407835,ETHN 137,A00,744906,Martin Sandino; Amanda Maria Yoland,19,0,20,1
1731505408861,ETHN 138,A00,744907,Gosin; Monika N.,35,0,35,0
1731505409889,ETHN 139,A00,744908,Ruiz; Ariana,20,0,20,0
1731505410915,ETHN 143,A00,744909,Marez; Curtis F.,29,0,30,1
1731505411945,ETHN 163F,A00,744911,Burelle; Julie Sara Veronique,15,0,15,0
1731505412974,ETHN 165,A00,744912,Browne; Errol Tsekani,11,0,15,4
1731505414003,ETHN 167A,A00,744913,Patel; Shaista,11,0,12,1
1731505415029,ETHN 174,A00,744915,Childs; Dennis R.,20,0,20,0
1731505416061,ETHN 179,A00,744916,Dresser; Mark Stuart,24,0,25,1
1731505417094,ETHN 187,A00,744917,Cuong; Marisol,15,0,15,0
1731505418125,ETHN 200B,A00,744918,Patel; Shaista,11,0,15,4
1731505419156,ETHN 230,A00,744919,Perreira; Christopher Michael,10,0,15,5
1731505420183,ETHN 268,A00,744920,Fuste; Jose Ignacio,4,0,10,6
1731505421213,ETIM 289,A00,744923,Sasaki; Christen T,11,0,15,4
1731505422237,EXPR 100,A00,794937,Staff,9999,0,9999,0
1731505423263,EXPR 105,A00,794941,Staff,9999,0,9999,0
1731505424289,EXPR 201,A00,794944,Staff,9999,0,9999,0
1731505425317,EXPR 205,A00,794948,Staff,9999,0,9999,0
1731505426346,FILM 87,A00,745666,Rahimi; Babak,20,0,20,0
1731505426346,FILM 87,B00,745671,Rahimi; Babak,19,0,20,1
1731505426346,FILM 87,C00,745673,Adler; Steven,20,0,20,0
1731505427372,FMPH 277,A00,745558,Gilmer; Todd,9,0,15,6
1731505428401,FMPH 291,A00,745561,Silverstein; Donna K & Wynn; Adriane Michelle,9,0,15,6
1731505429431,FPM 278,A00,745585,Strong; David R,10,0,15,5
1731505430462,FPM 286,A00,791598,Johnson; Michelle Lee,120,0,120,0
1731505431490,FPM 288,A00,799968,Hurst; Samantha,4,0,5,1
1731505432518,FPM 296,001,791599,Allison; Matthew,8,0,10,2
1731505432518,FPM 296,002,791600,Staff,10,0,10,0
1731505432518,FPM 296,003,791601,Staff,10,0,10,0
1731505433544,FPM 297,001,745665,Strong; David R,99,0,99,0
1731505434574,GLBH 20,A00,745680,Walkover; Lillian B,146,0,146,0
1731505435600,GLBH 100,A00,745702,Staff,40,0,40,0
1731505435600,GLBH 100,B00,745703,Schonberg; Jeffrey,40,0,40,0
1731505436627,GLBH 109,A00,745704,Olivas Hernandez; Olga Lid,47,0,48,1
1731505437653,GLBH 111,A01,745712,Burgos; Jose L.,0,0,0,0
1731505437653,GLBH 111,B01,745771,Burgos; Jose L.,0,0,0,0
1731505438680,GLBH 113,A00,745821,Wilson; Brenda K,63,0,70,7
1731505439706,GLBH 139,A00,745834,Csordas; Thomas J.,19,0,20,1
1731505440736,GLBH 141,A00,745835,Sanghvi; Reema I,6,0,11,5
1731505441763,GLBH 146,A00,745836,Kang; Byung Chu,68,0,70,2
1731505442793,GLBH 148,A00,745837,Schonberg; Jeffrey,90,0,100,10
1731505443826,GLBH 150,A00,745838,Sloane; Julia Kathryn,35,0,35,0
1731505444852,GLBH 150A,A00,745839,Kaiser; Bronwyn Nicole,0,0,0,0
1731505445878,GLBH 160,A00,745840,Mackey; Timothy Ken,61,0,68,7
1731505446909,GLBH 171R,A00,745841,Jenkins; Janis A.,17,0,25,8
1731505446909,GLBH 171R,B00,795776,Jenkins; Janis A.,15,0,15,0
1731505447935,GLBH 181,A00,745842,Burgos; Jose L.,213,0,216,3
1731505448962,GLBH 214,A00,745843,Bhavsar; Radhika,4,0,19,15
1731505449992,GLBH 241,A00,745877,Sanghvi; Reema I,7,0,21,14
1731505451019,GLBH 249,A00,745948,Villarino; Margarita,5,0,20,15
1731505452051,GPEC 244,A00,765594,Levy; Morgan,20,0,20,0
1731505453082,GSS 22,A00,746032,Kokinis; Troy Andreas,26,0,30,4
1731505454107,GSS 27,A00,746039,Siapno; Jacqueline A,27,0,30,3
1731505455134,HDS 60,A01,747848,Warstadt; Melissa Fawn,34,0,35,1
1731505455134,HDS 60,A02,747849,Warstadt; Melissa Fawn,34,0,35,1
1731505456163,HDS 95,A00,747852,Staff,31,0,35,4
1731505457194,HDS 110,A00,747853,Wilder; Linnea Lorene,93,0,100,7
1731505458224,HDS 133,A00,747854,Stewart; Alexander B,86,0,100,14
1731505459252,HDS 150,A00,747856,Warstadt; Melissa Fawn,20,0,20,0
1731505460279,HDS 175,A00,747859,Bjorklund; Peter,35,0,35,0
1731505461312,HDS 181,A01,747863,Delgado; Tania,30,0,30,0
1731505462340,HDS 191,A01,747865,Reese; Clarissa Jane,20,0,20,0
1731505462340,HDS 191,B01,747867,Reese; Clarissa Jane,20,0,20,0
1731505463372,HIAF 113,A00,747574,Prestholdt; Jeremy,74,0,75,1
1731505464401,HIAF 114,A00,747576,Gyamfi; Bright,55,0,56,1
1731505465428,HIEA 140R,A00,747577,Gerth; Karl G.,23,0,30,7
1731505466455,HIEA 150,A00,747578,Henry; Todd A.,54,0,56,2
1731505467480,HIEU 103,A00,747579,Watts; Edward J.,108,0,115,7
1731505468511,HIEU 116B,A00,795104,Gallant; Thomas W.,50,0,50,0
1731505469537,HIEU 123,A00,747580,Demetriou; Denise,47,0,50,3
1731505470568,HIEU 147,A00,747616,Biess; Frank Peter,96,0,100,4
1731505471594,HIEU 149,A00,747617,Devereux; Andrew W,49,0,50,1
1731505472619,HIGR 203,A00,747836,Edington; Claire Ellen,4,0,5,1
1731505473646,HIGR 215B,A00,747837,Muscolino; Micah S,10,0,10,0
1731505474683,HIGR 217B,A00,747838,Schneewind; Sarah,15,0,15,0
1731505475709,HIGR 240,A00,747842,McKenzie; Kerry V.,4,0,5,1
1731505476738,HIGR 241,A00,747843,Lampland; Martha,5,0,5,0
1731505477767,HILA 100,A00,747621,Murillo; Dana V.,50,0,50,0
1731505478799,HILA 102,A00,747623,Cowan; Benjamin A,55,0,56,1
1731505479828,HILA 121B,A00,747633,Cowan; Benjamin A,56,0,56,0
1731505480854,HILA 167,A00,794866,Murillo; Dana V.,0,0,0,0
1731505481880,HILA 267,A00,794867,Murillo; Dana V.,12,0,15,3
1731505482913,HILD 2B,A01,746966,Plant; Rebecca Jo,27,0,32,5
1731505482913,HILD 2B,A02,746988,Plant; Rebecca Jo,30,0,32,2
1731505482913,HILD 2B,A03,747023,Plant; Rebecca Jo,32,0,32,0
1731505482913,HILD 2B,A04,747029,Plant; Rebecca Jo,32,0,32,0
1731505482913,HILD 2B,A05,747030,Plant; Rebecca Jo,31,0,32,1
1731505482913,HILD 2B,A06,747031,Plant; Rebecca Jo,32,0,32,0
1731505483947,HILD 7A,A01,747252,Graham; Jessica Lynn,30,0,32,2
1731505483947,HILD 7A,A02,747337,Graham; Jessica Lynn,30,0,32,2
1731505483947,HILD 7A,A03,747338,Graham; Jessica Lynn,32,0,32,0
1731505483947,HILD 7A,A04,747352,Graham; Jessica Lynn,30,0,32,2
1731505483947,HILD 7A,A05,747375,Graham; Jessica Lynn,30,0,32,2
1731505483947,HILD 7A,A06,747385,Graham; Jessica Lynn,29,0,32,3
1731505483947,HILD 7A,A07,747442,Graham; Jessica Lynn,32,0,32,0
1731505483947,HILD 7A,A08,747444,Graham; Jessica Lynn,32,0,32,0
1731505483947,HILD 7A,A09,747447,Graham; Jessica Lynn,32,0,32,0
1731505483947,HILD 7A,A10,747449,Graham; Jessica Lynn,32,0,32,0
1731505483947,HILD 7A,A11,747450,Graham; Jessica Lynn,32,0,32,0
1731505483947,HILD 7A,A12,747487,Graham; Jessica Lynn,32,0,32,0
1731505484973,HILD 11,A01,747512,Lu; Weijing,30,0,32,2
1731505484973,HILD 11,A02,747513,Lu; Weijing,32,0,32,0
1731505484973,HILD 11,A03,747538,Lu; Weijing,32,0,32,0
1731505484973,HILD 11,A04,747546,Lu; Weijing,32,0,32,0
1731505484973,HILD 11,A05,747558,Lu; Weijing,32,0,32,0
1731505484973,HILD 11,A06,747559,Lu; Weijing,32,0,32,0
1731505486002,HILD 41,A01,747562,Devereux; Andrew W,32,0,32,0
1731505486002,HILD 41,A02,747563,Devereux; Andrew W,32,0,32,0
1731505487028,HINE 109,A00,799584,Staff,0,0,0,0
1731505488053,HINE 118,A00,799585,Staff,0,0,0,0
1731505489084,HINE 125,A00,747822,Balberg; Mira,48,0,50,2
1731505490110,HINE 186,A00,794522,Hertz; Deborah & Kayali; Hasan,15,0,15,0
1731505491137,HISA 144,A00,794454,De; Aniket,48,0,50,2
1731505492164,HISC 109,A00,747823,Edington; Claire Ellen,44,0,50,6
1731505493191,HISC 115,A00,747824,Gere; Catherina M.,118,0,120,2
1731505494221,HISC 180,A00,747825,Golan; Tal,15,0,15,0
1731505495255,HITO 87,A00,747567,Hanna; Mark G.,15,0,15,0
1731505495255,HITO 87,B00,747569,Patterson; Patrick H.,14,0,15,1
1731505495255,HITO 87,C00,747570,Patterson; Patrick H.,15,0,15,0
1731505495255,HITO 87,D00,747571,Edington; Claire Ellen,14,0,15,1
1731505495255,HITO 87,E00,747573,Schneewind; Sarah,15,0,15,0
1731505496285,HITO 100,B00,747827,Strasser; Ulrike,20,0,22,2
1731505497310,HITO 133,A00,747828,Hansen; Jan Eric,54,0,56,2
1731505498334,HITO 178,A00,747829,Hanna; Mark G.,19,0,20,1
1731505499360,HITO 193,A00,770732,Hill; Seth J,9999,0,9999,0
1731505500388,HIUS 108B,A00,794492,Daly; Heather Marie,34,0,40,6
1731505501414,HIUS 133,A00,747831,Hanna; Mark G.,136,0,146,10
1731505502445,HIUS 146,A00,747834,Alvarez; Luis A,48,0,50,2
1731505503471,HIUS 152B,A00,794678,Daly; Heather Marie,36,0,40,4
1731505504499,HIUS 180,A00,747835,Gosin; Monika N.,20,0,20,0
1731505505537,HUM 1,A01,767622,Demetriou; Denise,15,0,15,0
1731505505537,HUM 1,A02,767623,Demetriou; Denise,14,0,15,1
1731505505537,HUM 1,A03,767624,Demetriou; Denise,12,0,15,3
1731505505537,HUM 1,A04,767625,Demetriou; Denise,11,0,15,4
1731505505537,HUM 1,A05,767626,Demetriou; Denise,12,0,15,3
1731505505537,HUM 1,A06,767627,Demetriou; Denise,15,0,15,0
1731505505537,HUM 1,A07,767628,Demetriou; Denise,15,0,15,0
1731505505537,HUM 1,A08,767629,Demetriou; Denise,15,0,15,0
1731505505537,HUM 1,A09,767687,Demetriou; Denise,14,0,15,1
1731505505537,HUM 1,A10,767695,Demetriou; Denise,14,0,15,1
1731505505537,HUM 1,A11,767696,Demetriou; Denise,15,0,15,0
1731505505537,HUM 1,A12,767698,Demetriou; Denise,15,0,15,0
1731505505537,HUM 1,B01,767771,West; Geoffrey Scott,14,0,15,1
1731505505537,HUM 1,B02,767815,West; Geoffrey Scott,14,0,15,1
1731505505537,HUM 1,B03,767837,West; Geoffrey Scott,14,0,15,1
1731505505537,HUM 1,B04,767843,West; Geoffrey Scott,13,0,15,2
1731505505537,HUM 1,B05,767853,West; Geoffrey Scott,15,0,15,0
1731505505537,HUM 1,B06,767861,West; Geoffrey Scott,15,0,15,0
1731505505537,HUM 1,B07,767884,West; Geoffrey Scott,15,0,15,0
1731505505537,HUM 1,B08,767903,West; Geoffrey Scott,15,0,15,0
1731505505537,HUM 1,B09,767945,West; Geoffrey Scott,15,0,15,0
1731505505537,HUM 1,B10,767986,West; Geoffrey Scott,15,0,15,0
1731505505537,HUM 1,B11,768004,West; Geoffrey Scott,14,0,15,1
1731505505537,HUM 1,B12,768005,West; Geoffrey Scott,12,0,15,3
1731505505537,HUM 1,B13,768015,West; Geoffrey Scott,15,0,15,0
1731505505537,HUM 1,B14,768019,West; Geoffrey Scott,15,0,15,0
1731505505537,HUM 1,C01,768080,Rodriguez; Bretton Sigfred,0,0,0,0
1731505505537,HUM 1,C02,768081,Rodriguez; Bretton Sigfred,0,0,0,0
1731505505537,HUM 1,C03,768082,Rodriguez; Bretton Sigfred,13,0,15,2
1731505505537,HUM 1,C04,768083,Rodriguez; Bretton Sigfred,13,0,15,2
1731505505537,HUM 1,C05,768084,Rodriguez; Bretton Sigfred,14,0,15,1
1731505505537,HUM 1,C06,768085,Rodriguez; Bretton Sigfred,13,0,15,2
1731505505537,HUM 1,C07,768086,Rodriguez; Bretton Sigfred,15,0,15,0
1731505505537,HUM 1,C08,768087,Rodriguez; Bretton Sigfred,15,0,15,0
1731505505537,HUM 1,C09,768088,Rodriguez; Bretton Sigfred,15,0,15,0
1731505505537,HUM 1,C10,768089,Rodriguez; Bretton Sigfred,15,0,15,0
1731505505537,HUM 1,C11,768090,Rodriguez; Bretton Sigfred,13,0,15,2
1731505505537,HUM 1,C12,768091,Rodriguez; Bretton Sigfred,15,0,15,0
1731505505537,HUM 1,C13,768157,Rodriguez; Bretton Sigfred,14,0,15,1
1731505505537,HUM 1,C14,768158,Rodriguez; Bretton Sigfred,14,0,15,1
1731505506566,HUM 2,A01,768160,Lyon; Antony J.,13,0,15,2
1731505506566,HUM 2,A02,768165,Lyon; Antony J.,13,0,15,2
1731505506566,HUM 2,A03,768166,Lyon; Antony J.,0,0,0,0
1731505506566,HUM 2,A04,768167,Lyon; Antony J.,0,0,0,0
1731505506566,HUM 2,A05,768169,Lyon; Antony J.,14,0,15,1
1731505506566,HUM 2,A06,768193,Lyon; Antony J.,15,0,15,0
1731505506566,HUM 2,A07,768200,Lyon; Antony J.,14,0,15,1
1731505506566,HUM 2,A08,768260,Lyon; Antony J.,15,0,15,0
1731505506566,HUM 2,A09,768299,Lyon; Antony J.,13,0,15,2
1731505506566,HUM 2,A10,768323,Lyon; Antony J.,12,0,15,3
1731505506566,HUM 2,A11,768330,Lyon; Antony J.,15,0,15,0
1731505506566,HUM 2,A12,768338,Lyon; Antony J.,14,0,15,1
1731505506566,HUM 2,A13,768344,Lyon; Antony J.,0,0,0,0
1731505506566,HUM 2,A14,768388,Lyon; Antony J.,0,0,0,0
1731505507596,HUM 4,A01,768408,Watkins; Eric,27,0,28,1
1731505507596,HUM 4,A02,768409,Watkins; Eric,26,0,28,2
1731505507596,HUM 4,A03,768410,Watkins; Eric,27,0,28,1
1731505507596,HUM 4,A04,768411,Watkins; Eric,28,0,28,0
1731505507596,HUM 4,A05,768412,Watkins; Eric,27,0,28,1
1731505507596,HUM 4,A06,768413,Watkins; Eric,27,0,28,1
1731505507596,HUM 4,B01,768415,Caldwell; Michael Alan,20,0,28,8
1731505507596,HUM 4,B02,768416,Caldwell; Michael Alan,27,0,28,1
1731505507596,HUM 4,B03,768417,Caldwell; Michael Alan,21,0,28,7
1731505507596,HUM 4,B04,768418,Caldwell; Michael Alan,26,0,28,2
1731505507596,HUM 4,B05,768419,Caldwell; Michael Alan,28,0,28,0
1731505507596,HUM 4,B06,768420,Caldwell; Michael Alan,27,0,28,1
1731505507596,HUM 4,B07,768421,Caldwell; Michael Alan,28,0,28,0
1731505507596,HUM 4,B08,768422,Caldwell; Michael Alan,28,0,28,0
1731505507596,HUM 4,C01,768424,Markman; Kristina,27,0,28,1
1731505507596,HUM 4,C02,768425,Markman; Kristina,23,0,28,5
1731505507596,HUM 4,C03,768426,Markman; Kristina,24,0,28,4
1731505507596,HUM 4,C04,768427,Markman; Kristina,23,0,28,5
1731505507596,HUM 4,C05,768428,Markman; Kristina,24,0,28,4
1731505507596,HUM 4,C06,768429,Markman; Kristina,26,0,28,2
1731505507596,HUM 4,C07,768430,Markman; Kristina,25,0,28,3
1731505507596,HUM 4,C08,768431,Markman; Kristina,26,0,28,2
1731505508625,HUM 100,001,768432,Zavodny; Tatiana Sophia,18,0,18,0
1731505508625,HUM 100,002,768433,Zavodny; Tatiana Sophia,17,0,18,1
1731505508625,HUM 100,003,768434,Zavodny; Tatiana Sophia,17,0,18,1
1731505508625,HUM 100,004,768435,West; Geoffrey Scott,18,0,18,0
1731505508625,HUM 100,005,768436,Crum; Matthew Stephen,18,0,18,0
1731505508625,HUM 100,006,768437,Crum; Matthew Stephen,17,0,18,1
1731505508625,HUM 100,007,768438,Crum; Matthew Stephen,18,0,18,0
1731505508625,HUM 100,008,768439,Shenoy; Niyati,17,0,18,1
1731505508625,HUM 100,009,768440,Shenoy; Niyati,18,0,18,0
1731505508625,HUM 100,010,768441,Shenoy; Niyati,18,0,18,0
1731505509655,INTL 100,A01,747870,Feuer; Anna Stagg,23,0,25,2
1731505509655,INTL 100,A02,747872,Feuer; Anna Stagg,24,0,25,1
1731505509655,INTL 100,A03,747874,Feuer; Anna Stagg,22,0,25,3
1731505509655,INTL 100,A04,747881,Feuer; Anna Stagg,25,0,25,0
1731505509655,INTL 100,A05,747891,Feuer; Anna Stagg,22,0,25,3
1731505509655,INTL 100,A06,747893,Feuer; Anna Stagg,25,0,25,0
1731505510681,INTL 101,A01,747898,McIntosh; Justin Daniel,30,0,35,5
1731505510681,INTL 101,A02,747900,McIntosh; Justin Daniel,27,0,35,8
1731505511712,INTL 102,A01,747903,Broz; James Lawrence,28,0,35,7
1731505511712,INTL 102,A02,747909,Broz; James Lawrence,33,0,35,2
1731505512743,INTL 190,A00,747910,Appel; Benjamin Jay,0,0,0,0
1731505512743,INTL 190,B00,747912,Feeley; Maureen Catherine,0,0,0,2
1731505512743,INTL 190,C00,747914,Fortier; Jana,0,0,0,2
1731505512743,INTL 190,D00,747915,Lettieri; Michael Joseph,0,0,0,0
1731505513776,JAPN 10B,A01,747919,Maruyama; Rie,20,0,20,0
1731505513776,JAPN 10B,B01,747925,Sato; Kyoko,20,0,20,0
1731505513776,JAPN 10B,C01,747929,Ross; Kayoko F,17,0,20,3
1731505513776,JAPN 10B,D01,747932,McKee; Mayumi Mochizuki,22,0,25,3
1731505513776,JAPN 10B,E01,747936,Kamioka; Sachiko,21,0,25,4
1731505513776,JAPN 10B,F01,747941,Inada; Minori,23,0,25,2
1731505513776,JAPN 10B,G01,747944,Tipton; Yuko,25,0,25,0
1731505513776,JAPN 10B,H01,747951,Homma; Kunihiko,22,0,25,3
1731505513776,JAPN 10B,I01,747955,Maruyama; Rie,23,0,25,2
1731505513776,JAPN 10B,J01,747960,Tipton; Yuko,21,0,25,4
1731505513776,JAPN 10B,K01,747965,Sato; Kyoko,24,0,25,1
1731505513776,JAPN 10B,L01,747968,Ross; Kayoko F,25,0,25,0
1731505513776,JAPN 10B,M01,747971,Homma; Kunihiko,18,0,20,2
1731505514802,JAPN 10BR,A01,747974,Inada; Minori,20,0,20,0
1731505514802,JAPN 10BR,B01,747978,McKee; Mayumi Mochizuki,19,0,20,1
1731505514802,JAPN 10BR,C01,796045,Inada; Minori,4,0,4,0
1731505514802,JAPN 10BR,D01,796047,McKee; Mayumi Mochizuki,4,0,4,0
1731505515831,JAPN 20B,A01,747981,Takeda; Izumi,20,0,20,0
1731505515831,JAPN 20B,B01,747984,Homma; Kunihiko,16,0,20,4
1731505515831,JAPN 20B,C01,747988,Iwamoto; Naoki,18,0,20,2
1731505515831,JAPN 20B,D01,747991,Simpson; Junko Tokuda,20,0,20,0
1731505515831,JAPN 20B,E01,747993,Takeda; Izumi,20,0,20,0
1731505516858,JAPN 130B,A01,747998,Maruyama; Rie,19,0,20,1
1731505516858,JAPN 130B,B01,748001,Kamioka; Sachiko,19,0,20,1
1731505517884,JAPN 135B,A00,748002,Ross; Kayoko F,18,0,20,2
1731505517884,JAPN 135B,B00,748003,Iwamoto; Naoki,18,0,20,2
1731505518910,JAPN 137B,A00,748004,Simpson; Junko Tokuda,16,0,20,4
1731505519936,JAPN 140B,A00,748005,Takeda; Izumi,14,0,15,1
1731505520966,JAPN 150A,A00,748009,Sato; Kyoko,14,0,15,1
1731505521995,JAPN 190,A00,748010,Turner; Christena L.,19,0,20,1
1731505523027,JWSP 2,A01,748014,Shuster; Alana,14,0,15,1
1731505524054,LATI 10,A01,748018,Kennemore; Amy Michelle,27,0,30,3
1731505524054,LATI 10,A02,748020,Kennemore; Amy Michelle,30,0,30,0
1731505524054,LATI 10,A03,748021,Kennemore; Amy Michelle,28,0,30,2
1731505524054,LATI 10,A04,748023,Kennemore; Amy Michelle,28,0,30,2
1731505524054,LATI 10,A05,748025,Kennemore; Amy Michelle,30,0,30,0
1731505525086,LATI 50,A01,794604,Kokinis; Troy Andreas,28,0,30,2
1731505525086,LATI 50,A02,794839,Kokinis; Troy Andreas,29,0,30,1
1731505525086,LATI 50,A03,794840,Kokinis; Troy Andreas,30,0,30,0
1731505525086,LATI 50,A04,794841,Kokinis; Troy Andreas,27,0,30,3
1731505526111,LATI 140,A01,748028,Kokinis; Troy Andreas,30,0,30,0
1731505527142,LATI 170,A00,796289,Kennemore; Amy Michelle,28,0,30,2
1731505528168,LATI 180,B00,748041,Vasquez Cortes; Mateo,29,0,30,1
1731505529196,LATI 190,A00,748043,Carvajal Regidor; Jose,30,0,30,0
1731505530225,LAWS 101,A00,748047,Golan; Tal,48,0,60,12
1731505531253,LIAB 1B,A00,748070,Saab; Dima,12,0,14,2
1731505531253,LIAB 1B,B00,748075,Saab; Dima,11,0,14,3
1731505532285,LIAB 1BX,A00,748076,El Cheddadi; Youniss,24,0,28,4
1731505533311,LIAB 1E,A00,748082,El Cheddadi; Youniss,14,0,14,0
1731505534345,LIFR 1B,A00,748098,Van Moer; Vinciane G,12,0,14,2
1731505534345,LIFR 1B,B00,748099,Van Moer; Vinciane G,12,0,14,2
1731505534345,LIFR 1B,C00,748341,Van Moer; Vinciane G,12,0,14,2
1731505535373,LIFR 1BX,A00,748356,Van Moer; Vinciane G,21,0,21,0
1731505535373,LIFR 1BX,B00,748357,Van Moer; Vinciane G,15,0,21,6
1731505536401,LIFR 1C,A00,748361,Van Moer; Vinciane G,13,0,14,1
1731505536401,LIFR 1C,B00,748362,Van Moer; Vinciane G,10,0,14,4
1731505536401,LIFR 1C,C00,748363,Van Moer; Vinciane G,13,0,14,1
1731505537427,LIFR 1CX,A00,748366,Van Moer; Vinciane G,20,0,21,1
1731505537427,LIFR 1CX,B00,748367,Van Moer; Vinciane G,19,0,21,2
1731505538453,LIFR 11,A00,748368,Goodall; Grant Todd,9999,0,9999,0
1731505539485,LIGM 1B,A00,748371,Fischer-Grunski; Eva K,12,0,14,2
1731505539485,LIGM 1B,B00,748372,Fischer-Grunski; Eva K,12,0,14,2
1731505539485,LIGM 1B,C00,748374,Fischer-Grunski; Eva K,13,0,14,1
1731505540513,LIGM 1BX,A00,748376,Fischer-Grunski; Eva K,19,0,21,2
1731505540513,LIGM 1BX,B00,748378,Fischer-Grunski; Eva K,20,0,21,1
1731505541540,LIGM 11,A00,748379,Goodall; Grant Todd,9999,0,9999,0
1731505542571,LIGN 8,A00,748997,McIntosh; Justin Daniel,245,0,250,5
1731505543603,LIGN 17,A00,749008,Kehler; Andrew Scott,247,0,250,3
1731505544647,LIGN 101,A01,749010,Staff,27,0,29,2
1731505544647,LIGN 101,A02,749011,Staff,29,0,29,0
1731505544647,LIGN 101,A03,749149,Staff,27,0,29,2
1731505544647,LIGN 101,A04,749176,Staff,29,0,29,0
1731505544647,LIGN 101,A05,749186,Staff,29,0,30,1
1731505545679,LIGN 111,A01,749192,Bakovic; Eric John,29,0,30,1
1731505545679,LIGN 111,A02,749193,Bakovic; Eric John,27,0,30,3
1731505545679,LIGN 111,A03,749194,Bakovic; Eric John,24,0,30,6
1731505546708,LIGN 112,A00,749205,Garellek; Marc,69,0,70,1
1731505547739,LIGN 121,A01,749209,Rodriguez Aispuro; Alejandro,20,0,25,5
1731505547739,LIGN 121,A02,749211,Rodriguez Aispuro; Alejandro,24,0,25,1
1731505547739,LIGN 121,A03,749214,Rodriguez Aispuro; Alejandro,24,0,25,1
1731505548768,LIGN 148,A00,749215,Mayberry; Rachel,72,0,75,3
1731505549803,LIGN 150,A00,749218,Garellek; Marc,42,0,50,8
1731505550829,LIGN 172,A01,794611,Dudley; Rachel,30,0,30,0
1731505551857,LIGN 178,A00,749223,Munoz Sanchez; Alicia,69,0,70,1
1731505552884,LIGN 187,A00,749226,Staff,30,0,30,0
1731505552884,LIGN 187,B00,749227,Warstadt; Alexander Scott,30,0,30,0
1731505553909,LIGN 188R,A00,749228,Clem; Emily,40,0,40,0
1731505554943,LIGN 214,A00,749229,Styler; William Francis,29,0,30,1
1731505555972,LIGN 225,A00,749230,Clem; Emily,30,0,30,0
1731505557007,LIGN 251,A00,749287,Bergen; Leon,28,0,30,2
1731505558121,LIGN 296,001,774625,Ackerman; Farrell,10,0,10,0
1731505558121,LIGN 296,002,774626,Bakovic; Eric John,10,0,10,0
1731505558121,LIGN 296,003,774627,Bergen; Leon,10,0,10,0
1731505558121,LIGN 296,004,774638,Caballero; Gabriela Hernandez,10,0,10,0
1731505558121,LIGN 296,005,774639,Caponigro; Ivano,10,0,10,0
1731505558121,LIGN 296,006,774683,Clem; Emily,10,0,10,0
1731505558121,LIGN 296,007,774684,Dudley; Rachel,10,0,10,0
1731505558121,LIGN 296,008,774685,Garellek; Marc,10,0,10,0
1731505558121,LIGN 296,009,774691,Goodall; Grant Todd,10,0,10,0
1731505558121,LIGN 296,010,774692,Kehler; Andrew Scott,10,0,10,0
1731505558121,LIGN 296,011,774694,Kluender; Robert,10,0,10,0
1731505558121,LIGN 296,012,774697,Rose; Sharon,10,0,10,0
1731505558121,LIGN 296,013,774700,Styler; William Francis,10,0,10,0
1731505558121,LIGN 296,014,774820,Caponigro; Ivano,10,0,10,0
1731505559150,LIHL 112W,A00,748052,Pagkalinawan; Leticia Cant,27,0,28,1
1731505560176,LIHL 114W,A00,748054,Nguyen; Hoan Thi,25,0,28,3
1731505561207,LIHL 117W,A00,748057,Sadegholvad; Elham,28,0,28,0
1731505562234,LIHL 118,A00,748059,Chen; Areana Yen,28,0,28,0
1731505563260,LIHL 124W,A00,748061,Nguyen; Hoan Thi,26,0,28,2
1731505564286,LIHL 132W,A00,748062,Pagkalinawan; Leticia Cant,28,0,28,0
1731505565317,LIHL 134W,A00,748064,Nguyen; Hoan Thi,28,0,28,0
1731505566348,LIHL 138,A00,748068,Chen; Areana Yen,28,0,28,0
1731505567382,LIIT 1B,A00,748409,Carnelos; Chiara,13,0,14,1
1731505567382,LIIT 1B,B00,748418,Carnelos; Chiara,12,0,14,2
1731505567382,LIIT 1B,C00,748424,Carnelos; Chiara,12,0,14,2
1731505568408,LIIT 1BX,A00,748428,Carnelos; Chiara,21,0,21,0
1731505568408,LIIT 1BX,B00,748430,Carnelos; Chiara,17,0,21,4
1731505569436,LIPO 1B,A00,748436,Paladini; Denise,12,0,14,2
1731505569436,LIPO 1B,B00,748437,Paladini; Denise,0,0,0,0
1731505570466,LIPO 1BX,A00,748438,De Abreu; Cassia,27,0,28,1
1731505571497,LIPO 17,A00,798404,Paladini; Denise,0,0,0,0
1731505572528,LISL 1B,A00,748478,Lott; Margaret S.,14,0,14,0
1731505572528,LISL 1B,B00,748482,Lott; Margaret S.,14,0,14,0
1731505572528,LISL 1B,C00,748484,Lott; Margaret S.,13,0,14,1
1731505572528,LISL 1B,D00,748485,Lott; Margaret S.,12,0,14,2
1731505572528,LISL 1B,E00,748487,Lott; Margaret S.,14,0,14,0
1731505572528,LISL 1B,F00,748490,Lott; Margaret S.,12,0,14,2
1731505572528,LISL 1B,G00,748491,Lott; Margaret S.,13,0,14,1
1731505572528,LISL 1B,H00,748492,Lott; Margaret S.,14,0,14,0
1731505573558,LISL 1BX,A00,748594,Lott; Margaret S.,28,0,28,0
1731505573558,LISL 1BX,B00,748595,Lott; Margaret S.,27,0,28,1
1731505573558,LISL 1BX,C00,748596,Lott; Margaret S.,25,0,28,3
1731505573558,LISL 1BX,D00,748597,Lott; Margaret S.,27,0,28,1
1731505574585,LISL 1C,A00,748614,Lott; Margaret S.,11,0,14,3
1731505574585,LISL 1C,B00,748616,Lott; Margaret S.,13,0,14,1
1731505574585,LISL 1C,C00,748678,Lott; Margaret S.,11,0,14,3
1731505574585,LISL 1C,D00,748686,Lott; Margaret S.,14,0,14,0
1731505575610,LISL 1CX,A00,748698,Lott; Margaret S.,21,0,28,7
1731505575610,LISL 1CX,B00,748699,Lott; Margaret S.,25,0,28,3
1731505576635,LISL 1E,A00,748700,Lott; Margaret S.,11,0,14,3
1731505577662,LISP 1B,A00,748737,Munoz Sanchez; Alicia,12,0,14,2
1731505577662,LISP 1B,B00,748755,Munoz Sanchez; Alicia,14,0,14,0
1731505577662,LISP 1B,C00,748761,Munoz Sanchez; Alicia,14,0,14,0
1731505577662,LISP 1B,D00,748763,Munoz Sanchez; Alicia,12,0,14,2
1731505577662,LISP 1B,E00,748764,Munoz Sanchez; Alicia,14,0,14,0
1731505577662,LISP 1B,F00,748790,Munoz Sanchez; Alicia,11,0,14,3
1731505577662,LISP 1B,G00,748791,Munoz Sanchez; Alicia,14,0,14,0
1731505577662,LISP 1B,H00,748792,Munoz Sanchez; Alicia,9,0,14,5
1731505577662,LISP 1B,I00,748793,Munoz Sanchez; Alicia,12,0,14,2
1731505577662,LISP 1B,J00,748794,Munoz Sanchez; Alicia,11,0,14,3
1731505578697,LISP 1BX,A00,748795,Munoz Sanchez; Alicia,26,0,28,2
1731505578697,LISP 1BX,B00,748796,Munoz Sanchez; Alicia,25,0,28,3
1731505578697,LISP 1BX,C00,748797,Munoz Sanchez; Alicia,26,0,28,2
1731505578697,LISP 1BX,D00,748798,Munoz Sanchez; Alicia,25,0,28,3
1731505578697,LISP 1BX,E00,748799,Munoz Sanchez; Alicia,24,0,28,4
1731505579733,LISP 1C,001,748834,Munoz Sanchez; Alicia,13,0,14,1
1731505579733,LISP 1C,002,748835,Munoz Sanchez; Alicia,14,0,14,0
1731505579733,LISP 1C,003,748847,Munoz Sanchez; Alicia,13,0,14,1
1731505579733,LISP 1C,004,748848,Munoz Sanchez; Alicia,13,0,14,1
1731505579733,LISP 1C,005,748863,Munoz Sanchez; Alicia,13,0,14,1
1731505579733,LISP 1C,006,748866,Munoz Sanchez; Alicia,13,0,14,1
1731505579733,LISP 1C,007,748867,Munoz Sanchez; Alicia,12,0,14,2
1731505579733,LISP 1C,008,748868,Munoz Sanchez; Alicia,14,0,14,0
1731505579733,LISP 1C,009,748869,Munoz Sanchez; Alicia,14,0,14,0
1731505579733,LISP 1C,010,748870,Munoz Sanchez; Alicia,13,0,14,1
1731505579733,LISP 1C,011,748871,Munoz Sanchez; Alicia,12,0,14,2
1731505579733,LISP 1C,012,748872,Munoz Sanchez; Alicia,12,0,14,2
1731505579733,LISP 1C,013,748873,Munoz Sanchez; Alicia,12,0,14,2
1731505579733,LISP 1C,014,748879,Munoz Sanchez; Alicia,13,0,14,1
1731505579733,LISP 1C,015,748895,Munoz Sanchez; Alicia,12,0,14,2
1731505579733,LISP 1C,016,748896,Munoz Sanchez; Alicia,14,0,14,0
1731505579733,LISP 1C,017,748901,Munoz Sanchez; Alicia,14,0,14,0
1731505579733,LISP 1C,018,748902,Munoz Sanchez; Alicia,13,0,14,1
1731505579733,LISP 1C,020,748904,Munoz Sanchez; Alicia,14,0,14,0
1731505580761,LISP 1CX,B00,748913,Munoz Sanchez; Alicia,27,0,30,3
1731505580761,LISP 1CX,C00,748914,Munoz Sanchez; Alicia,26,0,30,4
1731505580761,LISP 1CX,D00,748926,Munoz Sanchez; Alicia,27,0,30,3
1731505580761,LISP 1CX,E00,748937,Munoz Sanchez; Alicia,30,0,30,0
1731505580761,LISP 1CX,F00,748938,Munoz Sanchez; Alicia,27,0,30,3
1731505580761,LISP 1CX,G00,748950,Munoz Sanchez; Alicia,28,0,30,2
1731505580761,LISP 1CX,H00,748951,Munoz Sanchez; Alicia,28,0,30,2
1731505580761,LISP 1CX,I00,748956,Munoz Sanchez; Alicia,30,0,30,0
1731505580761,LISP 1CX,J00,748957,Munoz Sanchez; Alicia,29,0,30,1
1731505581789,LISP 16,A00,748994,Munoz Sanchez; Alicia,20,0,22,2
1731505581789,LISP 16,B00,748995,Munoz Sanchez; Alicia,21,0,22,1
1731505582817,LISP 18,A00,748996,Munoz Sanchez; Alicia,21,0,22,1
1731505583842,LTAM 105,A00,749877,Ruiz; Ariana,35,0,40,5
1731505584868,LTAM 110,A00,749882,Chacon; Gloria Elizabeth,40,0,40,0
1731505585894,LTAM 120,A00,749915,Martin-Cabrera; Luis,39,0,40,1
1731505586920,LTCO 281,A00,750740,Mukherjee; Silpa,15,0,15,0
1731505587950,LTCO 282,A00,750741,Cohen; Alain J. J.,12,0,15,3
1731505588980,LTCS 11,A00,749294,Lampert-Weissig; Lisa,39,0,40,1
1731505590014,LTCS 87,A00,795238,Nguyen; Hoang Tan,19,0,20,1
1731505590014,LTCS 87,B00,795239,Nguyen; Hoang Tan,20,0,20,0
1731505591043,LTCS 108,A00,749916,Lu; Lillian,19,0,20,1
1731505592070,LTCS 111,A00,749940,Vitkus; Daniel J.,25,0,25,0
1731505593095,LTCS 131,A00,749942,Sanchez Cruz; Jorge,39,0,40,1
1731505594128,LTEA 100A,A00,749944,Liao; Ping H,39,0,40,1
1731505595158,LTEA 132,A00,749945,Mendoza; Andrea,55,0,60,5
1731505596184,LTEA 138,A00,749946,Miyao; Daisuke,347,0,360,13
1731505597210,LTEN 23,A01,749297,Vijay; Ameeth Varma,28,0,28,0
1731505597210,LTEN 23,A02,749321,Vijay; Ameeth Varma,27,0,28,1
1731505597210,LTEN 23,A03,749322,Vijay; Ameeth Varma,28,0,28,0
1731505597210,LTEN 23,A04,749324,Vijay; Ameeth Varma,27,0,28,1
1731505598238,LTEN 26,A01,749326,Wesling; Megan E.,27,0,28,1
1731505598238,LTEN 26,A02,749327,Wesling; Megan E.,26,0,28,2
1731505598238,LTEN 26,A03,749328,Wesling; Megan E.,25,0,28,3
1731505598238,LTEN 26,A04,749329,Wesling; Megan E.,25,0,28,3
1731505599269,LTEN 27,A01,749339,Childs; Dennis R.,27,0,28,1
1731505599269,LTEN 27,A02,749348,Childs; Dennis R.,27,0,28,1
1731505599269,LTEN 27,A03,749360,Childs; Dennis R.,26,0,28,2
1731505599269,LTEN 27,A04,749362,Childs; Dennis R.,27,0,28,1
1731505600293,LTEN 112,A00,749947,Vitkus; Daniel J.,38,0,40,2
1731505601322,LTEN 140,A00,749948,Lu; Lillian,23,0,25,2
1731505602347,LTEN 142,A00,749949,Garofalo; Devin,38,0,40,2
1731505603373,LTEN 180,A00,749950,Ruiz; Ariana,17,0,20,3
1731505604402,LTEN 181,A00,749951,Kim; Joo Ok,36,0,40,4
1731505605427,LTEN 185,A00,749961,Childs; Dennis R.,17,0,20,3
1731505606453,LTEN 189,A00,749962,Vijay; Ameeth Varma,24,0,25,1
1731505607484,LTEN 252,A00,750742,Wesling; Megan E.,12,0,15,3
1731505608509,LTEN 272,A00,750744,Lampert-Weissig; Lisa,11,0,15,4
1731505609539,LTEU 105,A00,749963,De Marchi Gherini; Adriana,28,0,35,7
1731505610566,LTEU 141,A00,749977,Cohen; Alain J. J.,40,0,40,0
1731505611596,LTEU 150C,B00,750299,Morse; Ainsley,30,0,30,0
1731505612623,LTFR 2B,A01,749381,Ploye; Catherine,28,0,28,0
1731505613651,LTFR 2C,A00,749383,Ploye; Catherine,25,0,25,0
1731505614696,LTFR 104,A00,750301,Zhiri; Oumelbanine,25,0,25,0
1731505615722,LTFR 115,A00,750302,Zhiri; Oumelbanine,25,0,25,0
1731505616746,LTGK 2,A00,749384,Murray; Kourtney Kristine,30,0,31,1
1731505617788,LTGK 104,A00,795231,Murray; Kourtney Kristine,25,0,25,0
1731505618813,LTGM 2B,A01,749413,Fischer-Grunski; Eva K,25,0,25,0
1731505619843,LTIT 2B,A01,749459,De Marchi Gherini; Adriana,24,0,25,1
1731505620868,LTIT 115,A00,750314,De Marchi Gherini; Adriana,5,0,5,0
1731505621910,LTKO 1B,A01,749486,Cho; Hye Jin,26,0,28,2
1731505621910,LTKO 1B,B01,749543,Cho; Hye Jin,26,0,28,2
1731505621910,LTKO 1B,C01,749573,Tark; Eun Sun,26,0,28,2
1731505621910,LTKO 1B,D01,749575,Tark; Eun Sun,27,0,28,1
1731505621910,LTKO 1B,E01,749590,Yim; Nancy,28,0,28,0
1731505621910,LTKO 1B,F01,749632,Yim; Nancy,28,0,28,0
1731505622936,LTKO 2B,A01,749700,Lee; Jeyseon,23,0,28,5
1731505623962,LTKO 130W,A00,750479,Lee; Jeyseon,25,0,25,0
1731505624989,LTLA 2,A00,749738,Murray; Kourtney Kristine,44,0,45,1
1731505626016,LTLA 105,A00,750480,Kelting; Edward William,24,0,25,1
1731505627045,LTRU 1B,A01,749758,Wells; Patricia Rebecca,26,0,28,2
1731505628073,LTRU 2B,A01,749788,Wells; Patricia Rebecca,25,0,25,0
1731505629099,LTRU 104C,A01,750482,Wells; Patricia Rebecca,20,0,20,0
1731505630129,LTRU 110C,B00,750484,Morse; Ainsley,10,0,10,0
1731505631160,LTSP 2A,A01,749790,Lampell; Toni,23,0,28,5
1731505632189,LTSP 2B,A01,749855,Mastromartino; Alexandra L,26,0,28,2
1731505632189,LTSP 2B,B01,749857,Mastromartino; Alexandra L,26,0,28,2
1731505633215,LTSP 2C,A01,749859,Lampell; Toni,25,0,28,3
1731505634249,LTSP 2F,A00,749860,Mastromartino; Alexandra L,25,0,25,0
1731505635275,LTSP 3F,A00,749861,Dominguez; Noelia,25,0,25,0
1731505635275,LTSP 3F,B00,749862,Dominguez; Noelia,23,0,25,2
1731505636310,LTSP 100F,A00,750494,Arcos Herrera; Carol,25,0,25,0
1731505636310,LTSP 100F,B00,750495,Dominguez; Noelia,24,0,25,1
1731505636310,LTSP 100F,C00,750547,Villafuerte Vazquez; Nadia,25,0,25,0
1731505637340,LTSP 116,A00,750557,Arcos Herrera; Carol,40,0,40,0
1731505638369,LTSP 135B,A00,750560,Sanchez Cruz; Jorge,39,0,40,1
1731505639398,LTSP 145,A00,750561,Martin-Cabrera; Luis,24,0,25,1
1731505640433,LTSP 155,A00,798249,Blanco; John D,40,0,40,0
1731505641458,LTSP 166,A00,750562,Carvajal Regidor; Jose,39,0,40,1
1731505642490,LTSP 172,A00,750563,Chacon; Gloria Elizabeth,40,0,40,0
1731505643516,LTTH 210B,A00,750769,Blanco; John D,15,0,15,0
1731505644544,LTWL 11,A00,749863,Dhar; Amrita,40,0,40,0
1731505645572,LTWL 19B,A00,749864,Myerston Santana; Jacobo,38,0,40,2
1731505646597,LTWL 102,A00,750565,Myerston Santana; Jacobo,23,0,25,2
1731505647625,LTWL 120,A00,750578,Mendoza; Andrea,38,0,40,2
1731505648651,LTWL 124,A00,750579,Garofalo; Devin,39,0,40,1
1731505649678,LTWL 165,A00,750587,Kim; Joo Ok,40,0,40,0
1731505650703,LTWL 180,A00,750613,Nguyen; Hoang Tan,39,0,40,1
1731505651729,LTWL 184,A00,750625,Mukherjee; Silpa,38,0,40,2
1731505652756,LTWR 8A,A01,749866,Hoang; Lily Kim,25,0,28,3
1731505652756,LTWR 8A,A02,749867,Hoang; Lily Kim,28,0,28,0
1731505652756,LTWR 8A,A03,749868,Hoang; Lily Kim,25,0,28,3
1731505652756,LTWR 8A,A04,749869,Hoang; Lily Kim,24,0,28,4
1731505653782,LTWR 8B,A01,749872,Som; Brandon D,27,0,28,1
1731505653782,LTWR 8B,A02,749873,Som; Brandon D,27,0,28,1
1731505653782,LTWR 8B,A03,749874,Som; Brandon D,27,0,28,1
1731505653782,LTWR 8B,A04,749875,Som; Brandon D,28,0,28,0
1731505654809,LTWR 101C,A00,750638,Villafuerte Vazquez; Nadia,30,0,30,0
1731505655836,LTWR 109C,A00,795232,Terry; Christopher,24,0,30,6
1731505656864,LTWR 110C,A00,795236,Terry; Christopher,25,0,30,5
1731505657892,LTWR 113C,A00,750640,Carroll; Amy Sara,29,0,30,1
1731505658919,LTWR 114W,A00,750675,Springer; Anna Joy,14,0,15,1
1731505659950,LTWR 115C,A00,750677,Lopez; Casandra,28,0,30,2
1731505660975,LTWR 120C,A00,750678,Wilkinson; Marco,29,0,30,1
1731505662001,LTWR 121C,A00,795237,Terry; Christopher,26,0,30,4
1731505663028,LTWR 126W,A00,750739,Lopez; Casandra,13,0,15,2
1731505664058,LTWR 144,A00,795207,Hoang; Lily Kim,23,0,25,2
1731505665088,LTWR 215,A00,750771,Wilkinson; Marco,14,0,20,6
1731505666113,LTWR 220,A00,750778,Som; Brandon D,9,0,15,6
1731505667147,MAE 8,A01,754809,Arefiev; Alexey,136,0,140,4
1731505668178,MAE 20,A00,754810,Evdokimenko; Ekaterina,57,0,60,3
1731505669207,MAE 30A,A00,754811,Qi; Huihui,100,0,100,0
1731505669207,MAE 30A,B00,754812,Qi; Huihui,78,0,100,22
1731505670236,MAE 30B,A00,754813,Delson; Nathan Joseph,63,0,65,2
1731505671262,MAE 40,A00,754814,Cortes; Jorge,90,0,104,14
1731505672296,MAE 101A,A00,754815,Nomura; Keiko K.,140,0,150,10
1731505673328,MAE 101B,A00,754816,Pham; Hieu Tan,110,0,120,10
1731505674361,MAE 114,A00,754817,Krasheninnikov; Sergei,49,0,50,1
1731505675390,MAE 118,A00,754818,Marinoni; Alessandro,40,0,45,5
1731505676416,MAE 120,A00,754819,Krasheninnikov; Sergei,53,0,60,7
1731505677447,MAE 125,A00,754820,Kleissl; Jan,56,0,75,19
1731505678479,MAE 130,A00,754821,Frazier; Michael,59,0,60,1
1731505679506,MAE 131B,A00,754822,Scholtes Acevedo; Claire,99,0,100,1
1731505680534,MAE 142,A00,754823,Anderson; Mark Ronald,31,0,60,29
1731505681570,MAE 143A,A00,754824,Diagne; Mamadou Lamine,58,0,75,17
1731505681570,MAE 143A,B00,754825,Kramer; Boris,66,0,75,9
1731505682597,MAE 143B,A00,754826,Morimoto; Tania,83,0,100,17
1731505683625,MAE 148,A01,754828,Silberman; Jack,21,0,24,3
1731505684651,MAE 155A,A01,754830,Anderson; Mark Ronald,14,0,50,36
1731505684651,MAE 155A,B01,754832,Hwang; John T,35,0,50,15
1731505685684,MAE 156A,A01,754834,Gravish; Nicholas G & Tustaniwskyj; Jerry I & Mullin; Jennifer S & Lubarda; Marko & Delson; Nathan Joseph,0,0,12,12
1731505685684,MAE 156A,A02,754835,Gravish; Nicholas G & Tustaniwskyj; Jerry I & Delson; Nathan Joseph & Mullin; Jennifer S & Lubarda; Marko,7,0,12,5
1731505685684,MAE 156A,A03,754874,Gravish; Nicholas G & Tustaniwskyj; Jerry I & Mullin; Jennifer S & Lubarda; Marko & Delson; Nathan Joseph,0,0,12,12
1731505685684,MAE 156A,A04,754891,Gravish; Nicholas G & Tustaniwskyj; Jerry I & Mullin; Jennifer S & Lubarda; Marko & Delson; Nathan Joseph,12,0,12,0
1731505685684,MAE 156A,A05,754898,Gravish; Nicholas G & Tustaniwskyj; Jerry I & Mullin; Jennifer S & Lubarda; Marko & Delson; Nathan Joseph,0,0,12,12
1731505685684,MAE 156A,A06,754899,Gravish; Nicholas G & Tustaniwskyj; Jerry I & Delson; Nathan Joseph & Mullin; Jennifer S & Lubarda; Marko,10,0,12,2
1731505685684,MAE 156A,A07,754900,Gravish; Nicholas G & Tustaniwskyj; Jerry I & Mullin; Jennifer S & Lubarda; Marko & Delson; Nathan Joseph,8,0,12,4
1731505685684,MAE 156A,A08,754933,Gravish; Nicholas G & Tustaniwskyj; Jerry I & Mullin; Jennifer S & Lubarda; Marko & Delson; Nathan Joseph,10,0,12,2
1731505685684,MAE 156A,A09,754937,Gravish; Nicholas G & Tustaniwskyj; Jerry I & Mullin; Jennifer S & Lubarda; Marko & Delson; Nathan Joseph,8,0,14,6
1731505685684,MAE 156A,A10,754970,Gravish; Nicholas G & Tustaniwskyj; Jerry I & Delson; Nathan Joseph & Mullin; Jennifer S & Lubarda; Marko,1,0,8,7
1731505685684,MAE 156A,A11,754971,Gravish; Nicholas G & Tustaniwskyj; Jerry I & Mullin; Jennifer S & Lubarda; Marko & Delson; Nathan Joseph,3,0,8,5
1731505685684,MAE 156A,A12,754972,Gravish; Nicholas G & Tustaniwskyj; Jerry I & Mullin; Jennifer S & Lubarda; Marko & Delson; Nathan Joseph,4,0,8,4
1731505685684,MAE 156A,A13,754973,Gravish; Nicholas G & Tustaniwskyj; Jerry I & Mullin; Jennifer S & Lubarda; Marko & Delson; Nathan Joseph,5,0,8,3
1731505685684,MAE 156A,A14,754974,Gravish; Nicholas G & Tustaniwskyj; Jerry I & Delson; Nathan Joseph & Mullin; Jennifer S & Lubarda; Marko,6,0,8,2
1731505685684,MAE 156A,A15,754975,Gravish; Nicholas G & Tustaniwskyj; Jerry I & Mullin; Jennifer S & Lubarda; Marko & Delson; Nathan Joseph,4,0,8,4
1731505685684,MAE 156A,A16,754976,Gravish; Nicholas G & Tustaniwskyj; Jerry I & Mullin; Jennifer S & Lubarda; Marko & Delson; Nathan Joseph,6,0,8,2
1731505685684,MAE 156A,A17,754977,Gravish; Nicholas G & Tustaniwskyj; Jerry I & Mullin; Jennifer S & Lubarda; Marko & Delson; Nathan Joseph,7,0,8,1
1731505685684,MAE 156A,A18,754978,Gravish; Nicholas G & Tustaniwskyj; Jerry I & Delson; Nathan Joseph & Mullin; Jennifer S & Lubarda; Marko,6,0,6,0
1731505686711,MAE 156B,A01,754980,Staff,30,0,36,6
1731505686711,MAE 156B,B01,754982,Tustaniwskyj; Jerry I,25,0,36,11
1731505687740,MAE 160,A00,754983,Evdokimenko; Ekaterina,151,0,165,14
1731505688767,MAE 171A,A01,754985,Kleissl; Jan,24,0,32,8
1731505688767,MAE 171A,A02,754986,Kleissl; Jan,23,0,32,9
1731505688767,MAE 171A,A03,754987,Kleissl; Jan,2,0,32,30
1731505688767,MAE 171A,A04,754988,Kleissl; Jan,0,0,32,32
1731505688767,MAE 171A,A05,754989,Kleissl; Jan,30,0,32,2
1731505688767,MAE 171A,A06,754990,Kleissl; Jan,20,0,32,12
1731505688767,MAE 171A,A07,754991,Kleissl; Jan,25,0,32,7
1731505688767,MAE 171A,A08,754992,Kleissl; Jan,15,0,32,17
1731505688767,MAE 171A,A09,754993,Kleissl; Jan,20,0,24,4
1731505689802,MAE 175A,A01,754995,de Callafon; Raymond A,13,0,16,3
1731505689802,MAE 175A,A02,754996,de Callafon; Raymond A,5,0,16,11
1731505689802,MAE 175A,A03,754997,de Callafon; Raymond A,16,0,16,0
1731505689802,MAE 175A,A04,754998,de Callafon; Raymond A,13,0,16,3
1731505689802,MAE 175A,A05,754999,de Callafon; Raymond A,7,0,16,9
1731505689802,MAE 175A,A06,755052,de Callafon; Raymond A,14,0,15,1
1731505690834,MAE 180,A00,755116,Rosengren; Aaron,53,0,60,7
1731505691859,MAE 200,A00,755117,Diagne; Mamadou Lamine,0,0,50,50
1731505692886,MAE 204,A00,755186,Tolley; Michael Thomas,21,0,100,79
1731505693969,MAE 205,A00,755187,Diagne; Mamadou Lamine & Tynan; George Robert & Scholtes Acevedo; Claire & Qi; Huihui & Hao; Xuanting & Garay; Javier,9990,0,9999,9
1731505694998,MAE 206,A00,755188,Tynan; George Robert,23,0,80,57
1731505696025,MAE 207,A00,755193,Poulikakos; Lisa Voula,17,0,30,13
1731505696025,MAE 207,B00,755199,Staff,51,0,60,9
1731505697051,MAE 208,A00,755212,Saintillan; David,6,0,30,24
1731505698075,MAE 210B,A00,755213,Sanchez; Antonio Luis,13,0,30,17
1731505699102,MAE 210C,A00,755214,Becker; Janet Maria,11,0,15,4
1731505700129,MAE 212,A00,755215,Sanchez; Antonio Luis,18,0,40,22
1731505701158,MAE 217B,A00,755216,Arefiev; Alexey,6,0,10,4
1731505702187,MAE 221B,A00,755217,Coimbra; Carlos F.,7,0,15,8
1731505703219,MAE 221C,A00,755218,Saha; Abhishek,3,0,10,7
1731505704248,MAE 231C,A00,755220,Jandaghi Semnani; Shabnam,4,0,5,1
1731505705273,MAE 232B,A00,755221,Chen; Jiun-Shyan,0,0,10,10
1731505706302,MAE 248,A00,755222,Herbert; Sylvia Lee,15,0,15,0
1731505707327,MAE 261,A00,755223,Lindsey; Stephanie,10,0,10,0
1731505708354,MAE 270,A00,755224,Hwang; John T,0,0,15,15
1731505709386,MAE 271A,A00,755226,Luo; Jian,2,0,5,3
1731505710412,MAE 274,A00,755299,Kramer; Boris,0,0,0,0
1731505711438,MAE 276,A00,755300,Cai; Shengqiang,0,0,20,20
1731505712469,MAE 281A,A00,755301,Krstic; Miroslav,19,0,42,23
1731505713496,MAE 289B,A00,755302,Martinez; Sonia,10,0,10,0
1731505714522,MAE 290B,A00,755303,Sarkar; Sutanu,20,0,40,20
1731505715551,MAE 294B,A00,755304,Llewellyn Smith; Stefan G.,7,0,10,3
1731505716587,MATH 2,A01,751732,Cheng; Hsiao-Bing,193,0,200,7
1731505716587,MATH 2,B01,751734,Cheng; Hsiao-Bing,196,0,200,4
1731505717616,MATH 3B,A01,751736,Hammock; Frances H,33,0,33,0
1731505717616,MATH 3B,A02,751737,Hammock; Frances H,24,0,33,9
1731505717616,MATH 3B,A03,751738,Hammock; Frances H,33,0,33,0
1731505717616,MATH 3B,A04,751739,Hammock; Frances H,30,0,33,3
1731505717616,MATH 3B,A05,751740,Hammock; Frances H,30,0,31,1
1731505717616,MATH 3B,A06,751741,Hammock; Frances H,31,0,33,2
1731505717616,MATH 3B,B01,751743,Staff,27,0,32,5
1731505717616,MATH 3B,B02,751744,Staff,32,0,32,0
1731505717616,MATH 3B,B03,751745,Staff,29,0,32,3
1731505717616,MATH 3B,B04,751746,Staff,31,0,32,1
1731505717616,MATH 3B,B05,751765,Staff,32,0,32,0
1731505717616,MATH 3B,B06,751766,Staff,32,0,32,0
1731505718655,MATH 3C,A01,751774,Hammock; Frances H,29,0,30,1
1731505718655,MATH 3C,A02,751775,Hammock; Frances H,26,0,30,4
1731505718655,MATH 3C,A03,751776,Hammock; Frances H,30,0,30,0
1731505718655,MATH 3C,A04,751781,Hammock; Frances H,25,0,30,5
1731505718655,MATH 3C,A05,751782,Hammock; Frances H,20,0,30,10
1731505718655,MATH 3C,A06,751952,Hammock; Frances H,30,0,30,0
1731505718655,MATH 3C,B01,752043,Staff,32,0,35,3
1731505718655,MATH 3C,B02,752094,Staff,35,0,35,0
1731505718655,MATH 3C,B03,752188,Staff,35,0,35,0
1731505718655,MATH 3C,B04,752210,Staff,33,0,35,2
1731505718655,MATH 3C,C01,752281,Yin; Wei,31,0,32,1
1731505718655,MATH 3C,C02,752282,Yin; Wei,31,0,32,1
1731505718655,MATH 3C,C03,752283,Yin; Wei,32,0,32,0
1731505718655,MATH 3C,C04,752284,Yin; Wei,32,0,32,0
1731505719682,MATH 4C,A01,752286,Aliabadi Sr.; Mohsen,31,0,35,4
1731505719682,MATH 4C,A02,752287,Aliabadi Sr.; Mohsen,35,0,35,0
1731505719682,MATH 4C,A03,752290,Aliabadi Sr.; Mohsen,35,0,35,0
1731505719682,MATH 4C,A04,752291,Aliabadi Sr.; Mohsen,35,0,35,0
1731505720724,MATH 10A,A01,752293,Hiatt; Patrick John,20,0,32,12
1731505720724,MATH 10A,A02,752294,Hiatt; Patrick John,28,0,32,4
1731505720724,MATH 10A,A03,752296,Hiatt; Patrick John,31,0,32,1
1731505720724,MATH 10A,A04,752297,Hiatt; Patrick John,30,0,32,2
1731505720724,MATH 10A,B01,752306,Hiatt; Patrick John,23,0,32,9
1731505720724,MATH 10A,B02,752362,Hiatt; Patrick John,31,0,32,1
1731505720724,MATH 10A,B03,752366,Hiatt; Patrick John,32,0,32,0
1731505720724,MATH 10A,B04,752372,Hiatt; Patrick John,30,0,32,2
1731505720724,MATH 10A,B05,752415,Hiatt; Patrick John,32,0,32,0
1731505720724,MATH 10A,B06,752463,Hiatt; Patrick John,32,0,32,0
1731505720724,MATH 10A,C01,752582,Hardiman; Liam,53,0,58,5
1731505720724,MATH 10A,C02,752589,Hardiman; Liam,57,0,60,3
1731505720724,MATH 10A,C03,752591,Hardiman; Liam,31,0,32,1
1731505720724,MATH 10A,C04,752592,Hardiman; Liam,32,0,32,0
1731505720724,MATH 10A,C05,796290,Hardiman; Liam,59,0,60,1
1731505720724,MATH 10A,C06,796293,Hardiman; Liam,60,0,60,0
1731505720724,MATH 10A,D01,752596,Briones; Jor-el Thomas Caparas,84,0,100,16
1731505720724,MATH 10A,D02,752597,Briones; Jor-el Thomas Caparas,99,0,100,1
1731505721758,MATH 10B,A01,752608,Zhao; Yizhen,0,0,0,0
1731505721758,MATH 10B,A02,752609,Zhao; Yizhen,0,0,0,0
1731505721758,MATH 10B,A03,752620,Zhao; Yizhen,0,0,0,0
1731505721758,MATH 10B,A04,752621,Zhao; Yizhen,0,0,0,0
1731505721758,MATH 10B,A05,752622,Zhao; Yizhen,0,0,0,0
1731505721758,MATH 10B,A06,752626,Zhao; Yizhen,0,0,0,0
1731505721758,MATH 10B,B01,752730,Zhao; Yizhen,0,0,0,0
1731505721758,MATH 10B,B02,752731,Zhao; Yizhen,0,0,0,0
1731505721758,MATH 10B,B03,752733,Zhao; Yizhen,0,0,0,0
1731505721758,MATH 10B,B04,752736,Zhao; Yizhen,0,0,0,0
1731505721758,MATH 10B,B05,796263,Zhao; Yizhen,0,0,0,0
1731505721758,MATH 10B,B06,796264,Zhao; Yizhen,0,0,0,0
1731505721758,MATH 10B,C01,752739,Goffer; Gil,0,0,0,0
1731505721758,MATH 10B,C02,752740,Goffer; Gil,0,0,0,0
1731505721758,MATH 10B,C03,752771,Goffer; Gil,0,0,0,0
1731505721758,MATH 10B,C04,752779,Goffer; Gil,0,0,0,0
1731505721758,MATH 10B,D01,752787,Buzaglo; Lucas,0,0,0,0
1731505721758,MATH 10B,D02,752793,Buzaglo; Lucas,0,0,0,0
1731505721758,MATH 10B,D03,752794,Buzaglo; Lucas,0,0,0,0
1731505721758,MATH 10B,D04,752800,Buzaglo; Lucas,0,0,0,0
1731505721758,MATH 10B,E01,752805,Bach; Quang Tran,0,0,0,0
1731505721758,MATH 10B,E02,752810,Bach; Quang Tran,0,0,0,0
1731505722791,MATH 10C,A01,752869,Nag; Panchali,32,0,32,0
1731505722791,MATH 10C,A02,752899,Nag; Panchali,29,0,32,3
1731505722791,MATH 10C,A03,752901,Nag; Panchali,32,0,32,0
1731505722791,MATH 10C,A04,752902,Nag; Panchali,32,0,32,0
1731505722791,MATH 10C,A05,752903,Nag; Panchali,32,0,32,0
1731505722791,MATH 10C,A06,752904,Nag; Panchali,31,0,32,1
1731505722791,MATH 10C,B01,752908,Nag; Panchali,11,0,27,16
1731505722791,MATH 10C,B02,752913,Nag; Panchali,28,0,30,2
1731505722791,MATH 10C,B03,752914,Nag; Panchali,28,0,30,2
1731505722791,MATH 10C,B04,752916,Nag; Panchali,28,0,30,2
1731505723843,MATH 11,A01,752921,Rava; Denise,35,0,36,1
1731505723843,MATH 11,A02,752922,Rava; Denise,29,0,36,7
1731505723843,MATH 11,A03,752924,Rava; Denise,34,0,36,2
1731505723843,MATH 11,A04,752932,Rava; Denise,36,0,36,0
1731505723843,MATH 11,A05,752936,Rava; Denise,35,0,36,1
1731505723843,MATH 11,A06,752984,Rava; Denise,35,0,36,1
1731505723843,MATH 11,B01,752988,Staff,29,0,35,6
1731505723843,MATH 11,B02,752991,Staff,33,0,35,2
1731505723843,MATH 11,B03,752994,Staff,54,0,56,2
1731505723843,MATH 11,B04,752998,Staff,60,0,60,0
1731505724888,MATH 18,A01,753003,Anzaldo; Leesa B,27,0,60,33
1731505724888,MATH 18,A02,753004,Anzaldo; Leesa B,53,0,60,7
1731505724888,MATH 18,A03,753005,Anzaldo; Leesa B,58,0,60,2
1731505724888,MATH 18,A04,753006,Anzaldo; Leesa B,59,0,60,1
1731505724888,MATH 18,A05,753009,Anzaldo; Leesa B,59,0,60,1
1731505724888,MATH 18,A06,753010,Anzaldo; Leesa B,60,0,60,0
1731505724888,MATH 18,A07,753011,Anzaldo; Leesa B,28,0,32,4
1731505724888,MATH 18,A08,753013,Anzaldo; Leesa B,20,0,22,2
1731505724888,MATH 18,A09,753014,Anzaldo; Leesa B,30,0,32,2
1731505724888,MATH 18,A10,753041,Anzaldo; Leesa B,32,0,32,0
1731505724888,MATH 18,A11,753066,Anzaldo; Leesa B,32,0,32,0
1731505724888,MATH 18,A12,753067,Anzaldo; Leesa B,30,0,32,2
1731505724888,MATH 18,B01,753070,Ganesan; Priyanga,96,0,100,4
1731505724888,MATH 18,B02,753071,Ganesan; Priyanga,99,0,100,1
1731505724888,MATH 18,C01,753074,Ganesan; Priyanga,39,0,45,6
1731505724888,MATH 18,C02,753075,Ganesan; Priyanga,44,0,45,1
1731505724888,MATH 18,C03,753076,Ganesan; Priyanga,44,0,45,1
1731505724888,MATH 18,C04,753077,Ganesan; Priyanga,45,0,45,0
1731505725918,MATH 20A,A01,753159,Ho; Ching Wei,29,0,30,1
1731505725918,MATH 20A,A02,753160,Ho; Ching Wei,10,0,26,16
1731505725918,MATH 20A,A03,753161,Ho; Ching Wei,27,0,30,3
1731505725918,MATH 20A,A04,753162,Ho; Ching Wei,29,0,30,1
1731505725918,MATH 20A,B01,753169,Ho; Ching Wei,55,0,60,5
1731505725918,MATH 20A,B02,753170,Ho; Ching Wei,56,0,60,4
1731505725918,MATH 20A,B03,753171,Ho; Ching Wei,34,0,35,1
1731505725918,MATH 20A,B04,753172,Ho; Ching Wei,35,0,35,0
1731505726950,MATH 20B,A01,753174,Habib; Yousaf,34,0,34,0
1731505726950,MATH 20B,A02,753175,Habib; Yousaf,33,0,34,1
1731505726950,MATH 20B,A03,753176,Habib; Yousaf,34,0,34,0
1731505726950,MATH 20B,A04,753177,Habib; Yousaf,34,0,34,0
1731505726950,MATH 20B,B01,753179,Habib; Yousaf,31,0,33,2
1731505726950,MATH 20B,B02,753180,Habib; Yousaf,33,0,33,0
1731505726950,MATH 20B,B03,753181,Habib; Yousaf,33,0,33,0
1731505726950,MATH 20B,B04,753188,Habib; Yousaf,33,0,33,0
1731505726950,MATH 20B,B05,753194,Habib; Yousaf,33,0,33,0
1731505726950,MATH 20B,B06,753195,Habib; Yousaf,33,0,33,0
1731505726950,MATH 20B,C01,753260,Upadrashta; Pranav Kumar,69,0,75,6
1731505726950,MATH 20B,C02,753261,Upadrashta; Pranav Kumar,75,0,75,0
1731505726950,MATH 20B,D01,753352,Upadrashta; Pranav Kumar,65,0,65,0
1731505726950,MATH 20B,D02,753356,Upadrashta; Pranav Kumar,65,0,65,0
1731505726950,MATH 20B,D03,753357,Upadrashta; Pranav Kumar,25,0,32,7
1731505726950,MATH 20B,D04,753361,Upadrashta; Pranav Kumar,31,0,32,1
1731505726950,MATH 20B,E01,753380,Xu; Fengmin,20,0,26,6
1731505726950,MATH 20B,E02,753384,Xu; Fengmin,30,0,32,2
1731505726950,MATH 20B,E03,753385,Xu; Fengmin,32,0,32,0
1731505726950,MATH 20B,E04,753388,Xu; Fengmin,31,0,32,1
1731505726950,MATH 20B,E05,753392,Xu; Fengmin,32,0,32,0
1731505726950,MATH 20B,E06,753393,Xu; Fengmin,32,0,32,0
1731505727990,MATH 20C,A01,753398,Ohm; Ko Woon,77,0,94,17
1731505727990,MATH 20C,A02,753402,Ohm; Ko Woon,98,0,100,2
1731505727990,MATH 20C,A03,753409,Ohm; Ko Woon,98,0,100,2
1731505727990,MATH 20C,A04,753412,Ohm; Ko Woon,100,0,100,0
1731505727990,MATH 20C,A05,753503,Ohm; Ko Woon,25,0,40,15
1731505727990,MATH 20C,A06,753504,Ohm; Ko Woon,35,0,40,5
1731505727990,MATH 20C,A07,753509,Ohm; Ko Woon,39,0,40,1
1731505727990,MATH 20C,A08,753510,Ohm; Ko Woon,40,0,40,0
1731505727990,MATH 20C,B01,753513,Staff,58,0,60,2
1731505727990,MATH 20C,B02,753514,Staff,60,0,60,0
1731505727990,MATH 20C,B03,753516,Staff,60,0,60,0
1731505727990,MATH 20C,C01,753518,Yin; Wei,59,0,60,1
1731505727990,MATH 20C,C02,753519,Yin; Wei,32,0,32,0
1731505727990,MATH 20C,C03,753520,Yin; Wei,24,0,32,8
1731505727990,MATH 20C,C04,753521,Yin; Wei,32,0,32,0
1731505727990,MATH 20C,C05,753524,Yin; Wei,32,0,32,0
1731505729019,MATH 20D,A01,753531,Staff,28,0,35,7
1731505729019,MATH 20D,A02,753532,Staff,28,0,29,1
1731505729019,MATH 20D,A03,753533,Staff,35,0,35,0
1731505729019,MATH 20D,A04,753535,Staff,35,0,35,0
1731505729019,MATH 20D,B01,753549,Hardiman; Liam,31,0,35,4
1731505729019,MATH 20D,B02,753592,Hardiman; Liam,35,0,35,0
1731505729019,MATH 20D,B03,753594,Hardiman; Liam,35,0,35,0
1731505729019,MATH 20D,B04,753595,Hardiman; Liam,34,0,35,1
1731505729019,MATH 20D,C01,753600,Gartland; Christopher John,96,0,100,4
1731505729019,MATH 20D,C02,753622,Gartland; Christopher John,98,0,100,2
1731505729019,MATH 20D,D01,753628,Gartland; Christopher John,35,0,35,0
1731505729019,MATH 20D,D02,753635,Gartland; Christopher John,35,0,35,0
1731505729019,MATH 20D,D03,753636,Gartland; Christopher John,60,0,60,0
1731505729019,MATH 20D,D04,753643,Gartland; Christopher John,60,0,60,0
1731505730060,MATH 20E,A01,753646,Bach; Quang Tran,24,0,32,8
1731505730060,MATH 20E,A02,753668,Bach; Quang Tran,33,0,35,2
1731505730060,MATH 20E,A03,753669,Bach; Quang Tran,35,0,35,0
1731505730060,MATH 20E,A04,753670,Bach; Quang Tran,35,0,35,0
1731505730060,MATH 20E,A05,753671,Bach; Quang Tran,30,0,30,0
1731505730060,MATH 20E,A06,753672,Bach; Quang Tran,30,0,30,0
1731505730060,MATH 20E,A07,796295,Bach; Quang Tran,60,0,60,0
1731505730060,MATH 20E,A08,796317,Bach; Quang Tran,60,0,60,0
1731505730060,MATH 20E,B01,753699,Sanchez; Anthony,30,0,35,5
1731505730060,MATH 20E,B02,753700,Sanchez; Anthony,35,0,35,0
1731505730060,MATH 20E,B03,753701,Sanchez; Anthony,64,0,65,1
1731505730060,MATH 20E,B04,753702,Sanchez; Anthony,65,0,65,0
1731505731086,MATH 31BH,A01,753704,De Vleming; Kristin Elizab,35,0,35,0
1731505731086,MATH 31BH,A02,753705,De Vleming; Kristin Elizab,35,0,35,0
1731505732115,MATH 87,A00,795962,Rabin; Jeffrey Mark,18,0,20,2
1731505733141,MATH 95,A00,753706,Stevens; Laura Jeanne,31,0,35,4
1731505734168,MATH 100A,A01,753708,Aycock; Jon Merrill,31,0,35,4
1731505734168,MATH 100A,A02,753709,Aycock; Jon Merrill,35,0,35,0
1731505735197,MATH 100B,A01,753711,Rogalski; Daniel,23,0,35,12
1731505735197,MATH 100B,A02,753712,Rogalski; Daniel,32,0,35,3
1731505736223,MATH 102,A01,753714,Harel; Guershon,34,0,35,1
1731505736223,MATH 102,A02,753740,Harel; Guershon,35,0,35,0
1731505736223,MATH 102,B01,753742,Ophir; Amit,32,0,35,3
1731505736223,MATH 102,B02,753743,Ophir; Amit,35,0,35,0
1731505737253,MATH 103A,A01,753745,Buzaglo; Lucas,26,0,30,4
1731505737253,MATH 103A,A02,753746,Buzaglo; Lucas,29,0,30,1
1731505737253,MATH 103A,B01,753748,Goffer; Gil,35,0,35,0
1731505737253,MATH 103A,B02,753749,Goffer; Gil,35,0,35,0
1731505737253,MATH 103A,C01,753751,Wenzl; Hans G,35,0,35,0
1731505737253,MATH 103A,C02,753798,Wenzl; Hans G,34,0,35,1
1731505738283,MATH 103B,A01,753805,Klevdal; Christian Sleek,29,0,30,1
1731505738283,MATH 103B,A02,753806,Klevdal; Christian Sleek,29,0,30,1
1731505738283,MATH 103B,A03,796050,Klevdal; Christian Sleek,26,0,30,4
1731505738283,MATH 103B,B01,753841,Wesley; William J,27,0,35,8
1731505738283,MATH 103B,B02,753842,Wesley; William J,34,0,35,1
1731505738283,MATH 103B,C01,753872,Chou; Raymond Oliver,20,0,35,15
1731505738283,MATH 103B,C02,753873,Chou; Raymond Oliver,31,0,35,4
1731505739310,MATH 104B,A01,753875,Kane; Daniel Mertz,35,0,35,0
1731505740352,MATH 109,A01,753883,Ganapathy; Karthik,7,0,10,3
1731505740352,MATH 109,A02,753884,Ganapathy; Karthik,9,0,10,1
1731505740352,MATH 109,B01,753886,Ganapathy; Karthik,9,0,10,1
1731505740352,MATH 109,B02,753887,Ganapathy; Karthik,10,0,10,0
1731505740352,MATH 109,C01,753901,Lu; Yunze,4,0,10,6
1731505740352,MATH 109,C02,753902,Lu; Yunze,10,0,10,0
1731505740352,MATH 109,D01,753912,Nandi; Achinta Kumar,10,0,10,0
1731505740352,MATH 109,D02,753928,Nandi; Achinta Kumar,9,0,10,1
1731505740352,MATH 109,E01,753935,Xiao; Ming,7,0,10,3
1731505740352,MATH 109,E02,753958,Xiao; Ming,0,0,10,10
1731505741382,MATH 111B,A01,753960,Meyer; David A.,28,0,35,7
1731505742413,MATH 112A,A01,754063,Komarova; Natalia,24,0,27,3
1731505743439,MATH 120A,A01,754070,Treuer; John N,30,0,35,5
1731505743439,MATH 120A,A02,754116,Treuer; John N,35,0,35,0
1731505744464,MATH 121A,A01,754119,Stevens; Laura Jeanne,32,0,35,3
1731505745495,MATH 140A,A01,754121,Sanchez; Anthony,30,0,35,5
1731505745495,MATH 140A,A02,754122,Sanchez; Anthony,32,0,35,3
1731505746529,MATH 140B,A01,754126,Zlatos; Andrej,34,0,35,1
1731505746529,MATH 140B,A02,754127,Zlatos; Andrej,35,0,35,0
1731505746529,MATH 140B,B01,754130,Lu; Yunze,33,0,35,2
1731505746529,MATH 140B,B02,754132,Lu; Yunze,33,0,35,2
1731505747560,MATH 142A,A01,754205,Parise; Davide,31,0,35,4
1731505747560,MATH 142A,A02,754206,Parise; Davide,33,0,35,2
1731505747560,MATH 142A,B01,754232,Kunnawalkam Elayavalli; Sr,33,0,35,2
1731505747560,MATH 142A,B02,754233,Kunnawalkam Elayavalli; Sr,35,0,35,0
1731505747560,MATH 142A,C01,754236,Nandi; Achinta Kumar,32,0,35,3
1731505747560,MATH 142A,C02,754238,Nandi; Achinta Kumar,33,0,35,2
1731505748587,MATH 142B,A01,754240,Bejenaru; Ioan,20,0,35,15
1731505748587,MATH 142B,A02,754241,Bejenaru; Ioan,30,0,35,5
1731505748587,MATH 142B,B01,754243,Sarkar; Pratyush,33,0,35,2
1731505748587,MATH 142B,B02,754244,Sarkar; Pratyush,34,0,35,1
1731505748587,MATH 142B,C01,754246,Sarkar; Pratyush,34,0,35,1
1731505748587,MATH 142B,C02,754247,Sarkar; Pratyush,35,0,35,0
1731505749613,MATH 150A,A01,754249,Rabin; Jeffrey Mark,27,0,35,8
1731505750646,MATH 154,A01,754252,Grier; Daniel T,32,0,35,3
1731505750646,MATH 154,A02,754254,Grier; Daniel T,34,0,35,1
1731505750646,MATH 154,A03,754255,Grier; Daniel T,35,0,35,0
1731505750646,MATH 154,A04,754256,Grier; Daniel T,35,0,35,0
1731505750646,MATH 154,B01,754258,Tesler; Glenn,30,0,35,5
1731505750646,MATH 154,B02,754259,Tesler; Glenn,35,0,35,0
1731505750646,MATH 154,B03,754261,Tesler; Glenn,33,0,35,2
1731505750646,MATH 154,B04,754262,Tesler; Glenn,35,0,35,0
1731505751675,MATH 170A,A01,754266,Dumitriu; Ioana,26,0,35,9
1731505751675,MATH 170A,A02,754267,Dumitriu; Ioana,33,0,35,2
1731505751675,MATH 170A,A03,754268,Dumitriu; Ioana,34,0,35,1
1731505751675,MATH 170A,A04,754269,Dumitriu; Ioana,35,0,35,0
1731505751675,MATH 170A,B01,754271,Dumitriu; Ioana,35,0,35,0
1731505751675,MATH 170A,B02,754273,Dumitriu; Ioana,34,0,35,1
1731505751675,MATH 170A,B03,754275,Dumitriu; Ioana,32,0,35,3
1731505751675,MATH 170A,B04,754276,Dumitriu; Ioana,34,0,35,1
1731505752702,MATH 170B,A01,754278,Dixit; Rishabh,25,0,35,10
1731505752702,MATH 170B,A02,754336,Dixit; Rishabh,34,0,35,1
1731505752702,MATH 170B,A03,754337,Dixit; Rishabh,34,0,35,1
1731505752702,MATH 170B,A04,754339,Dixit; Rishabh,35,0,35,0
1731505753729,MATH 171A,A01,754341,Huang; Lei,21,0,35,14
1731505753729,MATH 171A,A02,754342,Huang; Lei,27,0,35,8
1731505753729,MATH 171A,A03,754343,Huang; Lei,33,0,35,2
1731505753729,MATH 171A,A04,754345,Huang; Lei,32,0,35,3
1731505754757,MATH 173B,A01,754350,Saab; Rayan,24,0,35,11
1731505754757,MATH 173B,A02,754351,Saab; Rayan,22,0,35,13
1731505754757,MATH 173B,A03,754352,Saab; Rayan,34,0,35,1
1731505754757,MATH 173B,A04,754354,Saab; Rayan,34,0,35,1
1731505755785,MATH 175,A01,754357,Briones; Jor-el Thomas Caparas,23,0,25,2
1731505756818,MATH 180A,A01,754360,Peca-Medlin; John Michael,27,0,30,3
1731505756818,MATH 180A,A02,754362,Peca-Medlin; John Michael,30,0,30,0
1731505756818,MATH 180A,A03,754363,Peca-Medlin; John Michael,35,0,35,0
1731505756818,MATH 180A,A04,754367,Peca-Medlin; John Michael,35,0,35,0
1731505756818,MATH 180A,B01,754372,Schweinsberg; Jason,29,0,30,1
1731505756818,MATH 180A,B02,754374,Schweinsberg; Jason,30,0,30,0
1731505756818,MATH 180A,B03,754376,Schweinsberg; Jason,28,0,30,2
1731505756818,MATH 180A,B04,754377,Schweinsberg; Jason,28,0,30,2
1731505756818,MATH 180A,B05,754380,Schweinsberg; Jason,29,0,30,1
1731505756818,MATH 180A,B06,754421,Schweinsberg; Jason,30,0,30,0
1731505757845,MATH 180B,A01,754423,Zheng; Tianyi,27,0,30,3
1731505757845,MATH 180B,A02,754424,Zheng; Tianyi,29,0,30,1
1731505757845,MATH 180B,A03,754425,Zheng; Tianyi,29,0,30,1
1731505757845,MATH 180B,A04,754426,Zheng; Tianyi,30,0,30,0
1731505757845,MATH 180B,B01,754428,Zheng; Tianyi,32,0,35,3
1731505757845,MATH 180B,B02,754429,Zheng; Tianyi,35,0,35,0
1731505757845,MATH 180B,B03,754438,Zheng; Tianyi,35,0,35,0
1731505757845,MATH 180B,B04,754452,Zheng; Tianyi,34,0,35,1
1731505758872,MATH 181A,A01,754454,Quarfoot; David James,27,0,30,3
1731505758872,MATH 181A,A02,754455,Quarfoot; David James,30,0,30,0
1731505758872,MATH 181A,A03,754456,Quarfoot; David James,28,0,30,2
1731505758872,MATH 181A,A04,754457,Quarfoot; David James,29,0,30,1
1731505758872,MATH 181A,B01,754459,Quarfoot; David James,23,0,30,7
1731505758872,MATH 181A,B02,754460,Quarfoot; David James,29,0,30,1
1731505758872,MATH 181A,B03,754461,Quarfoot; David James,26,0,30,4
1731505758872,MATH 181A,B04,754462,Quarfoot; David James,30,0,30,0
1731505759902,MATH 181E,A01,754465,Politis; Dimitris,23,0,35,12
1731505759902,MATH 181E,A02,754466,Politis; Dimitris,32,0,35,3
1731505760930,MATH 183,A01,754468,Vishwanath; Siddharth,9,0,10,1
1731505760930,MATH 183,A02,754469,Vishwanath; Siddharth,3,0,10,7
1731505760930,MATH 183,A03,754470,Vishwanath; Siddharth,0,0,10,10
1731505760930,MATH 183,A04,754473,Vishwanath; Siddharth,8,0,10,2
1731505761961,MATH 184,A01,754527,Chou; Raymond Oliver,28,0,35,7
1731505761961,MATH 184,A02,754529,Chou; Raymond Oliver,33,0,35,2
1731505761961,MATH 184,A03,754532,Chou; Raymond Oliver,35,0,35,0
1731505761961,MATH 184,A04,754534,Chou; Raymond Oliver,35,0,35,0
1731505762985,MATH 185,A01,754537,Rava; Denise,29,0,35,6
1731505762985,MATH 185,A02,754559,Rava; Denise,29,0,35,6
1731505764015,MATH 186,A01,754624,Tesler; Glenn,21,0,33,12
1731505764015,MATH 186,A02,754625,Tesler; Glenn,26,0,33,7
1731505764015,MATH 186,A03,754626,Tesler; Glenn,18,0,33,15
1731505765043,MATH 187A,A01,754628,Bucur; Alina Ioana,11,0,30,19
1731505765043,MATH 187A,A02,754641,Bucur; Alina Ioana,29,0,30,1
1731505765043,MATH 187A,A03,754650,Bucur; Alina Ioana,25,0,30,5
1731505765043,MATH 187A,A04,754654,Bucur; Alina Ioana,28,0,30,2
1731505765043,MATH 187A,A05,754658,Bucur; Alina Ioana,26,0,30,4
1731505765043,MATH 187A,A06,754664,Bucur; Alina Ioana,29,0,30,1
1731505766069,MATH 189,A01,754672,Vishwanath; Siddharth,0,0,10,10
1731505766069,MATH 189,A02,754679,Vishwanath; Siddharth,0,0,10,10
1731505766069,MATH 189,A03,754681,Vishwanath; Siddharth,0,0,10,10
1731505766069,MATH 189,A04,754690,Vishwanath; Siddharth,0,0,10,10
1731505766069,MATH 189,A05,754694,Vishwanath; Siddharth,0,0,10,10
1731505766069,MATH 189,A06,754696,Vishwanath; Siddharth,0,0,10,10
1731505767095,MATH 190A,A01,754709,McKernan; James,25,0,35,10
1731505768120,MATH 196,A00,795968,Sorensen; Claus M,34,0,40,6
1731505769147,MATH 200B,A00,754711,Salehi Golsefidy; Alireza,18,0,20,2
1731505770177,MATH 202B,A00,754712,Novak; Jonathan I,16,0,20,4
1731505771203,MATH 203B,A00,754713,Oprea; Dragos N.,20,0,20,0
1731505772230,MATH 204B,A00,754715,Kedlaya; Kiran S.,20,0,20,0
1731505773254,MATH 207A,A00,754716,Mohammadi; Amir,17,0,20,3
1731505774281,MATH 208,A00,754718,Oprea; Dragos N.,10,0,10,0
1731505775306,MATH 209,A00,754719,Bucur; Alina Ioana,10,0,10,0
1731505776336,MATH 211A,A00,754720,Salehi Golsefidy; Alireza,9,0,10,1
1731505777366,MATH 211B,A00,754722,Sanchez; Anthony,10,0,10,0
1731505778393,MATH 212A,A01,754725,Komarova; Natalia,0,0,5,5
1731505779424,MATH 216B,A00,754727,Saab; Rayan,14,0,20,6
1731505780450,MATH 218,A00,754729,Komarova; Natalia,10,0,10,0
1731505781475,MATH 220B,A00,754730,Xiao; Ming,16,0,20,4
1731505782502,MATH 231B,A00,754731,Zlatos; Andrej,20,0,20,0
1731505783528,MATH 240B,A00,754733,Spolaor; Luca,18,0,20,2
1731505784554,MATH 243,A00,754734,Kunnawalkam Elayavalli; Sr,10,0,10,0
1731505785589,MATH 247A,A00,754736,Frisch; Joshua R,25,0,25,0
1731505786618,MATH 248,A00,754738,Bejenaru; Ioan,10,0,10,0
1731505787647,MATH 250B,A00,754740,Ni; Lei,17,0,20,3
1731505788674,MATH 257A,A00,754741,Spolaor; Luca,18,0,20,2
1731505788674,MATH 257A,B00,754742,Roberts; Justin Deritter,18,0,20,2
1731505789701,MATH 258,A00,754743,Ni; Lei,10,0,10,0
1731505790727,MATH 264B,A00,754745,Rhoades; Brendon Patrick,19,0,20,1
1731505791752,MATH 269,A00,754749,Warnke; Lutz Peter,10,0,10,0
1731505792779,MATH 270B,A00,754750,Leok; Melvin,13,0,20,7
1731505793806,MATH 271B,A00,754752,Nie; Jiawang,15,0,20,5
1731505794834,MATH 272B,A00,754754,Miller; Pearson,19,0,20,1
1731505795860,MATH 275,A01,754757,Briones; Jor-el Thomas Caparas,8,0,10,2
1731505796887,MATH 277A,A00,754763,Ding; Lijun,24,0,25,1
1731505796887,MATH 277A,B00,795972,Patil; Vishal Prakash,16,0,20,4
1731505797923,MATH 278A,A00,754765,Cheng; Li-Tien,10,0,10,0
1731505798954,MATH 278B,A00,754768,Cloninger; Alexander,9,0,10,1
1731505799980,MATH 278C,A00,754770,Nie; Jiawang,10,0,10,0
1731505801008,MATH 280B,A00,754780,Kemp; Todd Aahron,15,0,20,5
1731505802034,MATH 281B,A00,754788,Bradic; Jelena,1,0,20,19
1731505803064,MATH 282B,A00,754796,Arias-Castro; Ery,6,0,20,14
1731505804090,MATH 288,A00,754800,Ang; Jie Jun,10,0,10,0
1731505805116,MATH 290B,A00,754801,Sorensen; Claus M,19,0,20,1
1731505806143,MATH 292,A00,754802,Lu; Yunze,9,0,10,1
1731505807168,MATH 295,A00,754804,Bejenaru; Ioan,15,0,15,0
1731505808198,MATH 297,001,754807,Gamst; Anthony Collins,0,0,0,0
1731505809224,MATS 200,A00,751610,Graeve; Olivia A,9976,0,9999,23
1731505810255,MATS 201A,A00,751611,Luo; Jian,19,0,55,36
1731505811283,MATS 231,A00,751612,Cai; Shengqiang,14,0,25,11
1731505812308,MATS 255,A00,751613,Meyers; Marc,3,0,20,17
1731505813335,MATS 261A,A00,751614,Qiao; Yu,17,0,25,8
1731505814364,MATS 295,A00,751660,Graeve; Olivia A,9999,0,9999,0
1731505815394,MATS 296,A00,751661,Kim; Hyonny,9999,0,9999,0
1731505815394,MATS 296,B00,751665,Bandaru; Prabhakar,9999,0,9999,0
1731505816420,MBC 259,A00,799573,Murray; Samantha J.,2,0,26,24
1731505817452,MCWP 40,001,755308,Wastal; Carrie King,15,0,15,0
1731505817452,MCWP 40,002,755309,Wastal; Carrie King,15,0,15,0
1731505817452,MCWP 40,003,755310,Montejo; Carolina,20,0,20,0
1731505817452,MCWP 40,006,755313,Duru; Nur,15,0,20,5
1731505817452,MCWP 40,007,755316,Duru; Nur,19,0,20,1
1731505817452,MCWP 40,008,755317,Duru; Nur,20,0,20,0
1731505817452,MCWP 40,012,755322,Wastal; Carrie King,15,0,15,0
1731505817452,MCWP 40,013,755323,Wastal; Carrie King,14,0,15,1
1731505817452,MCWP 40,017,755327,Bartulis; Jason Michael,11,0,20,9
1731505817452,MCWP 40,018,755328,Bartulis; Jason Michael,15,0,20,5
1731505817452,MCWP 40,019,755329,Bartulis; Jason Michael,15,0,20,5
1731505818502,MCWP 50,001,755330,Wastal; Carrie King,10,0,15,5
1731505818502,MCWP 50,002,755331,Redela; Pamela Morgan,20,0,20,0
1731505818502,MCWP 50,003,755332,Redela; Pamela Morgan,18,0,20,2
1731505818502,MCWP 50,004,755333,Redela; Pamela Morgan,18,0,20,2
1731505818502,MCWP 50,005,755334,Compas; Sean Matthew,14,0,20,6
1731505818502,MCWP 50,006,755335,Compas; Sean Matthew,17,0,20,3
1731505818502,MCWP 50,007,755336,Compas; Sean Matthew,17,0,20,3
1731505818502,MCWP 50,008,755337,Carter; Andrea L,19,0,20,1
1731505818502,MCWP 50,009,755338,Carter; Andrea L,20,0,20,0
1731505818502,MCWP 50,010,755339,Carter; Andrea L,20,0,20,0
1731505818502,MCWP 50,011,755340,Smith; Haydee Marie,16,0,20,4
1731505818502,MCWP 50,012,755341,Smith; Haydee Marie,17,0,20,3
1731505818502,MCWP 50,013,755342,Smith; Haydee Marie,20,0,20,0
1731505818502,MCWP 50,014,755344,Pham; Vincent Minhduc,20,0,20,0
1731505818502,MCWP 50,015,755345,Pham; Vincent Minhduc,20,0,20,0
1731505818502,MCWP 50,016,755346,Pham; Vincent Minhduc,20,0,20,0
1731505818502,MCWP 50,017,755347,Morshed; Michael James,13,0,20,7
1731505818502,MCWP 50,018,755382,Silva; Kelly B,20,0,20,0
1731505818502,MCWP 50,019,755685,Silva; Kelly B,20,0,20,0
1731505818502,MCWP 50,020,755686,Carter; Jennifer A,19,0,20,1
1731505818502,MCWP 50,021,755687,Carter; Jennifer A,20,0,20,0
1731505818502,MCWP 50,022,755688,Carter; Jennifer A,18,0,20,2
1731505818502,MCWP 50,024,755694,Nies; Laurie Elizabeth,16,0,20,4
1731505818502,MCWP 50,025,755695,Nies; Laurie Elizabeth,15,0,20,5
1731505818502,MCWP 50,026,755704,Krone; Jarret,17,0,20,3
1731505818502,MCWP 50,027,755711,Krone; Jarret,19,0,20,1
1731505818502,MCWP 50,028,755739,Krone; Jarret,18,0,20,2
1731505818502,MCWP 50,031,755747,Morshed; Michael James,17,0,20,3
1731505818502,MCWP 50,032,755748,Morshed; Michael James,8,0,20,12
1731505819529,MCWP 125,A00,755868,Guillen; Melinda,15,0,20,5
1731505819529,MCWP 125,B00,755870,Guillen; Melinda,8,0,20,12
1731505820582,MCWP 125R,A00,755873,Miller; Elizabeth Deen,13,0,20,7
1731505820582,MCWP 125R,B00,755874,Miller; Elizabeth Deen,18,0,20,2
1731505820582,MCWP 125R,C00,795037,Miller; Elizabeth Deen,19,0,20,1
1731505821615,MED 238,A00,755306,Chen; Ju & Sun; Wei & Shyy; Yeun-Jund & Sheikh; Farah & Ross; Robert Scott & King; Kevin R & Evans; Sylvia M & Cho; Yoshitake,5,0,10,5
1731505822646,MED 246,A00,796576,Gordts; Philip & Lewis; Amanda Lark & Godula; Kamil & Gagneux; Pascal & Esko; Jeffrey D. & Bode; Lars,10,0,10,0
1731505823677,MED 262,A00,796570,Koola; Jejo David,24,0,30,6
1731505824706,MED 263,A00,796550,Curtius; Kathleen Mary & D'Antonio; Matteo,1,0,18,17
1731505825737,MED 278,A00,796573,Carter; Hannah Kathryn,10,0,15,5
1731505826764,MED 283,A00,755307,Ideker; Trey,0,0,0,0
1731505827794,MED 296,001,791666,Malinak; David James,9,0,10,1
1731505827794,MED 296,002,791667,Von Drygalski; Annette,9,0,10,1
1731505827794,MED 296,003,791668,Chi; Neil C.,8,0,10,2
1731505827794,MED 296,004,791670,Castellanos; Luis R.,9,0,10,1
1731505828828,MGT 3,A00,766229,Wagner; Timothy Ryan,95,0,98,3
1731505829863,MGT 4,A01,766234,Levkoff; Steven B.,4,0,8,4
1731505829863,MGT 4,A02,766235,Levkoff; Steven B.,6,0,8,2
1731505829863,MGT 4,A03,766273,Levkoff; Steven B.,8,0,9,1
1731505829863,MGT 4,B01,798342,Brooks; Marcus Raymond,31,0,32,1
1731505830890,MGT 5,A00,766275,Molloie Jr.; William H,181,0,186,5
1731505831921,MGT 12,A00,766277,Pecore; Joseph P.,72,0,100,28
1731505832959,MGT 16,A00,766279,Buchanan; Harold G,97,0,100,3
1731505832959,MGT 16,B00,766282,Buchanan; Harold G,96,0,100,4
1731505832959,MGT 16,C00,766285,Campbell; Robert Harold,117,0,120,3
1731505832959,MGT 16,D00,766288,Campbell; Robert Harold,119,0,120,1
1731505832959,MGT 16,E00,766290,Demill; Burritt,98,0,98,0
1731505832959,MGT 16,F00,766291,Lindenberger; Wade Douglas,85,0,100,15
1731505833987,MGT 18,A00,766299,McKay; Michael J,97,0,98,1
1731505833987,MGT 18,B00,766308,McKay; Michael J,93,0,98,5
1731505833987,MGT 18,C00,766310,McKay; Michael J,96,0,98,2
1731505833987,MGT 18,D00,766311,Chamberlain; Travis Dean,97,0,98,1
1731505835012,MGT 45,A00,766315,Pecore; Joseph P.,141,0,150,9
1731505835012,MGT 45,B00,766322,Pecore; Joseph P.,148,0,150,2
1731505836040,MGT 52,A00,766324,Deal; Jennifer Jean,89,0,98,9
1731505837067,MGT 71R,A00,766325,Phiroz; Zal Navroze,66,0,98,32
1731505838092,MGT 100,A00,766328,Yavorsky; Daniel Ryan,107,0,120,13
1731505838092,MGT 100,B00,796601,Yavorsky; Daniel Ryan,111,0,120,9
1731505839126,MGT 103,A00,766334,Bates; Kenneth Walter,91,0,98,7
1731505839126,MGT 103,C00,766338,Eberhard; Craig A,98,0,98,0
1731505839126,MGT 103,D00,766341,Eberhard; Craig A,96,0,98,2
1731505839126,MGT 103,E00,766343,Ehrich; Kristine R,92,0,98,6
1731505839126,MGT 103,F00,766344,Ehrich; Kristine R,93,0,98,5
1731505839126,MGT 103,G00,766604,Ehrich; Kristine R,97,0,98,1
1731505840153,MGT 105,A00,796605,Bates; Kenneth Walter,91,0,98,7
1731505841183,MGT 106,A00,766605,Eberhard; Craig A,96,0,98,2
1731505842214,MGT 107,A00,766688,Jaroszewicz; Ania,97,0,98,1
1731505842214,MGT 107,B00,766721,Jaroszewicz; Ania,80,0,98,18
1731505842214,MGT 107,C00,796609,Jaroszewicz; Ania,93,0,98,5
1731505843240,MGT 109,A00,766779,Staff,88,0,98,10
1731505844265,MGT 112,A00,766780,Somasundaram; Tyagarajan,52,0,60,8
1731505844265,MGT 112,B00,766781,Somasundaram; Tyagarajan,54,0,70,16
1731505845292,MGT 119,A00,766782,Etingue Kum; Menes,96,0,98,2
1731505846318,MGT 121A,A00,766783,Klaas; Jeffrey David,92,0,98,6
1731505847347,MGT 123,A00,796610,Felke; Magnus Roland,97,0,98,1
1731505848373,MGT 127R,A00,766784,Zhu; Kevin Xiaoguo,68,0,80,12
1731505849398,MGT 131A,A00,766802,Houskeeper; Robert,148,0,150,2
1731505850426,MGT 131B,A00,766833,Houskeeper; Robert,96,0,98,2
1731505851452,MGT 135,A00,766882,Anderson; John Charles,74,0,75,1
1731505852481,MGT 136,A00,766883,Lindenberger; Wade Douglas,90,0,98,8
1731505853507,MGT 137,A00,766893,Perez Cavazos; Gerardo,81,0,98,17
1731505854533,MGT 151R,A00,766954,Phiroz; Zal Navroze,92,0,98,6
1731505854533,MGT 151R,B00,766998,Phiroz; Zal Navroze,97,0,98,1
1731505855558,MGT 153,A00,766999,Perols; Johan Lars,57,0,90,33
1731505856590,MGT 160,A00,767000,Samek; Anya,87,0,90,3
1731505856590,MGT 160,B00,767001,Samek; Anya,74,0,90,16
1731505856590,MGT 160,C00,767038,Samek; Anya,86,0,90,4
1731505857623,MGT 162,A00,767085,Demill; Burritt,96,0,98,2
1731505857623,MGT 162,B00,767086,Demill; Burritt,92,0,98,6
1731505858649,MGT 162R,A00,767087,Gneezy; Uri,180,0,199,19
1731505859679,MGT 164,A00,767088,McKay; Mary A,97,0,98,1
1731505859679,MGT 164,B00,767089,McKay; Mary A,98,0,98,0
1731505859679,MGT 164,C00,767095,McKay; Mary A,96,0,98,2
1731505859679,MGT 164,D00,767097,Meyer; Alison Bloomfield,95,0,98,3
1731505859679,MGT 164,E00,767104,Smith; Pamela Karen,84,0,98,14
1731505860706,MGT 166,A00,767106,Moran; Cathleen L.,57,0,60,3
1731505860706,MGT 166,B00,767107,Moran; Cathleen L.,96,0,98,2
1731505860706,MGT 166,C00,767110,Moran; Cathleen L.,97,0,98,1
1731505861739,MGT 167,A00,767114,Jacob; Jo Dee C,97,0,98,1
1731505862776,MGT 172,A00,767115,Hedges; Kathleen & Royal; Rebecca,118,0,120,2
1731505862776,MGT 172,B00,767118,Hedges; Kathleen,94,0,98,4
1731505862776,MGT 172,C00,767121,Zimmermann; Carsten,98,0,98,0
1731505862776,MGT 172,D00,767124,Zimmermann; Carsten,97,0,98,1
1731505863802,MGT 173,A00,767130,Hayes; Sherry Lorine,91,0,98,7
1731505863802,MGT 173,B00,767135,Hayes; Sherry Lorine,97,0,98,1
1731505864827,MGT 175,A00,767137,Gopal; Christopher S.,97,0,98,1
1731505865852,MGT 176,A00,767139,Gopal; Christopher S.,89,0,98,9
1731505866883,MGT 180R,A00,767140,Engelberg; Joseph Edward,287,0,300,13
1731505867916,MGT 181,A00,767145,Bliss; Barbara Ann,83,0,98,15
1731505867916,MGT 181,B00,767155,Buchanan; Harold G,109,0,120,11
1731505868943,MGT 187,A00,767157,Dunn; Louis Jean,93,0,98,5
1731505868943,MGT 187,B00,767194,Dunn; Louis Jean,92,0,98,6
1731505869971,MGT 189,A00,767242,Dunn; Louis Jean,91,0,98,7
1731505869971,MGT 189,B00,767281,Reher; Michael Christopher,84,0,98,14
1731505871000,MGT 241,A00,770734,Staff,0,0,0,0
1731505872027,MGT 249,A00,767282,August; Terrence & Shin; Hyo Duk & Erat; Sanjiv,19,0,20,1
1731505873055,MGT 256,A00,767296,Liu; Wei,0,0,0,3
1731505874086,MGT 259,A00,767311,Smith; Pamela Karen,17,0,20,3
1731505875123,MGT 296,001,795366,Gneezy; Ayelet,3,0,3,0
1731505875123,MGT 296,002,795367,Amir; On,3,0,3,0
1731505875123,MGT 296,003,795368,Amir; On & Karmarkar; Uma R,2,0,3,1
1731505875123,MGT 296,004,795373,Liu; Jun,3,0,3,0
1731505875123,MGT 296,005,795374,Hansen; Karsten T.,2,0,3,1
1731505875123,MGT 296,006,795376,Erat; Sanjiv,2,0,3,1
1731505875123,MGT 296,007,795377,Timmermann; Allan,1,0,3,2
1731505875123,MGT 296,008,795378,Smith; Pamela Karen,3,0,3,0
1731505875123,MGT 296,009,795380,Zhang; Zhe,3,0,3,0
1731505875123,MGT 296,010,795381,Oveis; Christopher S,3,0,3,0
1731505875123,MGT 296,011,795384,Amir; On & Gneezy; Ayelet,3,0,3,0
1731505875123,MGT 296,012,795385,Luo; Danqi,3,0,3,0
1731505876164,MMW 12,A01,750828,Chang; Edmond Yi-Teh,16,0,16,0
1731505876164,MMW 12,A02,750829,Chang; Edmond Yi-Teh,16,0,16,0
1731505876164,MMW 12,A03,750830,Chang; Edmond Yi-Teh,15,0,16,1
1731505876164,MMW 12,A04,750863,Chang; Edmond Yi-Teh,15,0,16,1
1731505876164,MMW 12,A05,750864,Chang; Edmond Yi-Teh,16,0,16,0
1731505876164,MMW 12,A06,750870,Chang; Edmond Yi-Teh,16,0,16,0
1731505876164,MMW 12,A07,750874,Chang; Edmond Yi-Teh,16,0,16,0
1731505876164,MMW 12,A08,750877,Chang; Edmond Yi-Teh,16,0,16,0
1731505876164,MMW 12,A09,750882,Chang; Edmond Yi-Teh,16,0,16,0
1731505876164,MMW 12,A10,750884,Chang; Edmond Yi-Teh,16,0,16,0
1731505876164,MMW 12,A11,750890,Chang; Edmond Yi-Teh,16,0,16,0
1731505876164,MMW 12,A12,750891,Chang; Edmond Yi-Teh,16,0,16,0
1731505876164,MMW 12,A13,750892,Chang; Edmond Yi-Teh,16,0,16,0
1731505876164,MMW 12,A14,750940,Chang; Edmond Yi-Teh,16,0,16,0
1731505876164,MMW 12,A15,750951,Chang; Edmond Yi-Teh,0,0,0,0
1731505876164,MMW 12,A16,750957,Chang; Edmond Yi-Teh,0,0,0,0
1731505876164,MMW 12,A17,750967,Chang; Edmond Yi-Teh,16,0,16,0
1731505876164,MMW 12,A18,750976,Chang; Edmond Yi-Teh,16,0,16,0
1731505876164,MMW 12,A19,750977,Chang; Edmond Yi-Teh,16,0,16,0
1731505876164,MMW 12,A20,750980,Chang; Edmond Yi-Teh,16,0,16,0
1731505876164,MMW 12,A21,750981,Chang; Edmond Yi-Teh,16,0,16,0
1731505876164,MMW 12,A22,751031,Chang; Edmond Yi-Teh,16,0,16,0
1731505876164,MMW 12,A23,751032,Chang; Edmond Yi-Teh,0,0,0,0
1731505876164,MMW 12,B01,751035,Adamiak; Patrick John,15,0,16,1
1731505876164,MMW 12,B02,751065,Adamiak; Patrick John,14,0,16,2
1731505876164,MMW 12,B03,751066,Adamiak; Patrick John,16,0,16,0
1731505876164,MMW 12,B04,751067,Adamiak; Patrick John,16,0,16,0
1731505876164,MMW 12,B05,751068,Adamiak; Patrick John,16,0,16,0
1731505876164,MMW 12,B06,751069,Adamiak; Patrick John,16,0,16,0
1731505876164,MMW 12,B07,751070,Adamiak; Patrick John,16,0,16,0
1731505876164,MMW 12,B08,751071,Adamiak; Patrick John,16,0,16,0
1731505876164,MMW 12,B09,751072,Adamiak; Patrick John,15,0,16,1
1731505876164,MMW 12,B10,751073,Adamiak; Patrick John,16,0,16,0
1731505876164,MMW 12,B11,751074,Adamiak; Patrick John,16,0,16,0
1731505876164,MMW 12,B12,751075,Adamiak; Patrick John,16,0,16,0
1731505876164,MMW 12,B13,751076,Adamiak; Patrick John,16,0,16,0
1731505876164,MMW 12,B14,751077,Adamiak; Patrick John,16,0,16,0
1731505876164,MMW 12,B15,751078,Adamiak; Patrick John,0,0,0,0
1731505876164,MMW 12,B16,751079,Adamiak; Patrick John,0,0,0,0
1731505876164,MMW 12,B17,751080,Adamiak; Patrick John,15,0,16,1
1731505876164,MMW 12,B18,751081,Adamiak; Patrick John,16,0,16,0
1731505876164,MMW 12,B19,751082,Adamiak; Patrick John,16,0,16,0
1731505876164,MMW 12,B20,751083,Adamiak; Patrick John,16,0,16,0
1731505876164,MMW 12,B21,751084,Adamiak; Patrick John,15,0,16,1
1731505876164,MMW 12,B22,751085,Adamiak; Patrick John,15,0,16,1
1731505876164,MMW 12,C01,751087,Herbst; Matthew,16,0,16,0
1731505876164,MMW 12,C02,751088,Herbst; Matthew,16,0,16,0
1731505876164,MMW 12,C03,751090,Herbst; Matthew,16,0,16,0
1731505876164,MMW 12,C04,751091,Herbst; Matthew,16,0,16,0
1731505876164,MMW 12,C05,751092,Herbst; Matthew,14,0,16,2
1731505876164,MMW 12,C06,751093,Herbst; Matthew,16,0,16,0
1731505876164,MMW 12,C07,751094,Herbst; Matthew,15,0,16,1
1731505876164,MMW 12,C08,751096,Herbst; Matthew,16,0,16,0
1731505876164,MMW 12,C09,751097,Herbst; Matthew,16,0,16,0
1731505876164,MMW 12,C10,751098,Herbst; Matthew,15,0,16,1
1731505876164,MMW 12,C11,751099,Herbst; Matthew,16,0,16,0
1731505876164,MMW 12,C12,751100,Herbst; Matthew,16,0,16,0
1731505876164,MMW 12,C13,751101,Herbst; Matthew,15,0,16,1
1731505876164,MMW 12,C14,751102,Herbst; Matthew,16,0,16,0
1731505876164,MMW 12,C15,751103,Herbst; Matthew,0,0,0,0
1731505876164,MMW 12,C16,751105,Herbst; Matthew,0,0,0,0
1731505876164,MMW 12,C17,751106,Herbst; Matthew,16,0,16,0
1731505876164,MMW 12,C18,751107,Herbst; Matthew,16,0,16,0
1731505876164,MMW 12,C19,751108,Herbst; Matthew,16,0,16,0
1731505876164,MMW 12,C20,751110,Herbst; Matthew,16,0,16,0
1731505876164,MMW 12,C21,751112,Herbst; Matthew,0,0,0,0
1731505876164,MMW 12,C22,751113,Herbst; Matthew,0,0,0,0
1731505877193,MMW 14,A01,751190,Chang; Edmond Yi-Teh,25,0,28,3
1731505877193,MMW 14,A02,751227,Chang; Edmond Yi-Teh,27,0,28,1
1731505877193,MMW 14,A03,751235,Chang; Edmond Yi-Teh,0,0,0,0
1731505877193,MMW 14,A04,751248,Chang; Edmond Yi-Teh,0,0,0,0
1731505877193,MMW 14,A05,751249,Chang; Edmond Yi-Teh,27,0,28,1
1731505877193,MMW 14,A06,751253,Chang; Edmond Yi-Teh,25,0,28,3
1731505877193,MMW 14,B01,751265,Hertz; Deborah,24,0,28,4
1731505877193,MMW 14,B02,751266,Hertz; Deborah,21,0,28,7
1731505877193,MMW 14,B03,751267,Hertz; Deborah,0,0,0,0
1731505877193,MMW 14,B04,751270,Hertz; Deborah,24,0,28,4
1731505877193,MMW 14,B05,751273,Hertz; Deborah,28,0,28,0
1731505877193,MMW 14,C01,751386,Herbst; Matthew,0,0,0,0
1731505878230,MMW 122,A01,751389,Peterson; Johanna L,23,0,27,4
1731505878230,MMW 122,A02,751424,Peterson; Johanna L,25,0,27,2
1731505878230,MMW 122,A03,751435,Peterson; Johanna L,27,0,27,0
1731505878230,MMW 122,A04,751437,Peterson; Johanna L,27,0,27,0
1731505878230,MMW 122,A05,751438,Peterson; Johanna L,27,0,27,0
1731505878230,MMW 122,A06,751440,Peterson; Johanna L,27,0,27,0
1731505878230,MMW 122,A07,751441,Peterson; Johanna L,0,0,0,0
1731505878230,MMW 122,A08,751442,Peterson; Johanna L,0,0,0,0
1731505878230,MMW 122,A09,751443,Peterson; Johanna L,27,0,27,0
1731505878230,MMW 122,A10,751444,Peterson; Johanna L,26,0,27,1
1731505878230,MMW 122,A11,751448,Peterson; Johanna L,0,0,0,0
1731505878230,MMW 122,A12,751493,Peterson; Johanna L,0,0,0,0
1731505878230,MMW 122,B01,751497,Rahimi; Babak,26,0,27,1
1731505878230,MMW 122,B02,751501,Rahimi; Babak,25,0,27,2
1731505878230,MMW 122,B03,751504,Rahimi; Babak,26,0,27,1
1731505878230,MMW 122,B04,751505,Rahimi; Babak,27,0,27,0
1731505878230,MMW 122,B05,751526,Rahimi; Babak,22,0,27,5
1731505878230,MMW 122,B06,751528,Rahimi; Babak,27,0,27,0
1731505878230,MMW 122,B07,751531,Rahimi; Babak,26,0,27,1
1731505878230,MMW 122,B08,751533,Rahimi; Babak,26,0,27,1
1731505878230,MMW 122,B09,751534,Rahimi; Babak,0,0,0,0
1731505878230,MMW 122,B10,751535,Rahimi; Babak,0,0,0,0
1731505878230,MMW 122,C01,751538,Herbst; Matthew,0,0,0,0
1731505879256,MSED 295,A00,751699,Staff,5,0,5,0
1731505880288,MUS 1B,A01,755885,Staff,20,0,25,5
1731505880288,MUS 1B,A02,755889,Staff,21,0,25,4
1731505880288,MUS 1B,A03,755890,Staff,23,0,25,2
1731505880288,MUS 1B,A04,755891,Staff,25,0,25,0
1731505881315,MUS 2B,A01,755895,Carlson; Erik,30,0,30,0
1731505882340,MUS 2BK,A00,755896,Ohnishi; Takae,12,0,15,3
1731505882340,MUS 2BK,B00,755897,Ohnishi; Takae,15,0,15,0
1731505883369,MUS 4,A01,755899,Day; Kevin Alexander,24,0,25,1
1731505883369,MUS 4,A02,755900,Day; Kevin Alexander,25,0,25,0
1731505883369,MUS 4,A03,755901,Day; Kevin Alexander,25,0,25,0
1731505883369,MUS 4,A04,755902,Day; Kevin Alexander,25,0,25,0
1731505883369,MUS 4,A05,755903,Day; Kevin Alexander,25,0,25,0
1731505883369,MUS 4,A06,755904,Day; Kevin Alexander,25,0,25,0
1731505883369,MUS 4,A07,755926,Day; Kevin Alexander,25,0,25,0
1731505883369,MUS 4,A08,755927,Day; Kevin Alexander,24,0,25,1
1731505883369,MUS 4,A09,755951,Day; Kevin Alexander,25,0,25,0
1731505883369,MUS 4,A10,755952,Day; Kevin Alexander,25,0,25,0
1731505884397,MUS 6,A01,755954,Freitas Caetano; Marcelo,25,0,25,0
1731505884397,MUS 6,A02,755955,Freitas Caetano; Marcelo,22,0,25,3
1731505884397,MUS 6,A03,755982,Freitas Caetano; Marcelo,22,0,25,3
1731505884397,MUS 6,A04,755983,Freitas Caetano; Marcelo,25,0,25,0
1731505885430,MUS 9,A01,756195,Staff,19,0,20,1
1731505885430,MUS 9,A02,756197,Staff,20,0,20,0
1731505885430,MUS 9,A03,756198,Staff,20,0,20,0
1731505885430,MUS 9,A04,756199,Staff,20,0,20,0
1731505885430,MUS 9,A05,756201,Staff,20,0,20,0
1731505885430,MUS 9,A06,756209,Staff,20,0,20,0
1731505886458,MUS 12,A01,756214,Davis; Anthony Curtis,25,0,25,0
1731505886458,MUS 12,A02,756219,Davis; Anthony Curtis,24,0,25,1
1731505886458,MUS 12,A03,756221,Davis; Anthony Curtis,25,0,25,0
1731505886458,MUS 12,A04,756223,Davis; Anthony Curtis,25,0,25,0
1731505887485,MUS 13,A01,756228,Leslie Santana; Myrta,22,0,25,3
1731505887485,MUS 13,A02,756233,Leslie Santana; Myrta,21,0,25,4
1731505887485,MUS 13,A03,756234,Leslie Santana; Myrta,25,0,25,0
1731505887485,MUS 13,A04,756237,Leslie Santana; Myrta,25,0,25,0
1731505888520,MUS 15,A01,756244,Narucki; Susan M,23,0,25,2
1731505888520,MUS 15,A02,756250,Narucki; Susan M,23,0,25,2
1731505888520,MUS 15,A03,756256,Narucki; Susan M,23,0,25,2
1731505888520,MUS 15,A04,756259,Narucki; Susan M,25,0,25,0
1731505888520,MUS 15,A05,756262,Narucki; Susan M,24,0,25,1
1731505888520,MUS 15,A06,756269,Narucki; Susan M,22,0,25,3
1731505888520,MUS 15,A07,756273,Narucki; Susan M,25,0,25,0
1731505888520,MUS 15,A08,756280,Narucki; Susan M,23,0,25,2
1731505888520,MUS 15,A09,756281,Narucki; Susan M,25,0,25,0
1731505888520,MUS 15,A10,756282,Narucki; Susan M,23,0,25,2
1731505889550,MUS 17,A01,756669,Staff,23,0,25,2
1731505889550,MUS 17,A02,756673,Staff,23,0,25,2
1731505889550,MUS 17,A03,756674,Staff,17,0,25,8
1731505889550,MUS 17,A04,756675,Staff,24,0,25,1
1731505889550,MUS 17,A05,756679,Staff,25,0,25,0
1731505889550,MUS 17,A06,756683,Staff,21,0,25,4
1731505889550,MUS 17,A07,756689,Staff,25,0,25,0
1731505889550,MUS 17,A08,756693,Staff,24,0,25,1
1731505889550,MUS 17,A09,756695,Staff,24,0,25,1
1731505889550,MUS 17,A10,756697,Staff,24,0,25,1
1731505889550,MUS 17,A11,756701,Staff,23,0,25,2
1731505889550,MUS 17,A12,756703,Staff,24,0,25,1
1731505890588,MUS 20R,A01,797703,Borgo; David Garcia,7,0,25,18
1731505890588,MUS 20R,A02,797705,Borgo; David Garcia,24,0,25,1
1731505890588,MUS 20R,A03,797779,Borgo; David Garcia,23,0,25,2
1731505890588,MUS 20R,A04,797780,Borgo; David Garcia,25,0,25,0
1731505890588,MUS 20R,A05,797816,Borgo; David Garcia,23,0,25,2
1731505890588,MUS 20R,A06,797825,Borgo; David Garcia,25,0,25,0
1731505890588,MUS 20R,A07,797826,Borgo; David Garcia,24,0,25,1
1731505890588,MUS 20R,A08,797831,Borgo; David Garcia,21,0,25,4
1731505890588,MUS 20R,B01,798362,Borgo; David Garcia,3,0,3,0
1731505890588,MUS 20R,B02,798369,Borgo; David Garcia,3,0,3,0
1731505890588,MUS 20R,B03,798370,Borgo; David Garcia,3,0,3,0
1731505890588,MUS 20R,B04,798372,Borgo; David Garcia,3,0,3,0
1731505890588,MUS 20R,B05,798375,Borgo; David Garcia,3,0,3,0
1731505890588,MUS 20R,B06,798377,Borgo; David Garcia,3,0,3,0
1731505890588,MUS 20R,B07,798378,Borgo; David Garcia,3,0,3,0
1731505890588,MUS 20R,B08,798379,Borgo; David Garcia,3,0,3,0
1731505891626,MUS 32,001,735915,Dresser; Mark Stuart,10,0,10,0
1731505891626,MUS 32,002,735917,Curtis; Charles Rector,10,0,10,0
1731505891626,MUS 32,003,735920,Terrazas Perez; Wilfrido D,10,0,10,0
1731505891626,MUS 32,004,735921,Ohnishi; Takae,10,0,10,0
1731505891626,MUS 32,005,735923,Carlson; Erik,10,0,10,0
1731505891626,MUS 32,006,735924,Staff,10,0,10,0
1731505891626,MUS 32,007,735926,Staff,10,0,10,0
1731505892656,MUS 32V,A00,756706,Staff,10,0,10,0
1731505892656,MUS 32V,B00,756709,Staff,10,0,10,0
1731505893682,MUS 32VM,A00,756713,Staff,15,0,15,0
1731505894714,MUS 43,A00,756714,Yadegari; Shahrokh D,90,0,96,6
1731505895741,MUS 95C,A00,756725,Staff,38,0,40,2
1731505896770,MUS 95D,A00,756726,Yadegari; Shahrokh D,30,0,30,0
1731505897796,MUS 95E,A00,756730,Staff,40,0,40,0
1731505898825,MUS 95F,A00,756732,Staff,40,0,40,0
1731505899856,MUS 95G,A00,756742,Anderson; Kenneth,386,0,395,9
1731505899856,MUS 95G,B00,756743,Anderson; Kenneth,389,0,395,6
1731505900883,MUS 95JC,A00,756745,Kenyatta; Kamau,25,0,25,0
1731505901983,MUS 95L,A00,756749,Staff,65,0,65,0
1731505903015,MUS 95P,A00,756975,Nourai; Keyavash,20,0,20,0
1731505904043,MUS 95W,A00,756976,Seshadri; Kartik,28,0,30,2
1731505904043,MUS 95W,B00,756977,Seshadri; Kartik,30,0,30,0
1731505905074,MUS 101B,A01,757168,Day; Kevin Alexander,35,0,35,0
1731505906101,MUS 103B,A00,757172,Steiger; Rand,15,0,15,0
1731505907130,MUS 103E,A00,757173,Staff,10,0,10,0
1731505908155,MUS 107,A00,757174,Roberts; Matana,15,0,15,0
1731505909186,MUS 111,A00,757176,Guy; Nancy,117,0,120,3
1731505910213,MUS 113,A00,757178,Curtis; Charles Rector,30,0,30,0
1731505911242,MUS 114,A00,757179,Terrazas Perez; Wilfrido D,135,0,140,5
1731505912272,MUS 120B,A01,757182,Leslie Santana; Myrta,25,0,25,0
1731505913300,MUS 127,A00,757183,Dresser; Mark Stuart,94,0,100,6
1731505914327,MUS 130,A00,757185,Ohnishi; Takae,35,0,35,0
1731505915362,MUS 132,001,736011,Dresser; Mark Stuart,10,0,10,0
1731505915362,MUS 132,002,736012,Curtis; Charles Rector,10,0,10,0
1731505915362,MUS 132,003,736013,Terrazas Perez; Wilfrido D,10,0,10,0
1731505915362,MUS 132,004,736014,Ohnishi; Takae,10,0,10,0
1731505915362,MUS 132,005,736015,Carlson; Erik,10,0,10,0
1731505915362,MUS 132,006,736016,Staff,10,0,10,0
1731505915362,MUS 132,007,736017,Nourai; Keyavash,10,0,10,0
1731505915362,MUS 132,008,736018,Schick; Steven,10,0,10,0
1731505916391,MUS 132R,A00,757187,Narucki; Susan M,2,0,2,0
1731505917420,MUS 132V,A00,757189,Narucki; Susan M,15,0,15,0
1731505917420,MUS 132V,B00,757190,Staff,15,0,15,0
1731505918447,MUS 134,A00,757192,Yadegari; Shahrokh D,30,0,30,0
1731505919471,MUS 137B,A00,757193,Kenyatta; Kamau,34,0,35,1
1731505920500,MUS 143,A00,757194,Yadegari; Shahrokh D,27,0,31,4
1731505921529,MUS 160A,A00,757195,Dubnov; Shlomo,14,0,15,1
1731505921529,MUS 160A,B00,757198,Smythe; Cory Benjamin,15,0,15,0
1731505922565,MUS 171,A01,757200,Smyth; Tamara R.,47,0,65,18
1731505923593,MUS 173B,A01,757203,Britt; King James,25,0,25,0
1731505924620,MUS 174B,A00,757204,Britt; King James,18,0,25,7
1731505925650,MUS 176,A00,757205,Lou; Michelle Siulai,20,0,20,0
1731505926685,MUS 201A,A00,757207,Dresser; Mark Stuart,15,0,15,0
1731505927715,MUS 201B,A00,757208,Yadegari; Shahrokh D,13,0,15,2
1731505927715,MUS 201B,B00,757210,Roberts; Matana,13,0,15,2
1731505928741,MUS 201C,A00,757211,Schick; Steven,15,0,15,0
1731505929769,MUS 202,A00,795573,Schick; Steven,14,0,15,1
1731505930796,MUS 203B,A00,757213,Obermueller; Karola,14,0,15,1
1731505931822,MUS 203D,A00,757214,Davis; Anthony Curtis,10,0,10,0
1731505931822,MUS 203D,B00,757215,Lou; Michelle Siulai,10,0,10,0
1731505931822,MUS 203D,C00,757216,Obermueller; Karola,9,0,10,1
1731505931822,MUS 203D,D00,757217,Steiger; Rand,10,0,10,0
1731505931822,MUS 203D,E00,757218,McCormack; Timothy Matthew,10,0,10,0
1731505931822,MUS 203D,F00,795580,Liang; Lei,10,0,10,0
1731505932848,MUS 204,A00,757219,Lou; Michelle Siulai,13,0,15,2
1731505933880,MUS 205,A00,757220,Hankins; Sarah E.,13,0,15,2
1731505934912,MUS 206,A00,757221,Hankins; Sarah E.,14,0,15,1
1731505934912,MUS 206,B00,757222,Narucki; Susan M,14,0,15,1
1731505934912,MUS 206,C00,795581,Smythe; Cory Benjamin,15,0,15,0
1731505935939,MUS 207,A00,757223,Guy; Nancy,14,0,15,1
1731505936964,MUS 210,A00,757224,McCormack; Timothy Matthew,13,0,15,2
1731505937991,MUS 215D,A00,757225,Cimini; Amy Marie,14,0,15,1
1731505939021,MUS 232,001,736044,Dresser; Mark Stuart,10,0,10,0
1731505939021,MUS 232,002,736045,Curtis; Charles Rector,10,0,10,0
1731505939021,MUS 232,003,736046,Terrazas Perez; Wilfrido D,9,0,10,1
1731505939021,MUS 232,004,736047,Ohnishi; Takae,10,0,10,0
1731505939021,MUS 232,005,736048,Carlson; Erik,10,0,10,0
1731505939021,MUS 232,006,736049,Narucki; Susan M,9,0,10,1
1731505939021,MUS 232,007,736050,Staff,10,0,10,0
1731505939021,MUS 232,008,736051,Schick; Steven,10,0,10,0
1731505940048,MUS 234,A00,757226,Yadegari; Shahrokh D,20,0,20,0
1731505941076,MUS 245,A00,757230,Carlson; Erik,19,0,20,1
1731505942107,MUS 267,A00,757231,Smyth; Tamara R.,18,0,20,2
1731505943137,MUS 270D,A00,795583,Freitas Caetano; Marcelo,20,0,20,0
1731505944167,MUS 271A,A00,757235,Erbe; Tom,19,0,20,1
1731505945196,NANO 11,A00,757236,Fenning; David,100,0,100,0
1731505946225,NANO 15,A01,757238,Yang; Kesong,25,0,25,0
1731505947252,NANO 104,A00,757239,Vazquez Mena; Oscar,68,0,70,2
1731505948283,NANO 107,A01,757272,Cubukcu; Ertugrul,69,0,70,1
1731505949311,NANO 114,A00,757277,Jahed Motlagh; Zeinab,38,0,40,2
1731505950337,NANO 117,A00,757280,Cubukcu; Ertugrul,68,0,70,2
1731505951366,NANO 120A,A01,757286,Sirbuly; Donald,30,0,35,5
1731505951366,NANO 120A,B01,757294,Jokerst; Jesse Vincent,35,0,35,0
1731505952399,NANO 134,A00,757295,Pokorski; Jonathan Kyle,35,0,40,5
1731505953426,NANO 141A,A00,757296,Lubarda; Vlado,38,0,40,2
1731505954459,NANO 168,A00,757297,Fullerton; Eric E,37,0,40,3
1731505955489,NANO 200,A00,757302,Jahed Motlagh; Zeinab,88,0,120,32
1731505956518,NANO 203,A00,757314,Fenning; David,20,0,60,40
1731505957543,NANO 204,A00,757315,Li; Wan-Lu,28,0,30,2
1731505958570,NANO 205,A00,757323,Jokerst; Jesse Vincent,46,0,60,14
1731505959601,NANO 206,A00,757326,Chen; Shaochen,26,0,60,34
1731505960629,NANO 247B,A00,757331,Wang; Joseph,25,0,35,10
1731505961656,NANO 252,A00,757334,Meyers; Marc,16,0,20,4
1731505962683,NANO 265,A00,757355,Luo; Jian,8,0,10,2
1731505963715,NANO 272,A00,757357,Xu; Sheng,43,0,50,7
1731505964742,NEU 200B,A00,765050,Abdel-Azim; Eiman,0,0,0,0
1731505965823,NEU 276,A01,765052,Dore; Kim Bohemie,26,0,28,2
1731505966857,NEU 296,001,791944,Evans; Sean Jeffrey,5,0,10,5
1731505966857,NEU 296,002,791945,Graves; Jennifer Sharon Ol,9,0,10,1
1731505966857,NEU 296,003,791948,Staff,10,0,10,0
1731505967883,NEUG 221,A00,765055,Staff,7,0,12,5
1731505968913,NEUG 257,A01,765057,Halgren; Eric,16,0,18,2
1731505969940,NEUG 296,A00,765058,Bloodgood; Brenda Laurie,9998,0,9999,1
1731505970967,OPTH 296,001,792241,Baxter; Sally Liu,9,0,10,1
1731505970967,OPTH 296,002,792242,Staff,10,0,10,0
1731505970967,OPTH 296,003,792243,Staff,10,0,10,0
1731505971995,ORTH 296,001,792255,Staff,10,0,10,0
1731505971995,ORTH 296,002,792256,Staff,10,0,10,0
1731505971995,ORTH 296,003,792257,Staff,10,0,10,0
1731505973024,PAE 230,A00,791542,Villarreal Jr.; Elias,30,0,30,0
1731505974049,PAE 231,A00,791543,Villarreal Jr.; Elias,30,0,30,0
1731505975075,PAE 232,A00,791544,Villarreal Jr.; Elias,30,0,30,0
1731505976105,PAE 233,A00,791545,Villarreal Jr.; Elias,30,0,30,0
1731505977131,PAE 234,A01,791547,Villarreal Jr.; Elias,30,0,30,0
1731505978157,PAE 235,A01,791549,Villarreal Jr.; Elias,30,0,30,0
1731505979185,PAE 236,A00,791550,Villarreal Jr.; Elias,30,0,30,0
1731505980214,PATH 221,A00,761937,Yang; Jing,0,0,0,0
1731505981246,PATH 224,A01,799580,Ross; Camille,20,0,20,0
1731505982277,PATH 225,A01,797833,Klemke; Richard,25,0,25,0
1731505983303,PATH 296,001,792280,Staff,10,0,10,0
1731505983303,PATH 296,002,792282,Staff,10,0,10,0
1731505983303,PATH 296,003,792283,Staff,10,0,10,0
1731505984330,PEDS 296,001,792351,Staff,10,0,10,0
1731505984330,PEDS 296,002,792352,Staff,10,0,10,0
1731505984330,PEDS 296,003,792354,Staff,10,0,10,0
1731505985357,PH 40,A00,746085,Larsen; Britta Ann,94,0,100,6
1731505986385,PH 45,A01,785847,Stone; Matthew David,26,0,30,4
1731505986385,PH 45,A02,785848,Stone; Matthew David,26,0,30,4
1731505986385,PH 45,A03,785880,Stone; Matthew David,0,0,0,0
1731505986385,PH 45,A04,785898,Stone; Matthew David,0,0,0,0
1731505987419,PH 91,A00,746164,Harrell; Maralee Mae,100,0,100,0
1731505988446,PH 95,A00,746180,Larsen; Britta Ann,30,0,30,0
1731505989478,PH 98,A00,799480,Larsen; Britta Ann,0,0,0,0
1731505990507,PH 101,A00,746187,Tan; Gene Brian,28,0,40,12
1731505990507,PH 101,B00,746272,Miller; Lindsay Morgan,35,0,40,5
1731505991542,PH 102,A01,785945,Rana; Brinda Kanti,21,0,30,9
1731505991542,PH 102,A02,785966,Rana; Brinda Kanti,24,0,30,6
1731505992569,PH 110,A00,746301,Hartman; Sheri R,55,0,55,0
1731505992569,PH 110,B00,746625,Hartman; Sheri R,40,0,45,5
1731505993597,PH 120,A00,746626,Long; Kanya Claudine,49,0,55,6
1731505994627,PH 130,A00,746635,Kayser; Georgia Lyn,57,0,65,8
1731505995654,PH 161,A00,746643,Zoumas-Morse; Christine E.,55,0,60,5
1731505996685,PH 172,A00,746647,Ryan; Margaret Angela Kapp,35,0,40,5
1731505997718,PH 193,A00,746656,Staff,0,0,0,0
1731505997718,PH 193,B00,746659,Staff,0,0,0,0
1731505997718,PH 193,C00,746662,Staff,0,0,0,0
1731505997718,PH 193,D00,746667,Staff,0,0,0,0
1731505997718,PH 193,E00,746679,Staff,0,0,0,0
1731505997718,PH 193,F00,746683,Staff,0,0,0,0
1731505998749,PH 194,A00,746685,Nguyen; Annie Lu,0,0,0,0
1731505999777,PH 196AH,A01,746696,Binkin; Nancy Jeanne,20,0,20,0
1731506000806,PHAR 222,A00,761971,Yang; Jing,20,0,20,0
1731506001832,PHAR 255,A00,761972,Joiner; William J.,24,0,24,0
1731506002869,PHAR 275,A01,761977,Antal; Corina Elena & Obara; Christopher & Mendiola; Andrew & Gonzalez; David J,10,0,10,0
1731506003895,PHAR 295,A00,761978,Joiner; William J.,9,0,10,1
1731506004922,PHB 222,A00,746697,Messer; Karen Sue,30,0,50,20
1731506005949,PHB 226,A00,746698,Tu; Xin,15,0,25,10
1731506006976,PHB 243B,A01,746710,Thomas; Ronald G,9,0,20,11
1731506008006,PHB 244B,A00,746823,Vaida; Florin,24,0,45,21
1731506009036,PHB 280,A00,746910,Natarajan; Loki,48,0,75,27
1731506010062,PHB 291,A00,795411,Staff,14,0,25,11
1731506011099,PHIL 10,A01,761088,Carr; Jennifer Rose,39,0,44,5
1731506011099,PHIL 10,A02,761090,Carr; Jennifer Rose,44,0,44,0
1731506011099,PHIL 10,A03,761092,Carr; Jennifer Rose,42,0,44,2
1731506011099,PHIL 10,A04,761096,Carr; Jennifer Rose,44,0,44,0
1731506011099,PHIL 10,A05,761198,Carr; Jennifer Rose,44,0,44,0
1731506011099,PHIL 10,A06,761200,Carr; Jennifer Rose,43,0,44,1
1731506011099,PHIL 10,A07,761236,Carr; Jennifer Rose,44,0,44,0
1731506011099,PHIL 10,A08,761241,Carr; Jennifer Rose,43,0,44,1
1731506011099,PHIL 10,A09,761243,Carr; Jennifer Rose,0,0,0,0
1731506011099,PHIL 10,A10,761244,Carr; Jennifer Rose,0,0,0,0
1731506012135,PHIL 12,A01,761252,Kovaka; Karenc,29,0,30,1
1731506012135,PHIL 12,A02,761254,Kovaka; Karenc,0,0,0,0
1731506012135,PHIL 12,A03,761277,Kovaka; Karenc,30,0,30,0
1731506012135,PHIL 12,A04,761278,Kovaka; Karenc,29,0,30,1
1731506012135,PHIL 12,A05,761279,Kovaka; Karenc,30,0,30,0
1731506012135,PHIL 12,A06,761280,Kovaka; Karenc,29,0,30,1
1731506012135,PHIL 12,A07,761281,Kovaka; Karenc,30,0,30,0
1731506012135,PHIL 12,A08,761282,Kovaka; Karenc,0,0,0,0
1731506013162,PHIL 16,A00,761283,Harrell; Maralee Mae,31,0,33,2
1731506014195,PHIL 24,A00,761284,Callender; Craig Adam,120,0,120,0
1731506015225,PHIL 27,A01,761286,Lamey; Andy M.,17,0,25,8
1731506015225,PHIL 27,A02,761287,Lamey; Andy M.,18,0,25,7
1731506015225,PHIL 27,A03,761288,Lamey; Andy M.,0,0,0,0
1731506015225,PHIL 27,A04,761289,Lamey; Andy M.,0,0,0,0
1731506015225,PHIL 27,A05,761292,Lamey; Andy M.,21,0,25,4
1731506015225,PHIL 27,A06,761294,Lamey; Andy M.,20,0,25,5
1731506016256,PHIL 28,A01,761401,Brandt; Reuven A,16,0,25,9
1731506016256,PHIL 28,A02,761404,Brandt; Reuven A,23,0,25,2
1731506016256,PHIL 28,A03,761406,Brandt; Reuven A,23,0,25,2
1731506016256,PHIL 28,A04,761425,Brandt; Reuven A,18,0,25,7
1731506016256,PHIL 28,A05,761427,Brandt; Reuven A,25,0,25,0
1731506016256,PHIL 28,A06,761433,Brandt; Reuven A,23,0,25,2
1731506016256,PHIL 28,A07,761434,Brandt; Reuven A,0,0,0,0
1731506016256,PHIL 28,A08,761438,Brandt; Reuven A,0,0,0,0
1731506016256,PHIL 28,A09,761571,Brandt; Reuven A,8,0,25,17
1731506016256,PHIL 28,A10,761572,Brandt; Reuven A,24,0,25,1
1731506017283,PHIL 32,A01,761605,Johnson; Monte,23,0,25,2
1731506017283,PHIL 32,A02,761606,Johnson; Monte,25,0,25,0
1731506018315,PHIL 35,A00,761621,Marechal; Patricia,175,0,180,5
1731506019341,PHIL 51,A00,761645,Kovaka; Karenc,216,0,216,0
1731506020372,PHIL 90,A00,761646,Rudolph; Rachel Etta,31,0,33,2
1731506020372,PHIL 90,B00,761648,Kocurek; Alexander William,32,0,33,1
1731506021403,PHIL 100,A00,761696,Marechal; Patricia,24,0,32,8
1731506022429,PHIL 107,A00,761697,Tolley; Clinton,33,0,33,0
1731506023455,PHIL 111,A00,761698,Watkins; Eric,39,0,40,1
1731506024483,PHIL 122,A00,761699,Sher; Gila,31,0,33,2
1731506025513,PHIL 132,A00,761700,Sher; Gila,31,0,33,2
1731506026539,PHIL 136,A00,761701,Grush; Rick Scott,31,0,33,2
1731506027569,PHIL 138,A00,761721,Vargas; Manuel Rogelio,58,0,60,2
1731506028601,PHIL 149,A00,761738,Fulkerson; Matthew Todd,113,0,120,7
1731506029628,PHIL 163,A01,761771,Brandt; Reuven A,23,0,25,2
1731506029628,PHIL 163,A02,761774,Brandt; Reuven A,22,0,25,3
1731506029628,PHIL 163,A03,761778,Brandt; Reuven A,22,0,25,3
1731506029628,PHIL 163,A04,761785,Brandt; Reuven A,24,0,25,1
1731506029628,PHIL 163,A05,761810,Brandt; Reuven A,0,0,0,0
1731506029628,PHIL 163,A06,761819,Brandt; Reuven A,19,0,25,6
1731506029628,PHIL 163,A07,761823,Brandt; Reuven A,18,0,25,7
1731506029628,PHIL 163,A08,761827,Brandt; Reuven A,0,0,0,0
1731506029628,PHIL 163,A09,761833,Brandt; Reuven A,24,0,25,1
1731506029628,PHIL 163,A10,761840,Brandt; Reuven A,23,0,25,2
1731506030655,PHIL 167,A00,761841,Lamey; Andy M.,29,0,33,4
1731506031684,PHIL 176,A00,761843,Vargas; Manuel Rogelio,32,0,33,1
1731506032712,PHIL 177,A00,761848,Shields; Christopher John,33,0,33,0
1731506033743,PHIL 185,A00,794683,Shields; Christopher John,30,0,33,3
1731506035803,PHIL 191B,A00,799969,Tolley; Clinton,2,0,2,0
1731506035803,PHIL 191B,B00,799970,Bazargan-Forward; Saba,1,0,1,0
1731506036831,PHIL 201A,A00,761865,Tolley; Clinton,18,0,20,2
1731506037860,PHIL 206A,A00,761866,Carr; Jennifer Rose,17,0,20,3
1731506038886,PHIL 209C,A00,761870,McKenzie; Kerry V.,5,0,5,0
1731506039918,PHIL 209D,A00,761873,Lampland; Martha,5,0,5,0
1731506040944,PHIL 210,A00,761878,Johnson; Monte,19,0,20,1
1731506041975,PHIL 245,A00,761883,Cartwright; Nancy D.,14,0,20,6
1731506043008,PHIL 260,A00,761889,Bazargan-Forward; Saba & Yuan; Yuan,20,0,20,0
1731506044038,PHIL 271,A00,761891,Vargas; Manuel Rogelio & Fulkerson; Matthew Todd,10,0,10,0
1731506045066,PHIL 275,A00,761899,Watkins; Eric,10,0,10,0
1731506046093,PHIL 277,A00,761911,Tolley; Clinton,8,0,10,2
1731506047120,PHIL 278,A00,761919,Fulkerson; Matthew Todd & Cohen; Jonathan David,10,0,10,0
1731506048147,PHIL 280,A00,761930,Kovaka; Karenc,9999,0,9999,0
1731506049173,PHIL 281,A00,761931,Tolley; Clinton,10,0,10,0
1731506050200,PHIL 283,A00,794690,Tolley; Clinton & Vargas; Manuel Rogelio,10,0,10,0
1731506051224,PHIL 284,A00,761932,Kovaka; Karenc,10,0,10,0
1731506052250,PHIL 286,A00,761933,Chen; Keming & Callender; Craig Adam,10,0,10,0
1731506053277,PHIL 287,A00,761935,Johnson; Monte,10,0,10,0
1731506054327,PHIL 290,001,776411,Nelkin; Dana Kay,9999,0,9999,0
1731506054327,PHIL 290,002,776412,Bazargan-Forward; Saba,9999,0,9999,0
1731506054327,PHIL 290,003,776413,Brandt; Reuven A,9999,0,9999,0
1731506054327,PHIL 290,004,776414,Brink; David O.,9999,0,9999,0
1731506054327,PHIL 290,005,776415,Callender; Craig Adam,9999,0,9999,0
1731506054327,PHIL 290,006,776416,Carr; Jennifer Rose,9999,0,9999,0
1731506054327,PHIL 290,007,776483,Cartwright; Nancy D.,9999,0,9999,0
1731506054327,PHIL 290,008,776498,Cohen; Jonathan David,9999,0,9999,0
1731506054327,PHIL 290,009,776743,Danks; David J,9999,0,9999,0
1731506054327,PHIL 290,010,776746,Fulkerson; Matthew Todd,9999,0,9999,0
1731506054327,PHIL 290,011,776753,Grush; Rick Scott,9999,0,9999,0
1731506054327,PHIL 290,012,776756,Hardimon; Michael O.,9999,0,9999,0
1731506054327,PHIL 290,013,776760,Harrell; Maralee Mae,9999,0,9999,0
1731506054327,PHIL 290,014,776761,Johnson; Monte,9999,0,9999,0
1731506054327,PHIL 290,015,776762,Kovaka; Karenc,9999,0,9999,0
1731506054327,PHIL 290,016,776763,Lamey; Andy M.,9999,0,9999,0
1731506054327,PHIL 290,017,776766,Marechal; Patricia,9999,0,9999,0
1731506054327,PHIL 290,018,776771,McKenzie; Kerry V.,9999,0,9999,0
1731506054327,PHIL 290,019,776778,Rickless; Samuel Charles,9999,0,9999,0
1731506054327,PHIL 290,020,776782,Sher; Gila,9999,0,9999,0
1731506054327,PHIL 290,021,776785,Shields; Christopher John,9999,0,9999,0
1731506054327,PHIL 290,022,776787,Tolley; Clinton,9999,0,9999,0
1731506054327,PHIL 290,023,776796,Vargas; Manuel Rogelio,9999,0,9999,0
1731506054327,PHIL 290,024,776799,Watkins; Eric,9999,0,9999,0
1731506054327,PHIL 290,025,776802,Chen; Keming,9999,0,9999,0
1731506054327,PHIL 290,026,794693,Rudolph; Rachel Etta,9999,0,9999,0
1731506054327,PHIL 290,027,794696,Kocurek; Alexander William,9999,0,9999,0
1731506054327,PHIL 290,028,794697,Yuan; Yuan,9999,0,9999,0
1731506055357,PHIL 295,001,776806,Bazargan-Forward; Saba,9999,0,9999,0
1731506055357,PHIL 295,002,776808,Brandt; Reuven A,9999,0,9999,0
1731506055357,PHIL 295,003,776811,Brink; David O.,9999,0,9999,0
1731506055357,PHIL 295,004,776818,Callender; Craig Adam,9999,0,9999,0
1731506055357,PHIL 295,005,776820,Carr; Jennifer Rose,9999,0,9999,0
1731506055357,PHIL 295,006,776821,Cartwright; Nancy D.,9999,0,9999,0
1731506055357,PHIL 295,007,776825,Chen; Keming,9999,0,9999,0
1731506055357,PHIL 295,008,776827,Cohen; Jonathan David,9999,0,9999,0
1731506055357,PHIL 295,009,776831,Danks; David J,9999,0,9999,0
1731506055357,PHIL 295,010,776840,Fulkerson; Matthew Todd,9999,0,9999,0
1731506055357,PHIL 295,011,776842,Grush; Rick Scott,9999,0,9999,0
1731506055357,PHIL 295,012,776846,Hardimon; Michael O.,9999,0,9999,0
1731506055357,PHIL 295,013,776933,Harrell; Maralee Mae,9999,0,9999,0
1731506055357,PHIL 295,014,776934,Johnson; Monte,9999,0,9999,0
1731506055357,PHIL 295,015,776941,Kovaka; Karenc,9999,0,9999,0
1731506055357,PHIL 295,016,776960,Lamey; Andy M.,9999,0,9999,0
1731506055357,PHIL 295,017,777007,Marechal; Patricia,9999,0,9999,0
1731506055357,PHIL 295,018,777008,McKenzie; Kerry V.,9999,0,9999,0
1731506055357,PHIL 295,019,777047,Nelkin; Dana Kay,9999,0,9999,0
1731506055357,PHIL 295,020,777237,Rickless; Samuel Charles,9999,0,9999,0
1731506055357,PHIL 295,021,777242,Sher; Gila,9999,0,9999,0
1731506055357,PHIL 295,022,777245,Shields; Christopher John,9999,0,9999,0
1731506055357,PHIL 295,023,777246,Tolley; Clinton,9999,0,9999,0
1731506055357,PHIL 295,024,777247,Vargas; Manuel Rogelio,9999,0,9999,0
1731506055357,PHIL 295,025,777248,Watkins; Eric,9999,0,9999,0
1731506055357,PHIL 295,026,794698,Rudolph; Rachel Etta,9999,0,9999,0
1731506055357,PHIL 295,027,794699,Kocurek; Alexander William,9999,0,9999,0
1731506055357,PHIL 295,028,794710,Yuan; Yuan,9999,0,9999,0
1731506056384,PHYS 1A,A00,759213,Tsai; Philbert S,330,0,360,30
1731506057416,PHYS 1AL,001,759214,Yagil; Avi & Tsai; Philbert S,25,0,30,5
1731506057416,PHYS 1AL,002,759215,Yagil; Avi & Tsai; Philbert S,29,0,30,1
1731506057416,PHYS 1AL,003,759216,Yagil; Avi & Tsai; Philbert S,28,0,30,2
1731506057416,PHYS 1AL,004,759217,Yagil; Avi & Tsai; Philbert S,28,0,30,2
1731506057416,PHYS 1AL,005,759218,Yagil; Avi & Tsai; Philbert S,21,0,30,9
1731506057416,PHYS 1AL,006,759219,Yagil; Avi & Tsai; Philbert S,28,0,30,2
1731506057416,PHYS 1AL,007,759220,Yagil; Avi & Tsai; Philbert S,26,0,30,4
1731506057416,PHYS 1AL,008,759221,Yagil; Avi & Tsai; Philbert S,30,0,30,0
1731506057416,PHYS 1AL,009,759222,Yagil; Avi & Tsai; Philbert S,28,0,30,2
1731506057416,PHYS 1AL,010,759223,Yagil; Avi & Tsai; Philbert S,27,0,30,3
1731506057416,PHYS 1AL,011,759225,Yagil; Avi & Tsai; Philbert S,26,0,30,4
1731506057416,PHYS 1AL,012,759226,Yagil; Avi & Tsai; Philbert S,28,0,30,2
1731506058442,PHYS 1B,A00,759229,Smith; Douglas E,573,0,600,27
1731506058442,PHYS 1B,B00,759230,Smith; Douglas E,575,0,600,25
1731506059491,PHYS 1BL,001,759232,Yagil; Avi & Tsai; Philbert S,29,0,30,1
1731506059491,PHYS 1BL,002,759233,Yagil; Avi & Tsai; Philbert S,28,0,30,2
1731506059491,PHYS 1BL,003,759235,Yagil; Avi & Tsai; Philbert S,20,0,30,10
1731506059491,PHYS 1BL,004,759236,Yagil; Avi & Tsai; Philbert S,23,0,30,7
1731506059491,PHYS 1BL,005,759237,Yagil; Avi & Tsai; Philbert S,30,0,30,0
1731506059491,PHYS 1BL,006,759238,Yagil; Avi & Tsai; Philbert S,27,0,30,3
1731506059491,PHYS 1BL,007,759239,Yagil; Avi & Tsai; Philbert S,26,0,30,4
1731506059491,PHYS 1BL,008,759240,Yagil; Avi & Tsai; Philbert S,30,0,30,0
1731506059491,PHYS 1BL,009,759241,Yagil; Avi & Tsai; Philbert S,26,0,30,4
1731506059491,PHYS 1BL,010,759242,Yagil; Avi & Tsai; Philbert S,29,0,30,1
1731506059491,PHYS 1BL,011,759243,Yagil; Avi & Tsai; Philbert S,28,0,30,2
1731506059491,PHYS 1BL,012,759244,Yagil; Avi & Tsai; Philbert S,29,0,30,1
1731506059491,PHYS 1BL,015,759248,Yagil; Avi & Tsai; Philbert S,20,0,30,10
1731506059491,PHYS 1BL,016,759250,Yagil; Avi & Tsai; Philbert S,26,0,30,4
1731506059491,PHYS 1BL,017,759254,Yagil; Avi & Tsai; Philbert S,20,0,30,10
1731506059491,PHYS 1BL,018,759256,Yagil; Avi & Tsai; Philbert S,27,0,30,3
1731506059491,PHYS 1BL,019,759257,Yagil; Avi & Tsai; Philbert S,30,0,30,0
1731506059491,PHYS 1BL,020,759259,Yagil; Avi & Tsai; Philbert S,27,0,30,3
1731506059491,PHYS 1BL,021,759260,Yagil; Avi & Tsai; Philbert S,30,0,30,0
1731506059491,PHYS 1BL,022,759261,Yagil; Avi & Tsai; Philbert S,29,0,30,1
1731506059491,PHYS 1BL,023,759262,Yagil; Avi & Tsai; Philbert S,29,0,30,1
1731506059491,PHYS 1BL,024,759265,Yagil; Avi & Tsai; Philbert S,30,0,30,0
1731506059491,PHYS 1BL,025,759266,Yagil; Avi & Tsai; Philbert S,28,0,30,2
1731506059491,PHYS 1BL,026,759270,Yagil; Avi & Tsai; Philbert S,28,0,30,2
1731506059491,PHYS 1BL,027,759271,Yagil; Avi & Tsai; Philbert S,27,0,30,3
1731506059491,PHYS 1BL,028,759275,Yagil; Avi & Tsai; Philbert S,29,0,30,1
1731506059491,PHYS 1BL,029,759276,Yagil; Avi & Tsai; Philbert S,27,0,30,3
1731506059491,PHYS 1BL,030,759277,Yagil; Avi & Tsai; Philbert S,29,0,30,1
1731506059491,PHYS 1BL,031,759278,Yagil; Avi & Tsai; Philbert S,27,0,30,3
1731506059491,PHYS 1BL,032,759280,Yagil; Avi & Tsai; Philbert S,30,0,30,0
1731506059491,PHYS 1BL,033,759298,Yagil; Avi & Tsai; Philbert S,30,0,30,0
1731506059491,PHYS 1BL,034,759338,Yagil; Avi & Tsai; Philbert S,30,0,30,0
1731506059491,PHYS 1BL,035,759363,Yagil; Avi & Tsai; Philbert S,26,0,30,4
1731506059491,PHYS 1BL,036,759376,Yagil; Avi & Tsai; Philbert S,28,0,30,2
1731506060519,PHYS 1C,A00,759402,Bal; Gurleen K,341,0,362,21
1731506061552,PHYS 1CL,001,759406,Yagil; Avi & Tsai; Philbert S,25,0,30,5
1731506061552,PHYS 1CL,002,759408,Yagil; Avi & Tsai; Philbert S,23,0,30,7
1731506061552,PHYS 1CL,003,759464,Yagil; Avi & Tsai; Philbert S,27,0,30,3
1731506061552,PHYS 1CL,004,759467,Yagil; Avi & Tsai; Philbert S,25,0,30,5
1731506061552,PHYS 1CL,005,759469,Yagil; Avi & Tsai; Philbert S,27,0,30,3
1731506061552,PHYS 1CL,006,794532,Yagil; Avi & Tsai; Philbert S,26,0,30,4
1731506061552,PHYS 1CL,007,794533,Yagil; Avi & Tsai; Philbert S,27,0,30,3
1731506061552,PHYS 1CL,008,794534,Yagil; Avi & Tsai; Philbert S,30,0,30,0
1731506061552,PHYS 1CL,009,794535,Yagil; Avi & Tsai; Philbert S,29,0,30,1
1731506061552,PHYS 1CL,010,794536,Yagil; Avi & Tsai; Philbert S,30,0,30,0
1731506061552,PHYS 1CL,011,794537,Yagil; Avi & Tsai; Philbert S,28,0,30,2
1731506061552,PHYS 1CL,012,794538,Yagil; Avi & Tsai; Philbert S,29,0,30,1
1731506062583,PHYS 2A,A01,759498,Bal; Gurleen K,30,0,30,0
1731506062583,PHYS 2A,A02,759546,Bal; Gurleen K,30,0,30,0
1731506062583,PHYS 2A,A03,759548,Bal; Gurleen K,30,0,30,0
1731506062583,PHYS 2A,A04,759549,Bal; Gurleen K,30,0,30,0
1731506062583,PHYS 2A,A05,759550,Bal; Gurleen K,29,0,30,1
1731506062583,PHYS 2A,A06,759551,Bal; Gurleen K,29,0,30,1
1731506062583,PHYS 2A,A07,759552,Bal; Gurleen K,30,0,30,0
1731506062583,PHYS 2A,A08,759553,Bal; Gurleen K,30,0,30,0
1731506062583,PHYS 2A,A09,759554,Bal; Gurleen K,30,0,30,0
1731506062583,PHYS 2A,A10,759555,Bal; Gurleen K,30,0,30,0
1731506062583,PHYS 2A,A11,759556,Bal; Gurleen K,30,0,30,0
1731506062583,PHYS 2A,A12,759558,Bal; Gurleen K,29,0,30,1
1731506062583,PHYS 2A,B01,759560,Dudko; Olga,26,0,30,4
1731506062583,PHYS 2A,B02,759561,Dudko; Olga,30,0,30,0
1731506062583,PHYS 2A,B03,759562,Dudko; Olga,30,0,30,0
1731506062583,PHYS 2A,B04,759563,Dudko; Olga,29,0,30,1
1731506062583,PHYS 2A,B05,759565,Dudko; Olga,27,0,30,3
1731506062583,PHYS 2A,B06,759566,Dudko; Olga,28,0,30,2
1731506062583,PHYS 2A,B07,759567,Dudko; Olga,24,0,30,6
1731506062583,PHYS 2A,B08,759568,Dudko; Olga,30,0,30,0
1731506062583,PHYS 2A,B09,759569,Dudko; Olga,27,0,30,3
1731506062583,PHYS 2A,B10,759611,Dudko; Olga,29,0,30,1
1731506062583,PHYS 2A,B11,759661,Dudko; Olga,24,0,30,6
1731506062583,PHYS 2A,B12,759664,Dudko; Olga,24,0,30,6
1731506063611,PHYS 2B,A01,759701,Shotwell; Brian,29,0,30,1
1731506063611,PHYS 2B,A02,759737,Shotwell; Brian,30,0,30,0
1731506063611,PHYS 2B,A03,759743,Shotwell; Brian,29,0,30,1
1731506063611,PHYS 2B,A04,759744,Shotwell; Brian,30,0,30,0
1731506063611,PHYS 2B,A05,759745,Shotwell; Brian,28,0,30,2
1731506063611,PHYS 2B,A06,759779,Shotwell; Brian,27,0,30,3
1731506063611,PHYS 2B,A07,759782,Shotwell; Brian,28,0,30,2
1731506063611,PHYS 2B,A08,759796,Shotwell; Brian,29,0,30,1
1731506063611,PHYS 2B,A09,759798,Shotwell; Brian,26,0,30,4
1731506063611,PHYS 2B,A10,759905,Shotwell; Brian,29,0,30,1
1731506063611,PHYS 2B,A11,759989,Shotwell; Brian,28,0,30,2
1731506063611,PHYS 2B,A12,759992,Shotwell; Brian,23,0,30,7
1731506064639,PHYS 2C,A01,759994,Jun; Suckjoon,22,0,30,8
1731506064639,PHYS 2C,A02,759995,Jun; Suckjoon,27,0,30,3
1731506064639,PHYS 2C,A03,759996,Jun; Suckjoon,30,0,30,0
1731506064639,PHYS 2C,A04,759997,Jun; Suckjoon,29,0,30,1
1731506064639,PHYS 2C,A05,760002,Jun; Suckjoon,30,0,30,0
1731506064639,PHYS 2C,A06,760021,Jun; Suckjoon,30,0,30,0
1731506064639,PHYS 2C,A07,760032,Jun; Suckjoon,28,0,30,2
1731506064639,PHYS 2C,A08,760035,Jun; Suckjoon,30,0,30,0
1731506064639,PHYS 2C,A09,760041,Jun; Suckjoon,30,0,30,0
1731506064639,PHYS 2C,A10,760042,Jun; Suckjoon,30,0,30,0
1731506064639,PHYS 2C,A11,760043,Jun; Suckjoon,30,0,30,0
1731506064639,PHYS 2C,A12,760044,Jun; Suckjoon,30,0,30,0
1731506065669,PHYS 2CL,A01,760046,Jun; Suckjoon,24,0,28,4
1731506065669,PHYS 2CL,A02,760047,Jun; Suckjoon,26,0,28,2
1731506065669,PHYS 2CL,A03,760048,Jun; Suckjoon,25,0,28,3
1731506065669,PHYS 2CL,A04,760049,Jun; Suckjoon,25,0,28,3
1731506065669,PHYS 2CL,A05,760050,Jun; Suckjoon,24,0,28,4
1731506065669,PHYS 2CL,A06,760051,Jun; Suckjoon,28,0,28,0
1731506065669,PHYS 2CL,A07,760052,Jun; Suckjoon,25,0,28,3
1731506065669,PHYS 2CL,A08,760053,Jun; Suckjoon,26,0,28,2
1731506066697,PHYS 2D,A01,760055,Hirsch; Jorge Eduardo,29,0,32,3
1731506066697,PHYS 2D,A02,760056,Hirsch; Jorge Eduardo,31,0,32,1
1731506067731,PHYS 4A,A01,760058,Averitt; Richard Douglas,41,0,45,4
1731506067731,PHYS 4A,A02,760085,Averitt; Richard Douglas,44,0,45,1
1731506067731,PHYS 4A,A03,760086,Averitt; Richard Douglas,44,0,45,1
1731506067731,PHYS 4A,A04,760087,Averitt; Richard Douglas,45,0,45,0
1731506068759,PHYS 4D,A01,760090,Frano Pereira; Alex M,40,0,40,0
1731506068759,PHYS 4D,A02,760096,Frano Pereira; Alex M,39,0,40,1
1731506068759,PHYS 4D,A03,760097,Frano Pereira; Alex M,40,0,40,0
1731506069841,PHYS 12,A01,760099,Branson; James G,59,0,60,1
1731506070869,PHYS 39,A01,796284,Jun; Suckjoon,0,0,0,0
1731506071895,PHYS 41,A01,760104,Green; Daniel Richard,48,0,50,2
1731506072925,PHYS 87,A00,796262,Grinstein; Benjamin,20,0,20,0
1731506073953,PHYS 100B,A01,760163,Barreiro Guerrero; Julio,72,0,75,3
1731506074984,PHYS 105A,A01,760203,Lin; Tongyan,33,0,38,5
1731506074984,PHYS 105A,A02,760212,Lin; Tongyan,36,0,37,1
1731506076013,PHYS 110B,A01,760214,Serra; Mattia,74,0,75,1
1731506077043,PHYS 124,A01,760217,Arnold; Kam S,38,0,40,2
1731506078076,PHYS 130A,A01,760219,Parker; Daniel E,38,0,40,2
1731506079106,PHYS 130C,A01,760221,You; Yizhuang,22,0,30,8
1731506080132,PHYS 136,A00,760222,Grinstein; Benjamin,50,0,50,0
1731506081164,PHYS 139,A00,760223,Di Ventra; Massimiliano & Schuller; Ivan K,28,0,30,2
1731506082190,PHYS 140B,A01,760225,Arovas; Daniel P,26,0,30,4
1731506083216,PHYS 142,A01,794356,Duarte; Javier Mauricio,52,0,55,3
1731506084241,PHYS 152A,A01,760229,Butov; Leonid,39,0,40,1
1731506085268,PHYS 160,A01,760231,Fuller; George Michael,64,0,65,1
1731506086297,PHYS 176,A00,760232,Hwa; Terence T.,10,0,10,0
1731506087330,PHYS 178,A00,760233,Kleinfeld; David,32,0,35,3
1731506088363,PHYS 203A,A01,760242,Fogler; Michael M.,13,0,30,17
1731506089392,PHYS 211B,A00,760255,Grover; Tarun,28,0,30,2
1731506090423,PHYS 212B,A01,760269,Chivukula; Raja S,18,0,30,12
1731506091453,PHYS 215B,A00,760325,McGreevy; John A.,24,0,30,6
1731506092485,PHYS 225B,A00,760326,Flauger; Raphael M,27,0,30,3
1731506093518,PHYS 239,A00,760327,Di Ventra; Massimiliano & Schuller; Ivan K,12,0,15,3
1731506093518,PHYS 239,B00,760328,Goldenfeld; Nigel,25,0,30,5
1731506094548,PHYS 242,A00,794365,Duarte; Javier Mauricio,2,0,5,3
1731506095574,PHYS 250,A00,760331,Parker; Daniel E,45,0,50,5
1731506096603,PHYS 251,A00,760332,Grinstein; Benjamin,18,0,20,2
1731506097630,PHYS 252,A00,760333,Diamond; Patrick H,8,0,10,2
1731506098664,PHYS 253,A00,760336,Fuller; George Michael & Keating; Brian,19,0,20,1
1731506099689,PHYS 254,A00,760337,Tan; Tzer Han,30,0,30,0
1731506100719,PHYS 259A,A00,795452,Hwa; Terence T.,18,0,20,2
1731506101748,PHYS 260,A00,760340,Fuller; George Michael,46,0,50,4
1731506102779,PHYS 261,A00,760341,Schuller; Ivan K,28,0,30,2
1731506103806,PHYS 276,A00,760342,Hwa; Terence T.,6,0,10,4
1731506104834,PHYS 278,A00,760343,Kleinfeld; David,14,0,15,1
1731506105864,POLI 5D,A01,761982,Dai; Yinlin,6,0,6,0
1731506105864,POLI 5D,A02,761984,Dai; Yinlin,6,0,6,0
1731506105864,POLI 5D,A03,761987,Dai; Yinlin,6,0,6,0
1731506105864,POLI 5D,A04,761988,Dai; Yinlin,6,0,6,0
1731506105864,POLI 5D,A05,762321,Dai; Yinlin,5,0,6,1
1731506105864,POLI 5D,B01,762356,Dai; Yinlin,6,0,6,0
1731506105864,POLI 5D,B02,762362,Dai; Yinlin,6,0,6,0
1731506105864,POLI 5D,B03,762365,Dai; Yinlin,5,0,6,1
1731506105864,POLI 5D,B04,762369,Dai; Yinlin,6,0,6,0
1731506105864,POLI 5D,B05,762370,Dai; Yinlin,6,0,6,0
1731506106893,POLI 10D,A01,762376,Noble; Benjamin S,29,0,32,3
1731506106893,POLI 10D,A02,762377,Noble; Benjamin S,29,0,32,3
1731506106893,POLI 10D,A03,762384,Noble; Benjamin S,29,0,32,3
1731506106893,POLI 10D,A04,762385,Noble; Benjamin S,29,0,32,3
1731506106893,POLI 10D,A05,762390,Noble; Benjamin S,32,0,32,0
1731506106893,POLI 10D,A06,762397,Noble; Benjamin S,32,0,32,0
1731506107920,POLI 11D,A01,762400,Desposato; Scott,33,0,34,1
1731506107920,POLI 11D,A02,762403,Desposato; Scott,32,0,34,2
1731506107920,POLI 11D,A03,762406,Desposato; Scott,33,0,34,1
1731506107920,POLI 11D,A04,762408,Desposato; Scott,33,0,34,1
1731506107920,POLI 11D,A05,762409,Desposato; Scott,33,0,34,1
1731506107920,POLI 11D,A06,762411,Desposato; Scott,34,0,34,0
1731506108949,POLI 87,A00,799971,Mignozzetti; Umberto,20,0,20,0
1731506109980,POLI 100W,A00,762448,Paglayan; Agustina,111,0,120,9
1731506111012,POLI 104B,A00,762450,Smith; Glenn Chatmas,208,0,216,8
1731506112040,POLI 104C,A00,762453,Salam; Amna,102,0,115,13
1731506113066,POLI 104J,A00,762454,Nichter; Maysa,180,0,196,16
1731506114092,POLI 104U,A00,762456,Nichter; Maysa,130,0,146,16
1731506115118,POLI 108,A00,762463,Adida; Claire,289,0,295,6
1731506116149,POLI 110B,A00,762465,Ingham; Sean,54,0,56,2
1731506117180,POLI 113BR,A00,762468,Hoston; Germaine,193,0,200,7
1731506117180,POLI 113BR,B00,796178,Hoston; Germaine,30,0,30,0
1731506118210,POLI 114BR,A00,762469,Hoston; Germaine,195,0,200,5
1731506118210,POLI 114BR,B00,796626,Hoston; Germaine,30,0,30,0
1731506119236,POLI 117R,A00,762470,Forman; Fonna,27,0,40,13
1731506120267,POLI 118,A00,762472,Wiens; David,97,0,104,7
1731506121295,POLI 120G,A00,762598,Fisk; David Lee,111,0,115,4
1731506122323,POLI 124A,A00,762698,Fortunato; David,53,0,56,3
1731506123350,POLI 127,A00,762700,Feeley; Maureen Catherine,157,0,158,1
1731506124378,POLI 135,A00,762703,Fisk; David Lee,144,0,146,2
1731506125405,POLI 137,A00,762704,Saiegh; Sebastian,53,0,56,3
1731506126434,POLI 138,A00,762707,Draper; Matthew William,111,0,115,4
1731506127466,POLI 142J,A00,762708,Slantchev; Branislav,109,0,115,6
1731506128497,POLI 142L,A00,762709,Wagner; Wendy,138,0,146,8
1731506129524,POLI 147B,A00,762711,Roeder; Philip G,143,0,146,3
1731506130550,POLI 153,A00,762712,Fisk; David Lee,139,0,146,7
1731506131580,POLI 160AA,A00,762714,Staff,207,0,223,16
1731506132613,POLI 191B,A00,762715,Fowler; James,26,0,26,0
1731506133672,POLI 194,A00,770731,Hill; Seth J,9999,0,9999,0
1731506134699,POLI 197SD,A00,794843,Nichter; Maysa,9999,0,9999,0
1731506135726,POLI 203A,A00,762716,Ingham; Sean,21,0,25,4
1731506136757,POLI 212,A00,762739,Goldman; Harvey Stern,1,0,2,1
1731506137785,POLI 216,A00,762740,Wiens; David,23,0,25,2
1731506138815,POLI 220C,A00,762771,Garfias Royo; Ek Francisco,24,0,25,1
1731506139849,POLI 229,A00,762772,Saiegh; Sebastian,11,0,12,1
1731506139849,POLI 229,B00,762783,Liu; Guoer,22,0,25,3
1731506140873,POLI 231,A00,762784,Nichter; Simeon C,22,0,25,3
1731506141903,POLI 231E,A00,762788,Lowes; Sara Rachel & Bazzi; Samuel A,3,0,5,2
1731506142931,POLI 245,A00,762789,Naoi; Megumi,8,0,12,4
1731506143958,POLI 248,A00,762792,Lake; David A,19,0,25,6
1731506144984,POLI 257,A00,762795,Hill; Seth J,25,0,25,0
1731506146011,POLI 258,A00,762798,Noble; Benjamin S,25,0,25,0
1731506147038,POLI 271,A00,762799,Ahlquist; John S.,23,0,24,1
1731506148065,POLI 272,A00,762802,Mignozzetti; Umberto,11,0,12,1
1731506149092,POLI 281,A00,762803,Ban; Pamela M,13,0,13,0
1731506150123,POLI 282,A00,762804,Ferree; Karen E,23,0,25,2
1731506151149,POLI 283,A00,762805,Slantchev; Branislav,20,0,25,5
1731506152178,POLI 285,A00,762807,Ingham; Sean,10,0,10,0
1731506153206,POLI 286,A00,762808,Mignozzetti; Umberto,25,0,25,0
1731506154235,POLI 288,A00,762810,Fowler; James,12,0,12,0
1731506155261,PSY 296,001,792382,Staff,10,0,10,0
1731506155261,PSY 296,002,792383,Staff,10,0,10,0
1731506155261,PSY 296,003,792385,Staff,10,0,10,0
1731506156292,PSYC 1,A00,762811,Wennberg; Janna Wold,288,0,300,12
1731506157318,PSYC 2,A00,762815,Moranton; Nirelia Melbina-,247,0,250,3
1731506158346,PSYC 4,A00,795584,Anagnostaras; Stephan,285,0,295,10
1731506159378,PSYC 60,A01,786029,Lowe; Angela Beth,35,0,35,0
1731506159378,PSYC 60,A02,786035,Lowe; Angela Beth,33,0,35,2
1731506159378,PSYC 60,A03,786043,Lowe; Angela Beth,32,0,35,3
1731506159378,PSYC 60,A04,786046,Lowe; Angela Beth,32,0,35,3
1731506159378,PSYC 60,A05,786048,Lowe; Angela Beth,33,0,35,2
1731506159378,PSYC 60,A06,786049,Lowe; Angela Beth,33,0,35,2
1731506159378,PSYC 60,A07,786050,Lowe; Angela Beth,35,0,35,0
1731506159378,PSYC 60,B01,786056,Steiner; Eric Tomas,33,0,35,2
1731506159378,PSYC 60,B02,786058,Steiner; Eric Tomas,32,0,35,3
1731506159378,PSYC 60,B03,786061,Steiner; Eric Tomas,33,0,35,2
1731506159378,PSYC 60,B04,786065,Steiner; Eric Tomas,33,0,35,2
1731506159378,PSYC 60,B05,786068,Steiner; Eric Tomas,34,0,35,1
1731506159378,PSYC 60,B06,786071,Steiner; Eric Tomas,34,0,35,1
1731506159378,PSYC 60,B07,786075,Steiner; Eric Tomas,34,0,35,1
1731506160411,PSYC 70,A01,786078,Geller; Emma Harlan,27,0,35,8
1731506160411,PSYC 70,A02,786081,Geller; Emma Harlan,30,0,35,5
1731506160411,PSYC 70,A03,786084,Geller; Emma Harlan,35,0,35,0
1731506160411,PSYC 70,A04,786088,Geller; Emma Harlan,35,0,35,0
1731506160411,PSYC 70,A05,786089,Geller; Emma Harlan,35,0,35,0
1731506160411,PSYC 70,A06,786094,Geller; Emma Harlan,34,0,35,1
1731506161446,PSYC 71,A01,762821,Pilegard; Celeste Cristine,10,0,25,15
1731506161446,PSYC 71,A02,762822,Pilegard; Celeste Cristine,24,0,25,1
1731506161446,PSYC 71,B01,762826,Lowe; Angela Beth,24,0,25,1
1731506161446,PSYC 71,B02,762827,Lowe; Angela Beth,23,0,25,2
1731506162476,PSYC 101,A00,762829,Walker; Caren Michelle,255,0,295,40
1731506163507,PSYC 102,A00,762832,Gentner; Tim,220,0,225,5
1731506164535,PSYC 105,A00,762833,Brady; Timothy Francis,294,0,328,34
1731506165561,PSYC 106,A00,762834,Dobkins; Karen R.,282,0,295,13
1731506166589,PSYC 108,A00,762835,Adrian; Julia Anna,240,0,250,10
1731506167623,PSYC 110,A00,762838,Heyman; Gail D.,35,0,35,0
1731506168651,PSYC 111A,A01,762841,Geller; Emma Harlan,35,0,35,0
1731506169683,PSYC 116B,A01,762844,Lang; Ariel,21,0,21,0
1731506170712,PSYC 124,A00,762845,Dickenson; Janna Alene,76,0,80,4
1731506171738,PSYC 125,A00,762851,Rose; Fred E.,134,0,145,11
1731506172763,PSYC 137,A00,762853,Lin; Chujun,289,0,295,6
1731506173794,PSYC 144,A00,762855,Yilmaz; Anne Sheyda,285,0,295,10
1731506174821,PSYC 148,A00,762856,Mc Kenzie; Craig R.M.,90,0,100,10
1731506175851,PSYC 151,A00,762858,Glaser; Dale,67,0,70,3
1731506176880,PSYC 153,A00,762859,Harris; Christine Renee,241,0,250,9
1731506177910,PSYC 154,B00,762860,Lacefield; Katharine I,277,0,295,18
1731506178938,PSYC 162,A00,762863,Wixted; John T,284,0,295,11
1731506179964,PSYC 168,A00,762864,Chapman; Eddie Nathaniel,260,0,328,68
1731506180991,PSYC 172,A00,762865,Dickenson; Janna Alene,288,0,300,12
1731506182021,PSYC 175,A00,762868,Dobkins; Karen R.,35,0,35,0
1731506183048,PSYC 179,A00,762869,Lacefield; Katharine I,269,0,328,59
1731506184083,PSYC 181,A00,762872,Anagnostaras; Stephan,318,0,328,10
1731506185111,PSYC 184,A00,762873,Wilson; Brent M,281,0,295,14
1731506186146,PSYC 185,A00,762875,Aron; Adam,249,0,250,1
1731506187175,PSYC 187,A00,762876,Schachner; Adena,0,0,35,35
1731506188210,PSYC 193,A00,762879,Chapman; Eddie Nathaniel,29,0,35,6
1731506188210,PSYC 193,B00,762880,Pilegard; Celeste Cristine,48,0,50,2
1731506188210,PSYC 193,C00,762927,Rickard; Timothy C.,24,0,25,1
1731506188210,PSYC 193,D00,762934,Mukku; Dhananjaya,34,0,35,1
1731506188210,PSYC 193,E00,762935,Staff,48,0,50,2
1731506189264,PSYC 193L,A01,762937,Staff,23,0,35,12
1731506189264,PSYC 193L,B01,762939,Brown; Sandra A,65,0,65,0
1731506191305,PSYC 194B,A01,762941,Heyman; Gail D.,25,0,25,0
1731506192336,PSYC 201B,A01,762943,Staff,11,0,20,9
1731506193366,PSYC 220,A00,762944,Winkielman; Piotr,11,0,20,9
1731506194396,PSYC 224,A00,762945,Staff,28,0,30,2
1731506195423,PSYC 242,A00,762946,Staff,27,0,30,3
1731506196453,PSYC 247,A00,762947,Walker; Caren Michelle,19,0,20,1
1731506197479,PSYC 269,A00,762948,Schachner; Adena,19,0,20,1
1731506198509,PSYC 270B,A00,762949,Dobkins; Karen R.,18,0,20,2
1731506199537,PSYC 272,A00,762950,Mukku; Dhananjaya,20,0,20,0
1731506199537,PSYC 272,B00,762951,Brashier; Nadia Marie,16,0,20,4
1731506200563,PSYC 274,A00,762954,Staff,28,0,30,2
1731506201589,PSYC 275,A00,762955,Staff,19,0,30,11
1731506202616,PSYC 280,A00,762956,Serences; John Thomas,68,0,85,17
1731506203663,PSYC 296,001,777832,Anagnostaras; Stephan,9999,0,9999,0
1731506203663,PSYC 296,002,777833,Aron; Adam,9999,0,9999,0
1731506203663,PSYC 296,003,777834,Mukku; Dhananjaya,9999,0,9999,0
1731506203663,PSYC 296,004,777835,Barner; David A.,9998,0,9999,1
1731506203663,PSYC 296,005,777845,Schachner; Adena,9999,0,9999,0
1731506203663,PSYC 296,006,777846,Brown; Sandra A,9999,0,9999,0
1731506203663,PSYC 296,007,777847,Ferreira; Victor,9999,0,9999,0
1731506203663,PSYC 296,008,777848,Geller; Emma Harlan,9998,0,9999,1
1731506203663,PSYC 296,009,777849,Gentner; Tim,9999,0,9999,0
1731506203663,PSYC 296,010,777850,Gorman; Michael R.,9999,0,9999,0
1731506203663,PSYC 296,011,777852,Gremel; Christina M,9999,0,9999,0
1731506203663,PSYC 296,012,777854,Harris; Christine Renee,9999,0,9999,0
1731506203663,PSYC 296,013,777856,Pashler; Harold E,9999,0,9999,0
1731506203663,PSYC 296,014,777857,Pilegard; Celeste Cristine,9999,0,9999,0
1731506203663,PSYC 296,015,777858,Powell; Lindsey Jane,9999,0,9999,0
1731506203663,PSYC 296,016,777864,Rickard; Timothy C.,9998,0,9999,1
1731506203663,PSYC 296,017,777866,Serences; John Thomas,9998,0,9999,1
1731506203663,PSYC 296,018,777867,Walker; Caren Michelle,9998,0,9999,1
1731506203663,PSYC 296,019,777888,Lin; Chujun,9998,0,9999,1
1731506203663,PSYC 296,020,777889,Brashier; Nadia Marie,9997,0,9999,2
1731506203663,PSYC 296,021,777890,Oesch; Nicholas W,9999,0,9999,0
1731506203663,PSYC 296,022,777892,Long; Bria,9999,0,9999,0
1731506204691,RAD 278,A00,763247,Contijoch; Francisco,0,0,0,0
1731506205720,RAD 296,001,792406,Berman; Zachary,9,0,10,1
1731506205720,RAD 296,002,792408,Staff,10,0,10,0
1731506205720,RAD 296,003,792409,Staff,10,0,10,0
1731506206749,RELI 101,A00,763768,Rahimi; Babak,36,0,40,4
1731506207777,REV 20,A00,794904,Pomeroy; Robert S.,40,0,40,0
1731506208804,REV 87,A00,794931,Markman; Kristina,20,0,20,0
1731506209835,RMAS 296,001,792520,Murphy; James D,10,0,10,0
1731506209835,RMAS 296,002,792521,Staff,10,0,10,0
1731506209835,RMAS 296,003,792522,Staff,10,0,10,0
1731506210861,RMED 296,001,792600,Duleba; Antoni,9,0,10,1
1731506210861,RMED 296,002,792611,Staff,10,0,10,0
1731506210861,RMED 296,003,792620,Staff,10,0,10,0
1731506211890,SE 9,A01,763260,Kuester; Falko,28,0,34,6
1731506211890,SE 9,A02,763263,Kuester; Falko,33,0,33,0
1731506211890,SE 9,A03,763264,Kuester; Falko,31,0,33,2
1731506212918,SE 101A,A01,763356,Van Den Einde; Yael Dahlia,194,0,200,6
1731506213947,SE 101B,A01,763358,Todd; Michael,199,0,200,1
1731506214973,SE 102,A01,763360,Jandaghi Semnani; Shabnam,32,0,45,13
1731506214973,SE 102,A02,763361,Jandaghi Semnani; Shabnam,44,0,45,1
1731506214973,SE 102,A03,763362,Jandaghi Semnani; Shabnam,40,0,45,5
1731506216004,SE 103,A01,763364,Van Den Einde; Yael Dahlia,73,0,75,2
1731506216004,SE 103,A02,763365,Van Den Einde; Yael Dahlia,69,0,75,6
1731506217036,SE 110A,A01,763508,Lanza Di Scalea; Francesco,143,0,146,3
1731506218066,SE 110B,A00,763509,Asaro; Robert J,54,0,56,2
1731506219097,SE 115,A01,763555,Zhu; Qiang,198,0,200,2
1731506220130,SE 130A,A00,763556,Loh; Kenneth J. H.,37,0,40,3
1731506221164,SE 140A,A01,763558,Uang; Chia-Ming,2,0,24,22
1731506221164,SE 140A,A02,763559,Uang; Chia-Ming,10,0,24,14
1731506221164,SE 140A,A03,763560,Uang; Chia-Ming,22,0,24,2
1731506221164,SE 140A,A04,763561,Uang; Chia-Ming,20,0,24,4
1731506222189,SE 143A,A01,763563,Kosmatka; John B,15,0,32,17
1731506222189,SE 143A,A02,763564,Kosmatka; John B,32,0,32,0
1731506223217,SE 151A,A01,763566,Shing; P. Benson,71,0,100,29
1731506224244,SE 160A,A01,763569,Kosmatka; John B,168,0,175,7
1731506225270,SE 167,A01,763571,Chadha; Mayank,12,0,15,3
1731506226299,SE 171,A01,763573,Kim; Hyonny,20,0,35,15
1731506227329,SE 182,A01,763627,Hutchinson; Tara,44,0,50,6
1731506228358,SE 201B,A00,763629,Conte; Joel P,25,0,50,25
1731506229385,SE 203A,A00,763635,Tsampras; Georgios,39,0,65,26
1731506230412,SE 207,A00,763636,Palermo; Alessandro,0,0,20,20
1731506231438,SE 232,A01,763638,Jandaghi Semnani; Shabnam,21,0,40,19
1731506232467,SE 242,A01,763644,Tomac; Ingrid,5,0,25,20
1731506233494,SE 243,A00,763684,Hutchinson; Tara,40,0,40,0
1731506234522,SE 251A,A00,763751,Qiao; Yu,19,0,25,6
1731506235548,SE 252,A00,763752,Lanza Di Scalea; Francesco,20,0,25,5
1731506236602,SE 260A,A00,763753,Kosmatka; John B,11,0,15,4
1731506237631,SE 262,A00,763754,Kim; Hyonny,4,0,5,1
1731506238658,SE 266,A00,763755,Loh; Kenneth J. H.,5,0,15,10
1731506239686,SE 267A,A01,763758,Chadha; Mayank,12,0,15,3
1731506240718,SE 270,A00,763760,Morrison; Machel Leigh,25,0,35,10
1731506241743,SE 272,A00,763761,Asaro; Robert J,13,0,15,2
1731506242773,SE 273,A00,763762,Jandaghi Semnani; Shabnam,15,0,15,0
1731506243801,SE 276B,A00,763763,Chen; Jiun-Shyan,27,0,30,3
1731506244831,SE 281,A01,763765,Kuester; Falko,27,0,40,13
1731506245858,SE 290,A00,794880,Chen; Jiun-Shyan,57,0,100,43
1731506246891,SE 296,001,779072,Asaro; Robert J,9999,0,9999,0
1731506246891,SE 296,002,779073,Chen; Jiun-Shyan,9999,0,9999,0
1731506246891,SE 296,003,779074,Conte; Joel P,9999,0,9999,0
1731506246891,SE 296,004,779075,Elgamal; Ahmed,9999,0,9999,0
1731506246891,SE 296,005,779076,Hutchinson; Tara,9999,0,9999,0
1731506246891,SE 296,006,779077,Jandaghi Semnani; Shabnam,9999,0,9999,0
1731506246891,SE 296,007,779080,Kim; Hyonny,9999,0,9999,0
1731506246891,SE 296,008,779081,Kim; Hyunsun Alicia,9999,0,9999,0
1731506246891,SE 296,009,779082,Kosmatka; John B,9999,0,9999,0
1731506246891,SE 296,010,779085,Krysl; Petr,9999,0,9999,0
1731506246891,SE 296,011,779095,Kuester; Falko,9999,0,9999,0
1731506246891,SE 296,012,779096,Lanza Di Scalea; Francesco,9999,0,9999,0
1731506246891,SE 296,013,779098,Loh; Kenneth J. H.,9999,0,9999,0
1731506246891,SE 296,014,779172,McCartney; John Scott,9999,0,9999,0
1731506246891,SE 296,015,779175,Morrison; Machel Leigh,9999,0,9999,0
1731506246891,SE 296,016,779178,Mosqueda; Gilberto,9999,0,9999,0
1731506246891,SE 296,017,779179,Qiao; Yu,9999,0,9999,0
1731506246891,SE 296,018,779180,Shing; P. Benson,9999,0,9999,0
1731506246891,SE 296,019,779182,Todd; Michael,9998,0,9999,1
1731506246891,SE 296,020,779183,Tomac; Ingrid,9999,0,9999,0
1731506246891,SE 296,021,779185,Tsampras; Georgios,9999,0,9999,0
1731506246891,SE 296,022,779186,Uang; Chia-Ming,9999,0,9999,0
1731506246891,SE 296,023,779187,Van Den Einde; Yael Dahlia,9999,0,9999,0
1731506246891,SE 296,024,779188,Zhu; Qiang,9999,0,9999,0
1731506246891,SE 296,025,779190,Tehrani; Mehran,9999,0,9999,0
1731506246891,SE 296,026,779213,Palermo; Alessandro,9999,0,9999,0
1731506246891,SE 296,027,779214,Chadha; Mayank,9999,0,9999,0
1731506247921,SIO 1,A01,764333,Stegman; David,35,0,36,1
1731506247921,SIO 1,A02,764349,Stegman; David,35,0,36,1
1731506247921,SIO 1,A03,764383,Stegman; David,36,0,36,0
1731506247921,SIO 1,A04,764386,Stegman; David,35,0,36,1
1731506248949,SIO 3,A01,764389,Aburto Oropeza; Marco Octavio,35,0,35,0
1731506248949,SIO 3,A02,794529,Aburto Oropeza; Marco Octavio,35,0,35,0
1731506248949,SIO 3,A03,794527,Aburto Oropeza; Marco Octavio,34,0,35,1
1731506248949,SIO 3,A04,794528,Aburto Oropeza; Marco Octavio,35,0,35,0
1731506249983,SIO 25,A01,764394,Rivera-Collazo; Isabel C,40,0,40,0
1731506249983,SIO 25,A02,764395,Rivera-Collazo; Isabel C,37,0,40,3
1731506249983,SIO 25,A03,764397,Rivera-Collazo; Isabel C,40,0,40,0
1731506249983,SIO 25,A04,764401,Rivera-Collazo; Isabel C,39,0,40,1
1731506249983,SIO 25,A05,764454,Rivera-Collazo; Isabel C,38,0,40,2
1731506249983,SIO 25,A06,764460,Rivera-Collazo; Isabel C,38,0,40,2
1731506249983,SIO 25,A07,764480,Rivera-Collazo; Isabel C,38,0,40,2
1731506249983,SIO 25,A08,764484,Rivera-Collazo; Isabel C,39,0,40,1
1731506249983,SIO 25,A09,764488,Rivera-Collazo; Isabel C,39,0,40,1
1731506249983,SIO 25,A10,764490,Rivera-Collazo; Isabel C,38,0,40,2
1731506251010,SIO 45,A00,764491,Cook; Geoffrey W,91,0,120,29
1731506252035,SIO 65,A00,764497,Cook; Geoffrey W,34,0,35,1
1731506253062,SIO 87,A00,764567,Aburto Oropeza; Marco Octavio,25,0,25,0
1731506253062,SIO 87,B00,764568,Cook; Geoffrey W,20,0,20,0
1731506254089,SIO 90,A00,764570,Staff,57,0,65,8
1731506255120,SIO 102,A01,764574,Day; James M.D.,41,0,45,4
1731506256172,SIO 107,A00,764576,Schartup; Amina Bocary,28,0,30,2
1731506257201,SIO 109R,A00,764581,Forman; Fonna,53,0,75,22
1731506258230,SIO 116,A00,764582,Benmarhnia; Tarik,14,0,25,11
1731506259256,SIO 119,A01,764636,Send; Uwe & Andersson; Andreas Jerry,24,0,32,8
1731506259256,SIO 119,A02,764658,Send; Uwe & Andersson; Andreas Jerry,30,0,32,2
1731506259256,SIO 119,A03,764662,Send; Uwe & Andersson; Andreas Jerry,31,0,32,1
1731506259256,SIO 119,A04,764663,Send; Uwe & Andersson; Andreas Jerry,31,0,32,1
1731506260283,SIO 120,A01,764666,Cook; Geoffrey W,19,0,24,5
1731506261310,SIO 123,A00,764667,Allen; Andrew Ellis,38,0,40,2
1731506262338,SIO 126,A01,764669,Palenik; Brian,27,0,30,3
1731506262338,SIO 126,A02,764670,Palenik; Brian,29,0,30,1
1731506263371,SIO 133,A01,764673,Baumann-Pickering ; Simone & Kacev; David,27,0,36,9
1731506263371,SIO 133,A02,764674,Baumann-Pickering ; Simone & Kacev; David,33,0,36,3
1731506263371,SIO 133,A03,764675,Baumann-Pickering ; Simone & Kacev; David,30,0,36,6
1731506263371,SIO 133,A04,764676,Baumann-Pickering ; Simone & Kacev; David,34,0,36,2
1731506264401,SIO 134,A01,764678,Barton; Andrew David,13,0,14,1
1731506264401,SIO 134,A02,764680,Barton; Andrew David,12,0,14,2
1731506264401,SIO 134,A03,764682,Barton; Andrew David,8,0,14,6
1731506264401,SIO 134,A04,764684,Barton; Andrew David,13,0,14,1
1731506264401,SIO 134,A05,764685,Barton; Andrew David,13,0,14,1
1731506264401,SIO 134,A06,764686,Barton; Andrew David,12,0,15,3
1731506264401,SIO 134,A07,764687,Barton; Andrew David,12,0,15,3
1731506264401,SIO 134,A08,764688,Barton; Andrew David,15,0,15,0
1731506265430,SIO 144,A00,764690,Day; James M.D.,5,0,5,0
1731506266455,SIO 161,A01,764693,Fan; Wenyuan,18,0,20,2
1731506267482,SIO 162,A00,764694,Wright; Vashan,23,0,25,2
1731506268510,SIO 164,A00,764696,Staff,42,0,45,3
1731506269535,SIO 172,A00,764697,Norris; Joel Roland,35,0,40,5
1731506270566,SIO 178,A00,764699,Becker; Janet Maria,20,0,20,0
1731506271592,SIO 182,A00,764701,Constable; Steven C,19,0,20,1
1731506272619,SIO 187,A01,764776,Kacev; David,33,0,35,2
1731506272619,SIO 187,A02,764777,Kacev; David,32,0,35,3
1731506272619,SIO 187,A03,764779,Kacev; David,34,0,35,1
1731506272619,SIO 187,A04,764781,Kacev; David,32,0,35,3
1731506273648,SIO 190L,A01,764790,Sandin; Stuart Adrian,32,0,35,3
1731506274672,SIO 194,A00,770729,Hill; Seth J,9999,0,9999,0
1731506275703,SIOB 262,A00,764791,Moore; Bradley S.,23,0,25,2
1731506276730,SIOB 265,A01,764793,Jensen; Paul R.,8,0,12,4
1731506277759,SIOB 272,A01,764796,Sandin; Stuart Adrian,9,0,20,11
1731506277759,SIOB 272,A02,764797,Sandin; Stuart Adrian,14,0,20,6
1731506278785,SIOB 279,A00,794515,Barton; Andrew David,11,0,20,9
1731506279819,SIOB 286,A01,764803,Mesnick; Sarah & Smith; Jennifer,0,0,20,20
1731506280845,SIOB 291,A00,764806,Staff,0,0,0,0
1731506281877,SIOB 296,A00,794530,Staff,0,0,0,20
1731506282907,SIOB 297,A00,764807,Allen; Eric,17,0,25,8
1731506283935,SIOC 200C,A00,764808,Lin; Ying-Tsong,19,0,20,1
1731506284963,SIOC 202A,A00,764810,Hao; Xuanting & Lin; Ying-Tsong,22,0,30,8
1731506285992,SIOC 203B,A00,764811,Llewellyn Smith; Stefan G.,22,0,25,3
1731506287018,SIOC 207B,A00,764813,Meyer; Florian,1,0,5,4
1731506288048,SIOC 208,A00,764814,Merrifield; Mark A,30,0,40,10
1731506289075,SIOC 209,A00,764881,Benmarhnia; Tarik,12,0,30,18
1731506289075,SIOC 209,B00,794517,Charbit; Lia,30,0,30,0
1731506290100,SIOC 211A,A00,764882,Mackinnon; Jennifer A.,18,0,25,7
1731506291127,SIOC 212A,A00,764892,Eisenman; Ian,9,0,20,11
1731506292152,SIOC 216A,A00,794518,Werner; Bradley T.,19,0,20,1
1731506293177,SIOC 217B,A00,764895,Norris; Joel Roland,12,0,20,8
1731506294206,SIOC 217D,A00,764904,Keeling; Ralph F. & Russell; Lynn M.,19,0,20,1
1731506295231,SIOC 219,A00,796147,Mackinnon; Jennifer A. & Young; William Roy,29,0,30,1
1731506296259,SIOC 221B,A00,764907,Gille; Sarah T,17,0,25,8
1731506297287,SIOC 223,A00,764910,Send; Uwe & Merrifield; Mark A,18,0,20,2
1731506298316,SIOC 237B,A00,764912,Stramski; Dariusz,17,0,20,3
1731506299343,SIOC 296,A00,799576,Staff,0,0,0,0
1731506300385,SIOG 200C,A00,794531,Fan; Wenyuan,0,0,0,0
1731506301412,SIOG 223B,A00,764966,Agnew; Duncan Carr & Fan; Wenyuan,18,0,20,2
1731506302442,SIOG 227A,A00,765040,Gabriel; Anne Alice-Agnes,5,0,10,5
1731506303466,SIOG 228,A00,765043,Kacev; David,7,0,20,13
1731506304493,SIOG 229,A00,765046,Borsa; Adrian Antal,19,0,20,1
1731506305518,SIOG 234,A00,765047,Sandwell; David T,13,0,15,2
1731506306548,SIOG 237,A01,765099,Fialko; Yuri A.,18,0,20,2
1731506307577,SIOG 239,A00,765100,Gabriel; Anne Alice-Agnes,20,0,20,0
1731506308602,SIOG 252A,A00,765102,Day; James M.D.,5,0,10,5
1731506309628,SIOG 260,A00,765105,Schartup; Amina Bocary,21,0,50,29
1731506310654,SOCE 194,A00,770728,Hill; Seth J,9999,0,9999,0
1731506311680,SOCG 202,A00,764221,Goldman; Harvey Stern,4,0,10,6
1731506312709,SOCG 203,A00,764223,Ribas Norris; Janet Vanesa,1,0,10,9
1731506313739,SOCG 205,A00,764255,Sutton; April Marie,6,0,10,4
1731506314766,SOCG 208B,A00,764258,Ng; Kwai,5,0,10,5
1731506315793,SOCG 209,A00,764259,Lewis; Kevin Michael,0,0,10,10
1731506316824,SOCG 247,A00,764260,Edington; Claire Ellen,5,0,5,0
1731506317853,SOCG 253,A00,764262,Evans; John Hyde,4,0,8,4
1731506318879,SOCG 255C,A00,764266,McKenzie; Kerry V.,5,0,5,0
1731506319906,SOCG 255D,A00,764272,Lampland; Martha,5,0,5,0
1731506320933,SOCG 284,B00,800628,Navon; Daniel,0,0,0,0
1731506321959,SOCG 290,A00,794511,Gong; Neil M,9,0,10,1
1731506322985,SOCI 1,A01,763771,Rogers; Julia Ellen,30,0,30,0
1731506322985,SOCI 1,A02,763835,Rogers; Julia Ellen,29,0,30,1
1731506322985,SOCI 1,A03,763839,Rogers; Julia Ellen,30,0,30,0
1731506322985,SOCI 1,A04,763845,Rogers; Julia Ellen,27,0,30,3
1731506322985,SOCI 1,A05,763860,Rogers; Julia Ellen,29,0,30,1
1731506322985,SOCI 1,A06,763866,Rogers; Julia Ellen,30,0,30,0
1731506324013,SOCI 2,A01,763874,Staff,32,0,32,0
1731506324013,SOCI 2,A02,763875,Staff,30,0,32,2
1731506324013,SOCI 2,A03,763876,Staff,30,0,32,2
1731506324013,SOCI 2,A04,763896,Staff,30,0,32,2
1731506324013,SOCI 2,A05,763899,Staff,30,0,32,2
1731506324013,SOCI 2,A06,763901,Staff,31,0,32,1
1731506324013,SOCI 2,A07,763902,Staff,30,0,32,2
1731506324013,SOCI 2,A08,763904,Staff,31,0,32,1
1731506325045,SOCI 20,A01,763907,Kenworthy; Lane A.,30,0,30,0
1731506325045,SOCI 20,A02,763908,Kenworthy; Lane A.,26,0,30,4
1731506326070,SOCI 60,A01,763977,Ribas Norris; Janet Vanesa,28,0,32,4
1731506326070,SOCI 60,A02,763979,Ribas Norris; Janet Vanesa,31,0,32,1
1731506327096,SOCI 70,A01,763986,Lewis; Kevin Michael,25,0,30,5
1731506327096,SOCI 70,A02,763988,Lewis; Kevin Michael,30,0,30,0
1731506327096,SOCI 70,A03,763990,Lewis; Kevin Michael,27,0,30,3
1731506327096,SOCI 70,A04,764042,Lewis; Kevin Michael,27,0,30,3
1731506328122,SOCI 100,A01,764047,Goldman; Harvey Stern,29,0,30,1
1731506328122,SOCI 100,A02,764048,Goldman; Harvey Stern,29,0,30,1
1731506328122,SOCI 100,A03,764052,Goldman; Harvey Stern,28,0,30,2
1731506328122,SOCI 100,A04,764058,Goldman; Harvey Stern,28,0,30,2
1731506329148,SOCI 103M,A00,764059,Kilpatrick; Kevin,25,0,30,5
1731506330175,SOCI 104,A00,764066,Arnal; Maud Marie Leonie,25,0,30,5
1731506331201,SOCI 106,A00,795036,Shafir; Gershon,29,0,30,1
1731506332230,SOCI 109,A00,764070,Kilpatrick; Kevin,29,0,30,1
1731506333259,SOCI 117,A01,764078,Jones; Gabrielle Anastasia,15,0,17,2
1731506333259,SOCI 117,A02,764084,Jones; Gabrielle Anastasia,16,0,17,1
1731506333259,SOCI 117,A03,764085,Jones; Gabrielle Anastasia,17,0,17,0
1731506333259,SOCI 117,A04,764086,Jones; Gabrielle Anastasia,19,0,19,0
1731506333259,SOCI 117,B01,764163,Aragon; Maria Jose,8,0,10,2
1731506333259,SOCI 117,B02,764170,Aragon; Maria Jose,10,0,10,0
1731506334285,SOCI 118,A00,764178,Rogers; Julia Ellen,74,0,75,1
1731506335313,SOCI 119,A00,764179,Victoria Torres; Pablo,86,0,90,4
1731506336338,SOCI 120T,A00,764180,Staff,56,0,56,0
1731506337364,SOCI 124,A00,764181,Kenworthy; Lane A.,48,0,50,2
1731506338394,SOCI 125,A00,764182,Watson; Tobias,63,0,65,2
1731506339424,SOCI 126,A01,764184,Jones; Makeba,17,0,20,3
1731506339424,SOCI 126,A02,764185,Jones; Makeba,20,0,20,0
1731506339424,SOCI 126,A03,764186,Jones; Makeba,20,0,20,0
1731506340452,SOCI 127,A00,764187,Fitzgerald; David S,60,0,65,5
1731506341480,SOCI 130E,A00,764188,Pitt; Richard Norris,42,0,45,3
1731506342508,SOCI 133E,A00,764189,Pitt; Richard Norris,55,0,56,1
1731506343536,SOCI 135,A00,764190,Payne; Christine Anna,70,0,74,4
1731506344563,SOCI 136E,A00,764191,Ruiz; Jonathan Joseph,55,0,56,1
1731506345594,SOCI 136F,A00,764192,Gong; Neil M,55,0,56,1
1731506346620,SOCI 140,A00,764193,Tirshfield; Jeffrey T,46,0,49,3
1731506347650,SOCI 142,A00,764194,Crofts; Christine,56,0,70,14
1731506348675,SOCI 144P,A00,764195,Estefan; Michel,71,0,75,4
1731506349701,SOCI 148,A00,764196,Payne; Christine Anna,93,0,100,7
1731506350732,SOCI 148E,A00,764197,Calderon-Zaks; Michael Aar,43,0,45,2
1731506351760,SOCI 149,A00,764198,Alvarez; Camila Huerta,49,0,55,6
1731506352786,SOCI 150,A00,764200,Victoria Torres; Pablo,74,0,75,1
1731506353813,SOCI 154,A00,764201,Crofts; Christine,46,0,55,9
1731506354841,SOCI 159,B00,764202,Staff,56,0,56,0
1731506355867,SOCI 160,A00,764203,Ostovany; Khashayar,49,0,50,1
1731506356894,SOCI 161,A00,764204,Arnal; Maud Marie Leonie,53,0,56,3
1731506357921,SOCI 162,A00,764207,Rogers; Julia Ellen,53,0,55,2
1731506358950,SOCI 169,A00,764208,Shafir; Gershon,34,0,35,1
1731506359977,SOCI 170,A00,764209,Lampland; Martha,45,0,45,0
1731506361007,SOCI 171,A00,764210,Ruiz; Jonathan Joseph,51,0,56,5
1731506362033,SOCI 173,A00,764211,Navon; Daniel,99,0,100,1
1731506363061,SOCI 175,A00,764213,Calderon-Zaks; Michael Aar,64,0,65,1
1731506364088,SOCI 180,A00,764214,Ostovany; Khashayar,48,0,50,2
1731506365118,SOCI 183,A00,764215,Sutton; April Marie,25,0,25,0
1731506366145,SOCI 188,A01,764217,Andrews; Abigail Leslie,0,0,0,0
1731506367171,SOCI 188E,A00,764219,Jules-Rosette; Bennetta W.,30,0,30,0
1731506368198,SOCI 196B,A00,764220,Turner; Christena L.,14,0,15,1
1731506369227,SOMC 225,A00,792643,Rifkin; Dena E.,160,0,160,0
1731506370256,SOMC 227,A00,792651,Gold; Jeffrey Joseph,160,0,160,0
1731506371286,SOMC 237,A00,792671,Gold; Jeffrey Joseph,160,0,160,0
1731506372315,SOMC 238,A00,792678,Papamatheakis; Demosthenes,160,0,160,0
1731506373341,SOMC 239,A00,792686,Rifkin; Dena E.,160,0,160,0
1731506374374,SOMC 243,A00,793653,Gaines; Tommi L.,160,0,160,0
1731506375406,SOMC 245B,A01,792743,Noel; Geoffroy Pierre Jean,160,0,160,0
1731506376434,SOMC 246B,A00,792744,Eyler; Lisa T.,160,0,160,0
1731506377463,SOMC 247B,A50,792756,Calcutt; Nigel A,160,0,160,0
1731506378488,SOMC 248B,A00,792757,Joshi; Weena Erin,160,0,160,0
1731506379515,SOMC 251B,A00,792760,Eyler; Lisa T.,160,0,160,0
1731506380545,SOMC 252B,A00,792780,Taddonio; Michael Adam,160,0,160,0
1731506381575,SOMC 253B,A00,792808,Wooten; Darcy A,160,0,160,0
1731506382604,SOMC 254B,A00,792815,Joshi; Weena Erin,160,0,160,0
1731506383632,SOMC 255B,A00,792836,Allison; Matthew,160,0,160,0
1731506384659,SOMC 256B,A00,792845,Shapiro; Desiree Nicolette,160,0,160,0
1731506385687,SPPH 263A,A00,792290,O'Donoghue; Anthony John & Abagyan; Ruben,47,0,50,3
1731506386715,SPPS 200A,A00,792291,Luli; Alex J,100,0,100,0
1731506387746,SPPS 202,A00,792292,Fricovsky; Eduardo Santiago,76,0,80,4
1731506388773,SPPS 207,A01,792296,Hernandez Y Delso; Inmacul,76,0,80,4
1731506389801,SPPS 208,A00,792297,Bounthavong; Mark,76,0,80,4
1731506390828,SPPS 210,001,799992,Gustafsson; Asa Birgitta,99,0,99,0
1731506391855,SPPS 212B,A01,792301,Humber; Douglas M,80,0,80,0
1731506392881,SPPS 212D,A01,792304,Patel; Nimish,80,0,80,0
1731506393906,SPPS 216,A00,792305,Fitzgerald; Robert,80,0,80,0
1731506394933,SPPS 218A,A00,792306,Vijapurkar; Ulka,80,0,80,0
1731506396037,SPPS 223,A01,792308,Hook; Vivian Yuan-Ho,95,0,99,4
1731506397068,SPPS 224,A01,792310,Momper; Jeremiah D,76,0,80,4
1731506398094,SPPS 234,A00,792312,Rifkin; Dena E.,80,0,80,0
1731506399119,SPPS 248,A00,792315,Brandl; Katharina,80,0,80,0
1731506400145,SPPS 251,A00,792316,Chen; Timothy,20,0,20,0
1731506401173,SPPS 254,A00,792317,Shapiro; Desiree Nicolette,49,0,50,1
1731506402205,SPPS 264B,A00,792319,Tsunoda; Shirley M.,30,0,30,0
1731506403234,SPPS 270B,A00,792320,Fricovsky; Eduardo Santiago,30,0,30,0
1731506404262,SPPS 274,A00,792323,Namba; Jennifer Mariko,60,0,60,0
1731506405294,SPPS 278,A00,792325,Fricovsky; Eduardo Santiago,99,0,99,0
1731506406325,SPPS 282,A00,792326,Radic; Zoran,10,0,10,0
1731506407361,SPPS 287,A00,792327,Tsunoda; Shirley M.,60,0,60,0
1731506408391,SPPS 288,A00,792328,Saunders; Ila Maewal,98,0,99,1
1731506409417,SPPS 289,A00,792329,Armour; Jon Christopher,60,0,60,0
1731506410455,SURG 296,001,792875,Reid; Christopher,9,0,10,1
1731506410455,SURG 296,002,792880,Staff,10,0,10,0
1731506410455,SURG 296,003,792882,Staff,10,0,10,0
1731506411514,SYN 1,001,768443,Rosenberg; Ryan Glenn,17,0,20,3
1731506411514,SYN 1,002,768444,Iatarola; Briana Marie,11,0,20,9
1731506411514,SYN 1,003,768445,Bishop; Graham,14,0,20,6
1731506411514,SYN 1,004,768446,Atkinson; Arthur Laird,19,0,20,1
1731506411514,SYN 1,005,768447,Girard; Gabrielle,20,0,20,0
1731506411514,SYN 1,006,768455,Girard; Gabrielle,20,0,20,0
1731506411514,SYN 1,007,768471,Fish; Gwendolyn Anne,20,0,20,0
1731506411514,SYN 1,008,768473,Deavenport; James Cary,16,0,20,4
1731506411514,SYN 1,009,768474,Hom; Kirstyn Courtney,20,0,20,0
1731506411514,SYN 1,010,768494,Hom; Kirstyn Courtney,12,0,20,8
1731506411514,SYN 1,011,768525,Deavenport; James Cary,19,0,20,1
1731506411514,SYN 1,012,768794,Lagapa; Jason,19,0,20,1
1731506411514,SYN 1,013,768795,Meyer; Leslie Rose,17,0,20,3
1731506411514,SYN 1,014,768798,Meyer; Leslie Rose,18,0,20,2
1731506412554,SYN 1R,001,768853,Atkinson; Arthur Laird,19,0,20,1
1731506413585,SYN 2,001,768857,Birberick; Brittany Celest,20,0,20,0
1731506413585,SYN 2,002,768859,Girard; Gabrielle,17,0,20,3
1731506413585,SYN 2,003,768862,Tawater; Hanna Jean,20,0,20,0
1731506413585,SYN 2,004,768869,Tawater; Hanna Jean,17,0,20,3
1731506413585,SYN 2,005,768871,Difruscio; Mark,20,0,20,0
1731506413585,SYN 2,006,768872,Rock; Martin,18,0,20,2
1731506413585,SYN 2,007,768876,Difruscio; Mark,17,0,20,3
1731506413585,SYN 2,008,768878,Staff,20,0,20,0
1731506413585,SYN 2,010,768890,Rock; Martin,18,0,20,2
1731506413585,SYN 2,011,768891,Browne; Emily,19,0,20,1
1731506414614,SYN 2R,001,768972,Staff,18,0,20,2
1731506415650,SYN 100,A01,768983,Gladstein; Jill M,15,0,15,0
1731506415650,SYN 100,A02,768990,Gladstein; Jill M,14,0,15,1
1731506415650,SYN 100,B01,769012,Tawater; Hanna Jean,6,0,15,9
1731506415650,SYN 100,B02,769014,Tawater; Hanna Jean,5,0,15,10
1731506415650,SYN 100,C01,769019,Rosenberg; Ryan Glenn,11,0,15,4
1731506415650,SYN 100,C02,769022,Rosenberg; Ryan Glenn,15,0,15,0
1731506415650,SYN 100,D01,769025,Rosenberg; Ryan Glenn,14,0,15,1
1731506415650,SYN 100,D02,769027,Rosenberg; Ryan Glenn,12,0,15,3
1731506415650,SYN 100,E01,769044,Browne; Emily,13,0,15,2
1731506415650,SYN 100,E02,769053,Browne; Emily,14,0,15,1
1731506415650,SYN 100,F01,769071,Browne; Emily,10,0,15,5
1731506415650,SYN 100,F02,769072,Browne; Emily,15,0,15,0
1731506415650,SYN 100,G01,769096,Iatarola; Briana Marie,13,0,15,2
1731506415650,SYN 100,G02,769202,Iatarola; Briana Marie,10,0,15,5
1731506415650,SYN 100,H01,769221,Meyer; Leslie Rose,12,0,15,3
1731506415650,SYN 100,H02,795165,Meyer; Leslie Rose,14,0,15,1
1731506415650,SYN 100,I01,769227,Deavenport; James Cary,11,0,15,4
1731506415650,SYN 100,I02,769228,Deavenport; James Cary,12,0,15,3
1731506415650,SYN 100,J01,769230,Hom; Kirstyn Courtney,11,0,15,4
1731506415650,SYN 100,J02,769231,Hom; Kirstyn Courtney,14,0,15,1
1731506415650,SYN 100,K01,769233,Bishop; Graham,14,0,24,10
1731506415650,SYN 100,L01,769237,Difruscio; Mark,6,0,15,9
1731506415650,SYN 100,L02,769238,Difruscio; Mark,12,0,15,3
1731506415650,SYN 100,M01,769277,Gormally; Brenna,13,0,15,2
1731506415650,SYN 100,M02,769284,Gormally; Brenna,15,0,15,0
1731506415650,SYN 100,N01,769291,Rock; Martin,11,0,15,4
1731506415650,SYN 100,N02,769292,Rock; Martin,15,0,15,0
1731506415650,SYN 100,O01,769308,Atkinson; Arthur Laird,11,0,15,4
1731506415650,SYN 100,O02,769309,Atkinson; Arthur Laird,15,0,15,0
1731506416689,SYN 150,001,769422,Gladstein; Jill M,20,0,20,0
1731506416689,SYN 150,002,769423,Vega; Adrian,19,0,20,1
1731506416689,SYN 150,003,769424,Fish; Gwendolyn Anne,19,0,20,1
1731506416689,SYN 150,004,769427,Lagapa; Jason,20,0,20,0
1731506416689,SYN 150,005,769430,Lagapa; Jason,20,0,20,0
1731506416689,SYN 150,006,769431,Fish; Gwendolyn Anne,20,0,20,0
1731506416689,SYN 150,007,796615,Vega; Adrian,19,0,20,1
1731506417719,SYN 150R,001,769499,Vega; Adrian,20,0,20,0
1731506418765,TDAC 1,A00,760383,Walsh; Kim C.,11,0,20,9
1731506418765,TDAC 1,B00,760388,Walsh; Kim C.,19,0,20,1
1731506418765,TDAC 1,C00,760389,Walsh; Kim C.,19,0,20,1
1731506418765,TDAC 1,D00,760395,Walsh; Kim C.,16,0,20,4
1731506418765,TDAC 1,E00,760396,Walsh; Kim C.,17,0,20,3
1731506418765,TDAC 1,F00,760406,Walsh; Kim C.,17,0,20,3
1731506419802,TDAC 101,A00,760817,Harting; Carla Kelso,19,0,20,1
1731506419802,TDAC 101,B00,760819,Salovey; Todd,17,0,20,3
1731506420830,TDAC 102,A00,795388,Walsh; Kim C.,19,0,20,1
1731506421861,TDAC 108,A00,795390,Staff,14,0,16,2
1731506422891,TDAC 111,A00,760821,Meyer; Ursula,20,0,20,0
1731506423920,TDAC 115,A00,760822,Buescher; Stephen W.,14,0,20,6
1731506424952,TDAC 122,A00,795391,Perry; Lamar,30,0,30,0
1731506424952,TDAC 122,B00,796062,Celik; Aysan Karagasli,30,0,30,0
1731506425984,TDDE 1,A01,760433,Guirguis; Mark C,16,0,18,2
1731506425984,TDDE 1,A02,760434,Guirguis; Mark C,17,0,18,1
1731506425984,TDDE 1,A03,760436,Guirguis; Mark C,16,0,18,2
1731506425984,TDDE 1,A04,760513,Guirguis; Mark C,18,0,18,0
1731506425984,TDDE 1,A05,760515,Guirguis; Mark C,18,0,18,0
1731506427010,TDDE 111,A00,760823,Benzoni; Elisa,0,0,0,0
1731506428036,TDDE 130,A00,760827,Guirguis; Mark C,19,0,20,1
1731506429065,TDDE 132,A00,760828,Guirguis; Mark C,20,0,20,0
1731506430091,TDDM 1,A00,760516,Wilson; Terry A.,29,0,30,1
1731506431118,TDDM 101,A00,795403,Johnston; Holly,29,0,30,1
1731506432148,TDDR 101,A00,760835,Powell; Lora,28,0,30,2
1731506433173,TDDR 102,A00,760836,Powell; Lora,20,0,20,0
1731506434200,TDDR 190,A00,795392,Perry; Lamar,35,0,35,0
1731506435228,TDGE 1,A01,760522,Salovey; Todd,20,0,20,0
1731506435228,TDGE 1,A02,760523,Salovey; Todd,20,0,20,0
1731506435228,TDGE 1,A03,760526,Salovey; Todd,20,0,20,0
1731506435228,TDGE 1,A04,760531,Salovey; Todd,18,0,20,2
1731506435228,TDGE 1,A05,760546,Salovey; Todd,20,0,20,0
1731506435228,TDGE 1,A06,760784,Salovey; Todd,19,0,20,1
1731506436253,TDGE 11,A00,760785,Anderson; Mysia Anyse,128,0,146,18
1731506437281,TDGE 25,A00,760786,Harting; Carla Kelso,18,0,20,2
1731506437281,TDGE 25,B00,760788,Harting; Carla Kelso,17,0,20,3
1731506437281,TDGE 25,C00,760789,Harting; Carla Kelso,14,0,20,6
1731506437281,TDGE 25,D00,760790,Harting; Carla Kelso,16,0,20,4
1731506438305,TDGE 87,A00,760791,Guirguis; Mark C,20,0,20,0
1731506438305,TDGE 87,B00,795393,Adler; Steven,20,0,20,0
1731506439329,TDGE 124,A00,760838,Fulton; Julia,231,0,250,19
1731506440356,TDGE 127,A00,760839,Havis; Allan,218,0,225,7
1731506441383,TDGE 131,A00,760840,Burelle; Julie Sara Veronique,203,0,205,2
1731506442414,TDGR 210B,A00,760881,Celik; Aysan Karagasli,10,0,10,0
1731506443438,TDGR 212,A00,760883,Meyer; Ursula,10,0,10,0
1731506444463,TDGR 219,A00,760886,Perry; Lamar,0,0,0,0
1731506445492,TDGR 221A,A00,760887,Staff,10,0,10,0
1731506446521,TDGR 223B,A00,760889,Buescher; Stephen W.,10,0,10,0
1731506447550,TDGR 224B,A00,760890,Meyer; Ursula,10,0,10,0
1731506448576,TDGR 225B,A00,760891,Blair; Kyle Adam,10,0,10,0
1731506449605,TDGR 229,A00,760892,Brill; Robert L.,1,0,1,0
1731506449605,TDGR 229,B00,760893,Stalling; Vanessa,1,0,1,0
1731506449605,TDGR 229,C00,760894,Porter; Lisa,1,0,1,0
1731506450635,TDGR 244,A00,760895,Iizuka; Naomi Hisako,20,0,20,0
1731506451663,TDGR 245,A00,760898,Stalling; Vanessa,5,0,5,0
1731506452689,TDGR 250,A00,760899,Stein; Deborah Isobel,7,0,7,0
1731506453716,TDGR 251,A00,760900,Iizuka; Naomi Hisako,5,0,5,0
1731506453716,TDGR 251,B00,760901,Stein; Deborah Isobel,5,0,5,0
1731506454742,TDGR 257A,A00,760903,Staff,7,0,7,0
1731506455772,TDGR 262,A01,796141,Petrovich; Victoria A.,10,0,10,0
1731506456813,TDGR 269A,A00,760905,Petrovich; Victoria A.,18,0,20,2
1731506457839,TDGR 270C,A00,760909,Kuhl; Christopher August,20,0,20,0
1731506458865,TDGR 270D,A00,760911,McElver; Robert Harrison,20,0,20,0
1731506459891,TDGR 274,A00,760912,Brill; Robert L.,9,0,10,1
1731506460921,TDGR 275,A00,760913,Kuhl; Christopher August,10,0,10,0
1731506461948,TDGR 276,A00,760914,Benzoni; Elisa,10,0,10,0
1731506462976,TDGR 278,A00,760915,Staff,10,0,10,0
1731506462976,TDGR 278,B00,760919,Staff,20,0,20,0
1731506464006,TDGR 279,A00,760920,Benzoni; Elisa,5,0,5,0
1731506464006,TDGR 279,B00,760921,Petrovich; Victoria A.,4,0,5,1
1731506464006,TDGR 279,C00,760923,McElver; Robert Harrison,5,0,5,0
1731506464006,TDGR 279,D00,760924,Kuhl; Christopher August,5,0,5,0
1731506464006,TDGR 279,E00,760927,Brill; Robert L.,4,0,5,1
1731506465032,TDGR 282,A00,760930,McElver; Robert Harrison,10,0,10,0
1731506466061,TDGR 286,A00,760931,Staff,10,0,10,0
1731506467089,TDGR 288,A00,760932,Porter; Lisa,5,0,5,0
1731506468114,TDGR 289C,A00,760933,Mehrishi; Rishika,10,0,10,0
1731506469139,TDGR 289D,A00,760934,Power; Jade Yukana,10,0,10,0
1731506470167,TDGR 292,A00,760936,Burelle; Julie Sara Veronique,14,0,15,1
1731506471196,TDGR 293,A00,760937,Perry; Lamar,2,0,2,0
1731506472221,TDGR 296,A00,760938,Porter; Lisa,3,0,3,0
1731506472221,TDGR 296,B00,760939,Powell; Lora,3,0,3,0
1731506473248,TDGR 297,001,760940,Iizuka; Naomi Hisako,3,0,3,0
1731506474275,TDHD 20,A00,760792,Jun; Grace Shin Hae,20,0,20,0
1731506475307,TDHD 176,A00,795405,Staff,45,0,45,0
1731506476335,TDHT 10,A00,760794,Power; Jade Yukana,15,0,15,0
1731506476335,TDHT 10,B00,760795,Power; Jade Yukana,13,0,15,2
1731506477364,TDHT 22,A01,760797,Yapp; Hentyle T,24,0,24,0
1731506477364,TDHT 22,A02,760799,Yapp; Hentyle T,24,0,24,0
1731506477364,TDHT 22,A03,760801,Yapp; Hentyle T,21,0,24,3
1731506478391,TDHT 101,A00,760843,Mehrishi; Rishika,24,0,25,1
1731506478391,TDHT 101,B00,760845,Perry; Lamar,23,0,25,2
1731506479419,TDHT 102,A00,760846,Anderson; Mysia Anyse,24,0,25,1
1731506480448,TDHT 111,A00,760849,Power; Jade Yukana,17,0,20,3
1731506481474,TDMV 1,A00,760802,Arcidiacono; Kristin,25,0,30,5
1731506481474,TDMV 1,B00,760803,Staff,26,0,30,4
1731506482504,TDMV 2,A00,796063,Sammartano; Tonnie,20,0,30,10
1731506483531,TDMV 3,A00,760805,Mack; Kara Shanai',34,0,40,6
1731506484558,TDMV 11,A00,760807,Staff,28,0,30,2
1731506485587,TDMV 20,A00,760808,Alvarez; Ana Maria,0,0,0,0
1731506485587,TDMV 20,B00,760810,Smith; Alison D,30,0,30,0
1731506486617,TDMV 110,A00,760851,Weinberg; Sadie,30,0,30,0
1731506487642,TDMV 120,A00,760852,Yapp; Hentyle T,29,0,30,1
1731506487642,TDMV 120,B00,760853,Brown; Bernard Joseph,0,0,0,0
1731506488667,TDMV 123,A00,760855,Duran; Marcos Antonio,28,0,30,2
1731506489696,TDMV 130,A00,760856,Mack; Kara Shanai',40,0,40,0
1731506490728,TDMV 138,A00,795397,Corrales; Joseph Bernales,34,0,40,6
1731506491761,TDMV 140,A00,760857,Staff,37,0,40,3
1731506491761,TDMV 140,B00,760859,Corrales; Joseph Bernales,37,0,40,3
1731506491761,TDMV 140,C00,760860,Caligagan; Tony,37,0,40,3
1731506492787,TDMV 142,A00,760861,Blanco; Juan Carlos,28,0,30,2
1731506493812,TDMV 143,A00,760862,Fyall; Daunte Edward,30,0,30,0
1731506494840,TDMV 144,A00,760864,Staff,29,0,30,1
1731506495871,TDMV 146,A00,760866,Caligagan; Tony,28,0,30,2
1731506496898,TDMV 148,A00,760867,Jun; Grace Shin Hae,38,0,40,2
1731506497925,TDPF 161,A00,760869,Brown; Bernard Joseph,40,0,40,0
1731506498952,TDPF 163,A00,760870,Fyall; Daunte Edward,30,0,30,0
1731506498952,TDPF 163,B00,760871,Johnston; Holly,30,0,30,0
1731506498952,TDPF 163,C00,760872,Blanco; Juan Carlos,30,0,30,0
1731506500001,TDPR 6,A01,760812,Guirguis; Mark C,50,0,50,0
1731506500001,TDPR 6,A02,760814,Guirguis; Mark C,50,0,50,0
1731506501026,TDPR 102,A00,760873,Guirguis; Mark C,20,0,20,0
1731506502057,TDPR 104,A00,760874,Powell; Lora,15,0,15,0
1731506503082,TDPW 101,A00,760875,Stein; Deborah Isobel,20,0,20,0
1731506503082,TDPW 101,B00,760876,Stein; Deborah Isobel,19,0,20,1
1731506503082,TDPW 101,C00,760877,Stein; Deborah Isobel,20,0,20,0
1731506503082,TDPW 101,D00,760878,Stein; Deborah Isobel,18,0,20,2
1731506503082,TDPW 101,E00,760879,Stein; Deborah Isobel,20,0,20,0
1731506504110,TDPW 104,A00,760880,Staff,20,0,20,0
1731506505137,TDTR 10,A00,760815,Yapp; Hentyle T,30,0,30,0
1731506506167,TDTR 15,A00,760816,Smith; Alison D,29,0,30,1
1731506507194,TDTR 104,A00,795400,Smith; Alison D,30,0,30,0
1731506508221,TMC 15,A00,799598,Staff,25,0,25,0
1731506509248,TMC 20,A00,795572,Carver; Leslie J.,25,0,25,0
1731506510278,UROL 296,001,793638,Staff,10,0,10,0
1731506510278,UROL 296,002,793644,Staff,10,0,10,0
1731506511306,USP 2,A01,762958,Pezzoli; Keith,33,0,35,2
1731506511306,USP 2,A02,762960,Pezzoli; Keith,31,0,35,4
1731506512334,USP 3,A01,762962,Wickland; Teo Akande,34,0,35,1
1731506512334,USP 3,A02,762963,Wickland; Teo Akande,31,0,35,4
1731506513360,USP 4,A00,762964,Staff,27,0,30,3
1731506514385,USP 5,A01,762967,Sun; Feiyang,31,0,35,4
1731506514385,USP 5,A02,762968,Sun; Feiyang,33,0,35,2
1731506515418,USP 6,A01,762970,Shvartzberg Carrio; Manuel,35,0,35,0
1731506515418,USP 6,A02,762971,Shvartzberg Carrio; Manuel,34,0,35,1
1731506516451,USP 15,A01,762973,Anderson; William Raymond,32,0,35,3
1731506516451,USP 15,A02,762974,Anderson; William Raymond,34,0,35,1
1731506517482,USP 25,A00,762975,Shenkman; Michael Thomas,69,0,70,1
1731506518513,USP 100,A00,762976,Arroyo; John Christopher,66,0,70,4
1731506519539,USP 101,A00,762977,Staff,65,0,65,0
1731506520571,USP 108,A00,762978,Pezzoli; Keith,29,0,30,1
1731506521603,USP 124,A00,762979,Fulton; William,64,0,70,6
1731506522629,USP 128A,A01,762982,Lewis; Leslie R,13,0,13,0
1731506523661,USP 138,A00,762984,Anderson; William Raymond,25,0,25,0
1731506524691,USP 141A,A00,762985,Lewis; Leslie R,25,0,25,0
1731506525718,USP 143,A00,762986,Hinds; Juli Beth,198,0,225,27
1731506526743,USP 150,A00,762987,Osias; David,55,0,60,5
1731506527771,USP 151,A00,763006,Boomhower; Matthew Charles,68,0,70,2
1731506528799,USP 152A,A01,763042,Moeder; Nathan L,27,0,30,3
1731506528799,USP 152A,A02,763060,Moeder; Nathan L,30,0,30,0
1731506529826,USP 153,A00,763071,Shenkman; Michael Thomas,64,0,70,6
1731506530853,USP 158A,A00,798344,Bajaj; Ravi Siddharth,35,0,35,0
1731506531880,USP 159A,A00,763078,Gherini; Paul Pier-Carlo,8,0,8,0
1731506532910,USP 165A,A00,763079,Collins; Caroline Imani,23,0,25,2
1731506533936,USP 165B,A00,763083,Shilon; Mor,13,0,15,2
1731506534965,USP 170,A00,763084,Entezam; Maryam,48,0,50,2
1731506535991,USP 171,A00,763147,Lerner; Amy M,43,0,55,12
1731506537020,USP 173,A00,763151,Shvartzberg Carrio; Manuel,44,0,50,6
1731506538050,USP 175,A00,763152,Peerson; Susan,23,0,25,2
1731506539076,USP 177A,A00,763156,Velasco; Diego,24,0,25,1
1731506539076,USP 177A,B00,763158,Garcia; Kathleen,24,0,25,1
1731506540106,USP 179,A00,763161,Peerson; Susan,23,0,25,2
1731506541133,USP 180,A00,763164,Frank; Lawrence Douglas,28,0,30,2
1731506542163,USP 183,A00,763165,Sutton; April Marie,25,0,25,0
1731506543195,USP 185B,A01,763169,Boomhower; Matthew Charles,0,0,0,4
1731506543195,USP 185B,B01,763180,Sun; Feiyang,0,0,0,0
1731506544224,USP 187,A01,763190,Martin; Isaac,23,0,30,7
1731506544224,USP 187,A02,763196,Martin; Isaac,30,0,30,0
1731506545251,USP 188,A01,763235,Andrews; Abigail Leslie,28,0,30,2
1731506546277,USP 189,A00,763237,Arroyo; John Christopher,25,0,25,0
1731506546277,USP 189,B00,763240,Osias; David,23,0,25,2
1731506547306,USP 191A,A00,763243,Staff,15,0,20,5
1731506548337,USP 193,A00,795586,Devereux; Christina Schopp,22,0,25,3
1731506549365,USP 194,A00,770726,Hill; Seth J,9999,0,9999,0
1731506550388,USP 271,A00,763245,Lerner; Amy M,0,0,5,5
1731506551415,VIS 2,A01,769502,Segade; Alexandro Abraham,25,0,25,0
1731506551415,VIS 2,A02,769503,Segade; Alexandro Abraham,24,0,25,1
1731506551415,VIS 2,A03,769504,Segade; Alexandro Abraham,25,0,25,0
1731506551415,VIS 2,A04,769505,Segade; Alexandro Abraham,24,0,25,1
1731506551415,VIS 2,A05,769506,Segade; Alexandro Abraham,25,0,25,0
1731506551415,VIS 2,A06,769507,Segade; Alexandro Abraham,25,0,25,0
1731506551415,VIS 2,A07,769508,Segade; Alexandro Abraham,0,0,0,0
1731506551415,VIS 2,A08,769509,Segade; Alexandro Abraham,0,0,0,0
1731506552440,VIS 6,A00,769510,Staff,141,0,146,5
1731506553466,VIS 11,A01,769513,Cartwright; Lisa,33,0,34,1
1731506553466,VIS 11,A02,769514,Cartwright; Lisa,33,0,34,1
1731506553466,VIS 11,A03,769515,Cartwright; Lisa,34,0,34,0
1731506553466,VIS 11,A04,769516,Cartwright; Lisa,34,0,34,0
1731506553466,VIS 11,A05,769517,Cartwright; Lisa,34,0,34,0
1731506553466,VIS 11,A06,769519,Cartwright; Lisa,33,0,34,1
1731506553466,VIS 11,A07,769521,Cartwright; Lisa,31,0,34,3
1731506553466,VIS 11,A08,769522,Cartwright; Lisa,34,0,34,0
1731506553466,VIS 11,A09,769523,Cartwright; Lisa,33,0,34,1
1731506553466,VIS 11,A10,769524,Cartwright; Lisa,33,0,34,1
1731506553466,VIS 11,A11,769554,Cartwright; Lisa,34,0,34,0
1731506553466,VIS 11,A12,769557,Cartwright; Lisa,34,0,34,0
1731506554499,VIS 21B,A01,769570,Shen; Kuiyi,31,0,32,1
1731506554499,VIS 21B,A02,769571,Shen; Kuiyi,31,0,32,1
1731506554499,VIS 21B,A03,769587,Shen; Kuiyi,31,0,32,1
1731506554499,VIS 21B,A04,769600,Shen; Kuiyi,32,0,32,0
1731506554499,VIS 21B,A05,769639,Shen; Kuiyi,32,0,32,0
1731506554499,VIS 21B,A06,769693,Shen; Kuiyi,32,0,32,0
1731506554499,VIS 21B,A07,769710,Shen; Kuiyi,31,0,32,1
1731506554499,VIS 21B,A08,769755,Shen; Kuiyi,32,0,32,0
1731506555534,VIS 22,A01,769936,Rose; Jordan M,32,0,32,0
1731506555534,VIS 22,A02,769969,Rose; Jordan M,32,0,32,0
1731506555534,VIS 22,A03,769978,Rose; Jordan M,31,0,32,1
1731506555534,VIS 22,A04,770005,Rose; Jordan M,32,0,32,0
1731506555534,VIS 22,A05,770007,Rose; Jordan M,32,0,32,0
1731506555534,VIS 22,A06,770009,Rose; Jordan M,31,0,32,1
1731506555534,VIS 22,A07,770047,Rose; Jordan M,28,0,32,4
1731506555534,VIS 22,A08,770048,Rose; Jordan M,31,0,32,1
1731506555534,VIS 22,A09,770050,Rose; Jordan M,32,0,32,0
1731506555534,VIS 22,A10,770055,Rose; Jordan M,32,0,32,0
1731506555534,VIS 22,A11,770057,Rose; Jordan M,32,0,32,0
1731506555534,VIS 22,A12,770063,Rose; Jordan M,32,0,32,0
1731506556563,VIS 41,A01,770086,D'Elena-Tweed; Jessica Erin,24,0,25,1
1731506556563,VIS 41,A02,770194,D'Elena-Tweed; Jessica Erin,23,0,25,2
1731506556563,VIS 41,A03,770195,D'Elena-Tweed; Jessica Erin,23,0,25,2
1731506556563,VIS 41,A04,770196,D'Elena-Tweed; Jessica Erin,23,0,25,2
1731506556563,VIS 41,A05,770197,D'Elena-Tweed; Jessica Erin,24,0,25,1
1731506556563,VIS 41,A06,770198,D'Elena-Tweed; Jessica Erin,25,0,25,0
1731506556563,VIS 41,A07,770199,D'Elena-Tweed; Jessica Erin,25,0,25,0
1731506556563,VIS 41,A08,770200,D'Elena-Tweed; Jessica Erin,24,0,25,1
1731506557595,VIS 60,A01,770202,Mostajo; Lorena,25,0,25,0
1731506557595,VIS 60,A02,770203,Mostajo; Lorena,25,0,25,0
1731506557595,VIS 60,A03,770204,Mostajo; Lorena,25,0,25,0
1731506557595,VIS 60,A04,770205,Mostajo; Lorena,25,0,25,0
1731506557595,VIS 60,A05,770206,Mostajo; Lorena,25,0,25,0
1731506557595,VIS 60,A06,770207,Mostajo; Lorena,25,0,25,0
1731506558620,VIS 83,A00,770208,Kester; Grant,195,0,200,5
1731506559647,VIS 100,A00,770210,Cruz; Edwin Teddy,140,0,146,6
1731506560674,VIS 101A,A00,770215,Park; Kyong Dong,10,0,15,5
1731506560674,VIS 101A,B00,770229,Riley; Joe,13,0,15,2
1731506561702,VIS 103,A00,770230,Cruz; Edwin Teddy,145,0,146,1
1731506562731,VIS 103B,A00,770234,Park; Kyong Dong,74,0,75,1
1731506563768,VIS 105A,A00,770237,Tonies; Joshua Vanjaymes,24,0,30,6
1731506564794,VIS 105B,A00,770239,Tonies; Joshua Vanjaymes,27,0,30,3
1731506565820,VIS 105C,A00,770240,Adler; Amy,13,0,15,2
1731506566852,VIS 106A,A00,770241,Tobe; Geoffroy,25,0,25,0
1731506566852,VIS 106A,B00,770243,De Luca; Mara Julia,22,0,25,3
1731506567881,VIS 106B,A00,770244,De Luca; Mara Julia,22,0,25,3
1731506568907,VIS 107A,A00,770248,Iglesias; Janelle Ann,21,0,25,4
1731506569933,VIS 107C,A00,770249,Staff,15,0,15,0
1731506570960,VIS 108,A00,770250,Moss; Ceci,15,0,15,0
1731506570960,VIS 108,B00,770251,Adler; Amy,11,0,15,4
1731506571988,VIS 110D,A00,770253,Dean; Danielle Adobi,11,0,15,4
1731506573015,VIS 110F,A00,770254,Iglesias; Janelle Ann,14,0,15,1
1731506574046,VIS 110M,A00,770256,Dean; Danielle Adobi,15,0,15,0
1731506575073,VIS 112,A00,770257,Welchman; John C.,12,0,15,3
1731506576100,VIS 114B,A00,770260,Tronzo; William,12,0,15,3
1731506577130,VIS 124G,A00,770261,Rose; Jordan M,72,0,75,3
1731506578157,VIS 125G,A00,770262,Kester; Grant,75,0,75,0
1731506579189,VIS 126HN,A00,770264,Newsome; Elizabeth Ann,74,0,75,1
1731506580216,VIS 128C,A00,770265,Gaines; Malik Julian,75,0,75,0
1731506581252,VIS 128D,A00,770267,Asplund; Ingrid Marie,73,0,75,2
1731506582283,VIS 129E,A00,770268,Shen; Kuiyi,15,0,15,0
1731506583312,VIS 131,A00,770269,Erdmann; Dean,15,0,15,0
1731506584338,VIS 133,A01,770274,Staff,34,0,34,0
1731506584338,VIS 133,A02,770275,Staff,33,0,34,1
1731506585365,VIS 133A,A00,770276,Staff,13,0,15,2
1731506586394,VIS 135,A01,770280,Staff,21,0,22,1
1731506586394,VIS 135,A02,770281,Staff,16,0,22,6
1731506587422,VIS 141A,A01,770284,Stalbaum; Brett,23,0,25,2
1731506587422,VIS 141A,A02,770285,Stalbaum; Brett,21,0,25,4
1731506588454,VIS 142,A01,770287,Stalbaum; Brett,25,0,25,0
1731506588454,VIS 142,A02,770288,Stalbaum; Brett,25,0,25,0
1731506588454,VIS 142,A03,770290,Stalbaum; Brett,25,0,25,0
1731506588454,VIS 142,A04,770291,Stalbaum; Brett,25,0,25,0
1731506588454,VIS 142,A05,770292,Stalbaum; Brett,24,0,25,1
1731506588454,VIS 142,A06,770293,Stalbaum; Brett,25,0,25,0
1731506589486,VIS 145A,A01,770301,Stone; Patricia,20,0,22,2
1731506589486,VIS 145A,A02,770302,Stone; Patricia,22,0,22,0
1731506589486,VIS 145A,A03,770303,Stone; Patricia,22,0,22,0
1731506589486,VIS 145A,A04,770304,Stone; Patricia,20,0,22,2
1731506589486,VIS 145A,A05,770306,Stone; Patricia,21,0,22,1
1731506589486,VIS 145A,A06,770307,Stone; Patricia,21,0,22,1
1731506590514,VIS 146B,A00,794512,Twomey; Robert Daniel,15,0,15,0
1731506591542,VIS 147A,A01,770309,Staff,22,0,22,0
1731506591542,VIS 147A,A02,770311,Staff,20,0,22,2
1731506591542,VIS 147A,A03,770312,Staff,22,0,22,0
1731506591542,VIS 147A,A04,770313,Staff,22,0,22,0
1731506592568,VIS 147B,A00,770316,Akten; Mehmet,11,0,15,4
1731506593598,VIS 149,A00,770318,Alexander; Amy J,14,0,15,1
1731506593598,VIS 149,B00,795449,Crandall; Jordan,13,0,15,2
1731506594627,VIS 150,A00,770319,Wardwell; Mariana Razo,70,0,75,5
1731506595655,VIS 157D,A01,770329,Williams; Alena J,33,0,34,1
1731506595655,VIS 157D,A02,770334,Williams; Alena J,33,0,34,1
1731506596681,VIS 160A,A00,770375,Akten; Mehmet,9,0,15,6
1731506596681,VIS 160A,B00,770380,Alexander; Amy J,14,0,15,1
1731506596681,VIS 160A,C00,770391,Twomey; Robert Daniel,11,0,15,4
1731506597711,VIS 161,A00,770470,D'Elena-Tweed; Jessica Erin,14,0,15,1
1731506598738,VIS 164,A00,770484,Cross; Brian R,19,0,22,3
1731506598738,VIS 164,B00,770535,Erdmann; Dean,22,0,22,0
1731506599770,VIS 165B,A00,770548,Sprague; Sean Jeffrey,20,0,22,2
1731506600797,VIS 169A,A00,770551,Mostajo; Lorena,20,0,22,2
1731506601822,VIS 171,A00,770552,Dinco; Dino,22,0,22,0
1731506602854,VIS 174,A00,770599,Cross; Brian R,20,0,22,2
1731506602854,VIS 174,B00,770666,Dinco; Dino,21,0,22,1
1731506602854,VIS 174,C00,770705,Dinco; Dino,22,0,22,0
1731506603956,VIS 179,A00,770708,Zurita; Dmitri,22,0,22,0
1731506604985,VIS 180A,A00,770709,Erdmann; Dean,22,0,22,0
1731506606017,VIS 180B,A00,770710,Stone; Patricia,21,0,22,1
1731506607045,VIS 182A,A00,770711,Sprague; Sean Jeffrey,21,0,22,1
1731506608077,VIS 185,A00,770712,Trigilio; Michael,17,0,22,5
1731506609108,VIS 200,A00,770713,Wardwell; Mariana Razo,12,0,15,3
1731506610140,VIS 201,A00,770714,Bratton; Benjamin H.,10,0,15,5
1731506611172,VIS 202,A00,770715,Mangolte; Babette,2,0,15,13
1731506612199,VIS 203,A00,770716,Segade; Alexandro Abraham,0,0,15,15
1731506613225,VIS 242,A00,770718,Cartwright; Lisa,8,0,15,7
1731506614254,VIS 255,A00,770719,Welchman; John C.,8,0,15,7
1731506615284,VIS 260,A00,770720,Newsome; Elizabeth Ann,9,0,15,6
1731506616338,WCWP 10A,001,765834,Staff,0,0,0,0
1731506616338,WCWP 10A,002,765835,Windham; Emily,13,0,20,7
1731506616338,WCWP 10A,003,765836,Windham; Emily,17,0,20,3
1731506616338,WCWP 10A,004,765837,Escobar; Jordan Christophe,17,0,20,3
1731506616338,WCWP 10A,005,765838,Windham; Emily,16,0,20,4
1731506616338,WCWP 10A,006,765839,Escobar; Jordan Christophe,18,0,20,2
1731506616338,WCWP 10A,007,765840,Escobar; Jordan Christophe,19,0,20,1
1731506616338,WCWP 10A,008,765841,Staff,0,0,0,0
1731506616338,WCWP 10A,009,765842,Merryman; Walter,19,0,20,1
1731506616338,WCWP 10A,010,765843,Merryman; Walter,18,0,20,2
1731506616338,WCWP 10A,011,765844,Staff,0,0,0,0
1731506616338,WCWP 10A,012,765855,Staff,0,0,0,0
1731506616338,WCWP 10A,013,766004,Staff,0,0,0,0
1731506616338,WCWP 10A,014,766006,Susi; Natalie,15,0,20,5
1731506616338,WCWP 10A,015,766008,Welji; Haleema Nazir,18,0,20,2
1731506616338,WCWP 10A,016,766010,Martiniuk; Jill,19,0,20,1
1731506616338,WCWP 10A,017,766012,Martiniuk; Jill,16,0,20,4
1731506616338,WCWP 10A,018,766050,Staff,0,0,0,0
1731506616338,WCWP 10A,019,766051,Martiniuk; Jill,14,0,20,6
1731506616338,WCWP 10A,020,766052,Staff,0,0,0,0
1731506616338,WCWP 10A,021,766053,Holloway Ii; Mathew,19,0,20,1
1731506616338,WCWP 10A,022,766054,Holloway Ii; Mathew,20,0,20,0
1731506616338,WCWP 10A,023,766055,Holloway Ii; Mathew,20,0,20,0
1731506617379,WCWP 10B,001,766056,Staff,0,0,0,0
1731506617379,WCWP 10B,002,766057,Ornelas; Tricia,19,0,20,1
1731506617379,WCWP 10B,003,766058,Ornelas; Tricia,19,0,20,1
1731506617379,WCWP 10B,004,766119,Gagnon; Jeffrey C,0,0,0,0
1731506617379,WCWP 10B,005,766120,Ornelas; Tricia,15,0,20,5
1731506617379,WCWP 10B,006,766127,Staff,0,0,0,0
1731506617379,WCWP 10B,007,766162,Staff,0,0,0,0
1731506617379,WCWP 10B,008,766181,Dhir; Simrita,20,0,20,0
1731506617379,WCWP 10B,009,766182,Dhir; Simrita,17,0,20,3
1731506617379,WCWP 10B,010,766186,Uriarte; Emma,11,0,20,9
1731506617379,WCWP 10B,011,766187,Dhir; Simrita,18,0,20,2
1731506617379,WCWP 10B,012,766188,Uriarte; Emma,12,0,20,8
1731506617379,WCWP 10B,013,766189,Staff,0,0,0,0
1731506617379,WCWP 10B,014,766190,Staff,0,0,0,0
1731506617379,WCWP 10B,015,766191,Staff,0,0,0,0
1731506617379,WCWP 10B,016,766193,Staff,0,0,0,0
1731506617379,WCWP 10B,017,766194,Staff,0,0,0,0
1731506617379,WCWP 10B,018,766195,Staff,0,0,0,0
1731506617379,WCWP 10B,019,766196,Staff,0,0,0,0
1731506617379,WCWP 10B,020,766198,Staff,0,0,0,0
1731506617379,WCWP 10B,021,766201,Staff,0,0,0,0
1731506617379,WCWP 10B,022,766203,Staff,0,0,0,0
1731506617379,WCWP 10B,023,766204,Staff,0,0,0,0
1731506617379,WCWP 10B,024,766205,Staff,0,0,0,0
1731506617379,WCWP 10B,025,766207,Staff,0,0,0,0
1731506617379,WCWP 10B,026,766208,Staff,0,0,0,0
1731506617379,WCWP 10B,027,766209,Staff,0,0,0,0
1731506617379,WCWP 10B,028,766210,Staff,0,0,0,0
1731506618418,WCWP 100,A00,766213,McCleary; Keith Long,17,0,20,3
1731506618418,WCWP 100,B00,766215,McCleary; Keith Long,20,0,20,0
1731506618418,WCWP 100,C00,766217,McCleary; Keith Long,20,0,20,0
1731506618418,WCWP 100,D00,766220,Twohig; Niall Ivan,17,0,20,3
1731506618418,WCWP 100,E00,766221,Twohig; Niall Ivan,14,0,20,6
1731506618418,WCWP 100,F00,766222,Young; Mark T,19,0,20,1
1731506618418,WCWP 100,G00,766223,Young; Mark T,18,0,20,2
1731506618418,WCWP 100,H00,766224,Twohig; Niall Ivan,20,0,20,0
1731506618418,WCWP 100,I00,766228,Young; Mark T,19,0,20,1
1731506619444,WES 237A,A00,763250,Weibel; Nadir,15,0,15,0
1731506620471,WES 268B,A01,763253,Ling; Patrick L,15,0,15,0
1731506621497,WES 269,A00,763255,Pannuto; Patrick William,15,0,15,0
1731506623705,AAPI 198,A00,795102,Solomon; Amanda Lee Albaniel,9999,0,9999,0
1731506624736,AAS 10,A01,734476,Butler; Elizabeth Annette,32,0,34,2
1731506624736,AAS 10,A02,734477,Butler; Elizabeth Annette,33,0,34,1
1731506625768,AAS 11,A01,734479,Butler; Elizabeth Annette,33,0,34,1
1731506625768,AAS 11,A02,734480,Butler; Elizabeth Annette,33,0,34,1
1731506626802,AESE 241,A00,733587,Erat; Sanjiv & Wade; Jon P,35,0,35,0
1731506627830,AESE 278B,A00,733588,Gessner; Richard K.,35,0,35,0
1731506628859,AESE 278C,A00,733589,Wade; Jon P,35,0,35,0
1731506629885,AESE 279A,A00,733591,Zak; Alexander & Wade; Jon P,35,0,35,0
1731506630912,ANAR 121,A01,733532,Staff,39,0,40,1
1731506631944,ANAR 143,A00,799583,Dunseth; Zachary Clark,29,0,30,1
1731506632973,ANAR 158,A00,733535,Goldstein; Paul S,36,0,40,4
1731506634001,ANAR 164,A00,733536,Staff,44,0,45,1
1731506635028,ANAR 165,A00,799586,Staff,30,0,30,0
1731506636060,ANBI 100,A00,733537,Fox; Patrick Keolu Ozer,39,0,40,1
1731506637090,ANBI 130,A00,733538,Non; Amy L,55,0,70,15
1731506638116,ANBI 134,A00,733552,Simonson; Tatum Sasha Summ,28,0,30,2
1731506639141,ANBI 140,A00,733553,Staff,34,0,40,6
1731506640173,ANBI 143,A00,733554,Wilder; Linnea Lorene,36,0,40,4
1731506641201,ANBI 173,A00,733555,Wilder; Linnea Lorene,69,0,70,1
1731506642228,ANES 296,001,791559,Staff,10,0,10,0
1731506642228,ANES 296,002,791560,Staff,10,0,10,0
1731506642228,ANES 296,003,791561,Staff,10,0,10,0
1731506643261,ANSC 101A,A00,733558,Kang; Byung Chu,148,0,150,2
1731506644288,ANSC 109,A00,733559,Pedersen; David,40,0,40,0
1731506645322,ANSC 125,A00,733560,Brenner; Suzanne A,65,0,70,5
1731506646349,ANSC 135,A00,733561,Stone; Annika Britt,38,0,40,2
1731506647376,ANSC 139,A00,733562,Csordas; Thomas J.,20,0,20,0
1731506648404,ANSC 146,A00,733563,Kang; Byung Chu,69,0,70,1
1731506649433,ANSC 148,A00,733564,Schonberg; Jeffrey,46,0,46,0
1731506650461,ANSC 150,A00,733565,Sloane; Julia Kathryn,35,0,35,0
1731506651487,ANSC 154,A00,733566,Brenner; Suzanne A,10,0,12,2
1731506652518,ANSC 164,A00,733567,Stewart; Alexander B,37,0,40,3
1731506653546,ANSC 184,A00,733568,Fortier; Jana,40,0,40,0
1731506654573,ANSC 190,A00,733569,Jassal; Aftab,39,0,40,1
1731506655601,ANTH 5,A00,733397,Semendeferi; Ekaterini,20,0,20,0
1731506656630,ANTH 10,A00,733400,Staff,247,0,250,3
1731506657664,ANTH 21,A01,733407,Stone; Annika Britt,30,0,30,0
1731506657664,ANTH 21,A02,733409,Stone; Annika Britt,29,0,30,1
1731506657664,ANTH 21,A03,733411,Stone; Annika Britt,27,0,30,3
1731506657664,ANTH 21,A04,733414,Stone; Annika Britt,24,0,30,6
1731506657664,ANTH 21,A05,733416,Stone; Annika Britt,27,0,30,3
1731506658692,ANTH 23,A01,733472,Stewart; Alexander B,35,0,35,0
1731506658692,ANTH 23,A02,733501,Stewart; Alexander B,34,0,35,1
1731506658692,ANTH 23,A03,733502,Stewart; Alexander B,34,0,35,1
1731506658692,ANTH 23,A04,733507,Stewart; Alexander B,35,0,35,0
1731506658692,ANTH 23,A05,733525,Stewart; Alexander B,35,0,35,0
1731506658692,ANTH 23,A06,733528,Stewart; Alexander B,35,0,35,0
1731506659722,ANTH 45,A00,733530,Jassal; Aftab,30,0,30,0
1731506660792,ANTH 87,A00,795649,Pedersen; David,20,0,20,0
1731506661818,ANTH 102,A00,733570,Fox; Patrick Keolu Ozer,144,0,150,6
1731506662848,ANTH 106,A00,733571,Sloane; Julia Kathryn,30,0,30,0
1731506663877,ANTH 107,A00,733572,Shtienberg; Gilad,28,0,30,2
1731506664905,ANTH 111,A00,733573,Bialecki; Jon Anthony,39,0,40,1
1731506665933,ANTH 128A,A01,733576,Lewis; Leslie R,12,0,12,0
1731506666966,ANTH 196B,A00,733577,Varma; Saiba,15,0,15,0
1731506667995,ANTH 200,A00,733578,Fox; Patrick Keolu Ozer,15,0,15,0
1731506669026,ANTH 203,A00,733579,Gagneux; Pascal,9,0,15,6
1731506670056,ANTH 212,A00,733582,Marchetto; Maria Carolina,14,0,15,1
1731506671086,ANTH 230,001,799994,Gagneux; Pascal,19,0,20,1
1731506672112,ANTH 231,A00,799587,Staff,13,0,15,2
1731506673138,ANTH 236,A00,733583,Csordas; Thomas J.,9,0,12,3
1731506674166,ANTH 269,A00,733584,Lampland; Martha,5,0,5,0
1731506675195,ANTH 273,A00,733585,McKenzie; Kerry V.,5,0,5,0
1731506676220,ANTH 280F,A00,733586,Yeh; Rihan Wen Xin,13,0,15,2
1731506677252,ANTH 295,001,799995,Algaze; Guillermo,3,0,3,0
1731506677252,ANTH 295,002,799996,Brenner; Suzanne A,3,0,3,0
1731506677252,ANTH 295,003,799997,Csordas; Thomas J.,3,0,3,0
1731506677252,ANTH 295,004,799998,Fox; Patrick Keolu Ozer,3,0,3,0
1731506677252,ANTH 295,005,799999,Gagneux; Pascal,3,0,3,0
1731506677252,ANTH 295,006,800000,Goldstein; Paul S,3,0,3,0
1731506677252,ANTH 295,007,800001,Hankins; Joseph D.,3,0,3,0
1731506677252,ANTH 295,008,800002,Jassal; Aftab,3,0,3,0
1731506677252,ANTH 295,009,800035,Jenkins; Janis A.,3,0,3,0
1731506677252,ANTH 295,010,800036,Kaiser; Bronwyn Nicole,3,0,3,0
1731506677252,ANTH 295,011,800037,Kang; Byung Chu,3,0,3,0
1731506677252,ANTH 295,012,800038,Marchetto; Maria Carolina,3,0,3,0
1731506677252,ANTH 295,013,800039,Non; Amy L,3,0,3,0
1731506677252,ANTH 295,014,800040,Pedersen; David,3,0,3,0
1731506677252,ANTH 295,015,800041,Rivera-Collazo; Isabel C,3,0,3,0
1731506677252,ANTH 295,016,800042,Varma; Saiba,3,0,3,0
1731506677252,ANTH 295,017,800043,Yeh; Rihan Wen Xin,3,0,3,0
1731506678322,ANTH 296,001,800044,Braswell; Geoffrey E.,3,0,3,0
1731506678322,ANTH 296,002,800045,Marchetto; Maria Carolina,3,0,3,0
1731506678322,ANTH 296,003,800107,Rivera-Collazo; Isabel C,3,0,3,0
1731506678322,ANTH 296,004,800108,Varma; Saiba,2,0,3,1
1731506678322,ANTH 296,005,800109,Algaze; Guillermo,3,0,3,0
1731506678322,ANTH 296,006,800110,Brenner; Suzanne A,3,0,3,0
1731506678322,ANTH 296,007,800111,Csordas; Thomas J.,3,0,3,0
1731506678322,ANTH 296,008,800112,Fox; Patrick Keolu Ozer,3,0,3,0
1731506678322,ANTH 296,009,800113,Gagneux; Pascal,3,0,3,0
1731506678322,ANTH 296,010,800114,Goldstein; Paul S,2,0,3,1
1731506678322,ANTH 296,011,800116,Hankins; Joseph D.,3,0,3,0
1731506678322,ANTH 296,012,800117,Jassal; Aftab,3,0,3,0
1731506678322,ANTH 296,013,800118,Jenkins; Janis A.,3,0,3,0
1731506678322,ANTH 296,014,800119,Kaiser; Bronwyn Nicole,2,0,3,1
1731506678322,ANTH 296,015,800120,Kang; Byung Chu,3,0,3,0
1731506678322,ANTH 296,016,800121,Levy; Thomas E,3,0,3,0
1731506678322,ANTH 296,017,800122,Non; Amy L,3,0,3,0
1731506678322,ANTH 296,018,800123,Pedersen; David,3,0,3,0
1731506678322,ANTH 296,019,800184,Postero; Nancy Grey,3,0,3,0
1731506678322,ANTH 296,020,800185,Semendeferi; Ekaterini,3,0,3,0
1731506678322,ANTH 296,021,800186,Yeh; Rihan Wen Xin,3,0,3,0
1731506679353,ASTR 3,A01,733595,Trumbo; Samantha Kathleen,294,0,300,6
1731506680380,ASTR 20B,A01,733598,Konopacky; Quinn Morgan,49,0,50,1
1731506681409,ASTR 99,001,799856,Konopacky; Quinn Morgan,9999,0,9999,0
1731506682435,ASTR 102,A01,733600,Diamond; Patrick H & Konopacky; Quinn Morgan,29,0,30,1
1731506683463,ASTR 105,A01,733607,Boggs; Steven Edward,30,0,30,0
1731506684490,ASTR 122,A01,733609,Keres; Dusan,40,0,40,0
1731506685521,ASTR 150,A01,733641,Theissen; Christopher Alexander,28,0,30,2
1731506685521,ASTR 150,A02,733642,Theissen; Christopher Alexander,28,0,30,2
1731506686557,ASTR 201,A00,790490,Burgasser; Adam Jonathan,9,0,15,6
1731506687587,ASTR 210,A00,733648,Staff,12,0,15,3
1731506688612,ASTR 220,A00,733650,Wright; Shelley Adams,12,0,15,3
1731506689638,ASTR 250,A00,733652,Theissen; Christopher Alexander & Hosseinzadeh; Griffin Alex,22,0,30,8
1731506690665,ASTR 251,A00,733653,Theissen; Christopher Alexander & Hosseinzadeh; Griffin Alex,23,0,30,7
1731506691694,AUD 236,A01,791504,Harris; Jeffrey Paul,5,0,5,0
1731506692722,AUD 263,A00,791538,Zettner; Erika,13,0,13,0
1731506693751,AUD 276,A00,791507,Zettner; Erika,13,0,13,0
1731506694776,AUD 284,A01,791509,Zettner; Erika,13,0,13,0
1731506695804,AUD 291,A00,791534,Zettner; Erika,13,0,13,0
1731506696834,AUD 296,A00,791535,Zettner; Erika,13,0,13,0
1731506697894,AWP 3,002,733077,Ajo; Frances Margaret,12,0,12,0
1731506697894,AWP 3,003,733078,Given; William Allan,12,0,12,0
1731506697894,AWP 3,004,733080,Ajo; Frances Margaret,12,0,12,0
1731506697894,AWP 3,005,733082,Westerfeld; Kevin John,12,0,12,0
1731506697894,AWP 3,007,733085,O'Neil; Courtney L,12,0,12,0
1731506697894,AWP 3,008,733087,O'Neil; Courtney L,12,0,12,0
1731506697894,AWP 3,009,733138,Zimmerman; Guy,12,0,12,0
1731506697894,AWP 3,010,733139,Zimmerman; Guy,12,0,12,0
1731506697894,AWP 3,011,733140,Westerfeld; Kevin John,12,0,12,0
1731506697894,AWP 3,012,733141,Zimmerman; Guy,11,0,12,1
1731506697894,AWP 3,013,733142,Sartor; Alexandra,12,0,12,0
1731506697894,AWP 3,014,733143,Sartor; Alexandra,12,0,12,0
1731506697894,AWP 3,015,733144,Vaughn; Kelsey Sara,12,0,12,0
1731506697894,AWP 3,016,733145,Vaughn; Kelsey Sara,12,0,12,0
1731506697894,AWP 3,019,733148,Kolodezh; Samuel,12,0,12,0
1731506697894,AWP 3,020,733149,Kolodezh; Samuel,12,0,12,0
1731506697894,AWP 3,022,733151,Kolodezh; Samuel,12,0,12,0
1731506698946,AWP 4A,001,733154,Tsurska Svetina; Olena,13,0,14,1
1731506698946,AWP 4A,002,733156,Tsurska Svetina; Olena,10,0,14,4
1731506698946,AWP 4A,003,733157,Chandler; Bailee Daniele,12,0,14,2
1731506698946,AWP 4A,004,733158,Chandler; Bailee Daniele,13,0,14,1
1731506698946,AWP 4A,005,733159,Hall; Graham T,14,0,14,0
1731506698946,AWP 4A,006,733160,Hall; Graham T,14,0,14,0
1731506698946,AWP 4A,007,733161,Falcon; Jennifer A,14,0,14,0
1731506698946,AWP 4A,008,733162,Falcon; Jennifer A,13,0,14,1
1731506698946,AWP 4A,011,733165,Tiernan; Christa Michelle,14,0,14,0
1731506698946,AWP 4A,012,733166,Tiernan; Christa Michelle,12,0,14,2
1731506698946,AWP 4A,013,733168,Gardella; Alexander Drew,14,0,14,0
1731506698946,AWP 4A,014,733169,Gardella; Alexander Drew,12,0,14,2
1731506698946,AWP 4A,016,733171,Coulter; Jane Elisabeth,14,0,14,0
1731506698946,AWP 4A,017,733172,Spicer; Jacqueline,14,0,14,0
1731506698946,AWP 4A,018,733173,Spicer; Jacqueline,14,0,14,0
1731506698946,AWP 4A,019,733174,Christie; Veronica Ann,14,0,14,0
1731506698946,AWP 4A,020,733175,Bolin; Jillian,14,0,14,0
1731506698946,AWP 4A,021,733176,Bolin; Jillian,14,0,14,0
1731506698946,AWP 4A,022,733177,Zroka; Amy Liane,14,0,14,0
1731506698946,AWP 4A,023,733178,Zroka; Amy Liane,14,0,14,0
1731506698946,AWP 4A,024,733179,Christie; Veronica Ann,13,0,14,1
1731506698946,AWP 4A,025,733181,Steinberg; Stacy A,14,0,14,0
1731506698946,AWP 4A,026,733182,Steinberg; Stacy A,12,0,14,2
1731506698946,AWP 4A,027,733184,Gilmore; Lauren Monica,14,0,14,0
1731506698946,AWP 4A,028,733185,Gilmore; Lauren Monica,14,0,14,0
1731506698946,AWP 4A,032,733195,Grant; Melinda G,14,0,14,0
1731506698946,AWP 4A,033,733198,Grant; Melinda G,14,0,14,0
1731506698946,AWP 4A,037,733286,Jones; William Jadie,13,0,14,1
1731506698946,AWP 4A,038,733310,Jones; William Jadie,14,0,14,0
1731506698946,AWP 4A,039,733318,Heiser; Jerrod A,14,0,14,0
1731506698946,AWP 4A,040,733320,Heiser; Jerrod A,13,0,14,1
1731506698946,AWP 4A,041,733321,Bourdeau; Joseph Albert,14,0,14,0
1731506698946,AWP 4A,042,733331,Bourdeau; Joseph Albert,14,0,14,0
1731506698946,AWP 4A,043,733337,Wilson; Natalie Ann,13,0,14,1
1731506698946,AWP 4A,044,733378,Wilson; Natalie Ann,12,0,14,2
1731506698946,AWP 4A,045,733379,Staff,14,0,14,0
1731506698946,AWP 4A,046,733380,Staff,14,0,14,0
1731506698946,AWP 4A,047,733385,Staff,14,0,14,0
1731506698946,AWP 4A,048,733386,Staff,14,0,14,0
1731506698946,AWP 4A,049,733388,Staff,0,0,0,0
1731506698946,AWP 4A,050,733389,Staff,0,0,0,0
1731506698946,AWP 4A,051,733390,Staff,0,0,0,0
1731506698946,AWP 4A,052,733392,Staff,0,0,0,0
1731506698946,AWP 4A,053,733394,Staff,0,0,0,0
1731506698946,AWP 4A,054,733395,Staff,0,0,0,0
1731506699972,BENG 1,A01,733659,Sah; Robert Lie-Yuan,62,0,65,3
1731506699972,BENG 1,A02,733715,Sah; Robert Lie-Yuan,60,0,65,5
1731506699972,BENG 1,A03,733716,Sah; Robert Lie-Yuan,63,0,65,2
1731506701007,BENG 112A,A01,733831,Schmid-Schoenbein; Geert W,28,0,35,7
1731506701007,BENG 112A,A02,733832,Schmid-Schoenbein; Geert W,34,0,35,1
1731506702043,BENG 119B,A00,733833,Taylor Amos; Alyssa C,22,0,30,8
1731506703076,BENG 120,A01,733837,Huang; Xiaohua,35,0,35,0
1731506703076,BENG 120,A02,733843,Huang; Xiaohua,33,0,35,2
1731506704104,BENG 123,A01,733846,Palsson; Bernhard O.,24,0,30,6
1731506704104,BENG 123,A02,733847,Palsson; Bernhard O.,24,0,30,6
1731506705137,BENG 126B,A00,733850,Taylor Amos; Alyssa C,26,0,30,4
1731506706162,BENG 127B,A00,733860,Taylor Amos; Alyssa C,30,0,30,0
1731506707187,BENG 128B,A00,733862,Taylor Amos; Alyssa C,30,0,30,0
1731506708214,BENG 129B,A00,733865,Taylor Amos; Alyssa C,30,0,30,0
1731506709250,BENG 130,A00,733907,Subramaniam; Shankar,141,0,145,4
1731506710278,BENG 139B,A00,734022,Taylor Amos; Alyssa C,30,0,30,0
1731506711303,BENG 140A,A01,734136,Silva; Gabriel,27,0,30,3
1731506711303,BENG 140A,A02,734141,Silva; Gabriel,25,0,30,5
1731506711303,BENG 140A,A03,734146,Silva; Gabriel,25,0,30,5
1731506712333,BENG 147B,A00,734149,Taylor Amos; Alyssa C,28,0,30,2
1731506713358,BENG 148B,A00,734154,Taylor Amos; Alyssa C,25,0,30,5
1731506714383,BENG 149B,A00,734172,Taylor Amos; Alyssa C,30,0,30,0
1731506715421,BENG 152,A01,734185,Taylor Amos; Alyssa C,19,0,20,1
1731506716449,BENG 161B,A00,734193,Huang; Xiaohua,55,0,70,15
1731506717484,BENG 168,A01,734228,Shi; Lingyan,22,0,40,18
1731506717484,BENG 168,A02,734229,Shi; Lingyan,39,0,40,1
1731506717484,BENG 168,A03,734231,Shi; Lingyan,37,0,40,3
1731506718522,BENG 169B,A00,734233,Taylor Amos; Alyssa C,24,0,30,6
1731506719547,BENG 179B,A00,734243,Taylor Amos; Alyssa C,28,0,30,2
1731506720574,BENG 181,A01,734246,Pevzner; Pavel Arkadjevich,37,0,40,3
1731506721601,BENG 186B,A01,734248,Cauwenberghs; Gert,69,0,70,1
1731506722630,BENG 187C,A00,734249,Taylor Amos; Alyssa C,121,0,170,49
1731506723657,BENG 189,A00,734250,Contijoch; Francisco,26,0,30,4
1731506724683,BENG 191,A00,734252,Lal; Ratnesh,15,0,20,5
1731506725719,BENG 202,A00,734255,Pevzner; Pavel Arkadjevich,25,0,25,0
1731506726748,BENG 204,A01,734257,Subramaniam; Shankar,0,0,50,50
1731506727773,BENG 207,A00,734258,Friend; James Robert,0,0,0,0
1731506728801,BENG 212,A00,734259,Palsson; Bernhard O.,0,0,20,20
1731506729828,BENG 223,A00,734260,Kravets; Vira V.,0,0,60,60
1731506730855,BENG 225,A01,734263,Bartko; Andrew Peter,0,0,0,0
1731506731886,BENG 230B,A00,734289,Engler; Adam J.,38,0,120,82
1731506732923,BENG 238,A00,734290,Chen; Ju & Sun; Wei & Shyy; Yeun-Jund & Sheikh; Farah & Ross; Robert Scott & King; Kevin R & Evans; Sylvia M & Cho; Yoshitake,0,0,40,40
1731506733949,BENG 241A,A01,734314,Cyphert; Erika Leah,0,0,50,50
1731506735001,BENG 241B,A00,734333,Khojah; Reem I,35,0,70,35
1731506736028,BENG 247B,A00,734334,Wang; Joseph,0,0,40,40
1731506737058,BENG 277,A00,734336,Khojah; Reem I,0,0,0,0
1731506738082,BENG 278,A00,734340,Contijoch; Francisco,0,0,0,0
1731506739114,BENG 280B,A00,734351,El Kaffas; Ahmed,20,0,56,36
1731506740149,BENG 281,A00,734352,Aguado; Brian Alberto,25,0,120,95
1731506741174,BENG 291,A00,734356,Lal; Ratnesh,15,0,30,15
1731506742201,BENG 292,A01,734364,Ross; Camille,20,0,20,0
1731506743229,BENG 294B,A01,734430,Schmid-Schoenbein; Geert W,12,0,20,8
1731506744257,BENG 295,A00,734431,Watson; John Thomas,9999,0,9999,0
1731506745284,BGGN 206B,A00,765115,Oegema; Karen & Desai; Arshad,28,0,60,32
1731506746310,BGGN 207,A01,765121,Ross; Camille,0,0,0,0
1731506747337,BGGN 209,A00,765126,Neal; Sonya E,0,0,30,30
1731506748373,BGGN 213,A00,765129,Grant; Barry J,24,0,30,6
1731506749399,BGGN 216,A01,765138,Mueller; Liam O'Connor,0,0,0,24
1731506750430,BGGN 225,A00,765141,Lu; Li-Fan & Zuniga; Elina I,0,0,30,30
1731506751457,BGGN 228,A00,765144,Perry; Michael William & Kiger; Amy,0,0,30,30
1731506752484,BGGN 237,A01,765148,Goren; Alon M,10,0,10,0
1731506753510,BGGN 240,A01,765160,Benna; Marcus K,4,0,5,1
1731506753510,BGGN 240,A02,765210,Benna; Marcus K,1,0,5,4
1731506753510,BGGN 240,A03,765211,Benna; Marcus K,3,0,5,2
1731506753510,BGGN 240,A04,765212,Benna; Marcus K,2,0,5,3
1731506754541,BGGN 246A,A00,765223,Sejnowski; Terrence J,18,0,30,12
1731506755569,BGGN 249B,A00,765226,Abdel-Azim; Eiman,0,0,0,0
1731506756758,BGGN 271,001,798422,Ackerman; Susan,9999,0,9999,0
1731506756758,BGGN 271,002,798586,Akbari; Omar Sultan,9997,0,9999,2
1731506756758,BGGN 271,003,798588,Allen; Nicola J,9998,0,9999,1
1731506756758,BGGN 271,004,798599,Alperin; Mariann,9998,0,9999,1
1731506756758,BGGN 271,005,798600,Antal; Corina Elena,9998,0,9999,1
1731506756758,BGGN 271,006,798612,Bouvet; Michael,9999,0,9999,0
1731506756758,BGGN 271,007,798613,Breen; Ellen C.,9999,0,9999,0
1731506756758,BGGN 271,008,798637,Bui; Jack D,9998,0,9999,1
1731506756758,BGGN 271,009,798666,Burnett; Lindsey,9998,0,9999,1
1731506756758,BGGN 271,010,798745,Caffrey; Conor,9998,0,9999,1
1731506756758,BGGN 271,011,798780,Castle; Michael James,9998,0,9999,1
1731506756758,BGGN 271,012,798781,Chang; John Tzu-yu,9999,0,9999,0
1731506756758,BGGN 271,013,798782,Chen; Xu,9998,0,9999,1
1731506756758,BGGN 271,014,798783,Cheng; Christine Shiang-Ling,9999,0,9999,0
1731506756758,BGGN 271,015,798784,Cheresh; David A.,9998,0,9999,1
1731506756758,BGGN 271,016,798803,Cherqui; Stephanie,9999,0,9999,0
1731506756758,BGGN 271,017,798804,Chu; Hiutung,9998,0,9999,1
1731506756758,BGGN 271,018,798806,Church; Kellie Breen,9999,0,9999,0
1731506756758,BGGN 271,019,798807,Cleland; Elsa Eleanor,9998,0,9999,1
1731506756758,BGGN 271,020,798808,Coufal; Nicole Gabriele,9999,0,9999,0
1731506756758,BGGN 271,021,798809,Croker; Ben Adam,9999,0,9999,0
1731506756758,BGGN 271,022,798810,Crotty Alexander; Laura E,9997,0,9999,2
1731506756758,BGGN 271,023,798811,De Silva; Shermin,9999,0,9999,0
1731506756758,BGGN 271,024,798812,Dhar; Debanjan,9998,0,9999,1
1731506756758,BGGN 271,025,798813,Doherty; Taylor Alan,9997,0,9999,2
1731506756758,BGGN 271,026,798814,Dore; Kim Bohemie,9997,0,9999,2
1731506756758,BGGN 271,027,798815,Dulawa; Stephanie Carole,9999,0,9999,0
1731506756758,BGGN 271,028,798817,Farley; Emma Kristen,9998,0,9999,1
1731506756758,BGGN 271,029,798818,Feldstein; Ariel E,9999,0,9999,0
1731506756758,BGGN 271,030,798819,Feng; Gen-Sheng,9999,0,9999,0
1731506756758,BGGN 271,031,798820,Fisch; Kathleen Marie,9995,0,9999,4
1731506756758,BGGN 271,032,798822,Friedman; Rick Adam,9999,0,9999,0
1731506756758,BGGN 271,033,798823,Furnari; Frank,9999,0,9999,0
1731506756758,BGGN 271,034,798825,George; Olivier,9998,0,9999,1
1731506756758,BGGN 271,035,798826,Ghosh; Pradipta,9998,0,9999,1
1731506756758,BGGN 271,036,798828,Glasgow; Stacey Marie,9998,0,9999,1
1731506756758,BGGN 271,037,798832,Golden; James W,9998,0,9999,1
1731506756758,BGGN 271,038,798833,Golden; Susan S.,9999,0,9999,0
1731506756758,BGGN 271,039,798834,Goren; Alon M,9998,0,9999,1
1731506756758,BGGN 271,040,798835,Guatelli; John C,9998,0,9999,1
1731506756758,BGGN 271,041,798836,Guma; Monica,9998,0,9999,1
1731506756758,BGGN 271,042,798837,Gustafsson; Asa Birgitta,9999,0,9999,0
1731506756758,BGGN 271,043,798838,Hamdoun; Amr,9999,0,9999,0
1731506756758,BGGN 271,044,798839,Hao; Nan,9999,0,9999,0
1731506756758,BGGN 271,045,798841,Hasty; Jeff M,9999,0,9999,0
1731506756758,BGGN 271,046,798842,Ideker; Trey,9999,0,9999,0
1731506756758,BGGN 271,047,798843,Jiang; Qingfei,9998,0,9999,1
1731506756758,BGGN 271,048,798845,Jin; Yishi,9997,0,9999,2
1731506756758,BGGN 271,049,798846,Joshi; Shweta,9999,0,9999,0
1731506756758,BGGN 271,050,798849,Ju; Won-Kyu,9998,0,9999,1
1731506756758,BGGN 271,051,798850,Jun; Suckjoon,9999,0,9999,0
1731506756758,BGGN 271,052,798852,Kaech; Susan Michelle,9997,0,9999,2
1731506756758,BGGN 271,053,798853,Kauffman; Alexander,9997,0,9999,2
1731506756758,BGGN 271,054,798854,Kleinfeld; David,9998,0,9999,1
1731506756758,BGGN 271,055,798855,Koloski; Miranda Jane,9998,0,9999,1
1731506756758,BGGN 271,056,798856,Komiyama; Takaki,9998,0,9999,1
1731506756758,BGGN 271,057,798858,Kronenberg; Mitchell E.,9999,0,9999,0
1731506756758,BGGN 271,058,798859,Kufareva; Irina,9999,0,9999,0
1731506756758,BGGN 271,059,798860,Lee; Yun Sok,9999,0,9999,0
1731506756758,BGGN 271,060,798861,Leutgeb; Stefan,9999,0,9999,0
1731506756758,BGGN 271,061,798862,Li; Willis Xiaowei,9998,0,9999,1
1731506756758,BGGN 271,062,798864,Lim; Byungkook,9999,0,9999,0
1731506756758,BGGN 271,063,798865,Lo; Stanley M.,9999,0,9999,0
1731506756758,BGGN 271,064,798867,Lopez Ramirez; Miguel Alej,9998,0,9999,1
1731506756758,BGGN 271,065,798868,Lu; Pengzhe,9998,0,9999,1
1731506756758,BGGN 271,066,798869,Lyons; Deirdre Colleen,9998,0,9999,1
1731506756758,BGGN 271,067,798870,Lyumkis; Dmitry Evgenievich,9999,0,9999,0
1731506756758,BGGN 271,068,798871,McConville; Patrick James,9998,0,9999,1
1731506756758,BGGN 271,069,798873,McDonnell; Lisa Marie,9999,0,9999,0
1731506756758,BGGN 271,070,798877,Mertens; Jerome Stefan,9999,0,9999,0
1731506756758,BGGN 271,071,798900,Morris; Gerald P,9999,0,9999,0
1731506756758,BGGN 271,072,798911,Muotri; Alysson,9999,0,9999,0
1731506756758,BGGN 271,073,798916,Muroyama; Andrew David,9998,0,9999,1
1731506756758,BGGN 271,074,798919,Murre; Cornelis,9998,0,9999,1
1731506756758,BGGN 271,075,798920,Nieh; James Charles,9997,0,9999,2
1731506756758,BGGN 271,076,798922,Niwa; Maho,9999,0,9999,0
1731506756758,BGGN 271,077,798925,Parast; Mana,9999,0,9999,0
1731506756758,BGGN 271,078,798927,Perry; Michael William,9999,0,9999,0
1731506756758,BGGN 271,079,798929,Pillus; Lorraine,9998,0,9999,1
1731506756758,BGGN 271,080,798932,Pogliano; Joseph,9999,0,9999,0
1731506756758,BGGN 271,081,798936,Pride; David Tevis,9999,0,9999,0
1731506756758,BGGN 271,082,798939,Pruneda-Paz; Jose L.,9998,0,9999,1
1731506756758,BGGN 271,083,798940,Rana; Tariq,9999,0,9999,0
1731506756758,BGGN 271,084,798945,Rao; Anjana,9999,0,9999,0
1731506756758,BGGN 271,085,798950,Raz; Eyal,9997,0,9999,2
1731506756758,BGGN 271,086,798952,Ren; Bing,9999,0,9999,0
1731506756758,BGGN 271,087,798955,Rifkin; Scott,9998,0,9999,1
1731506756758,BGGN 271,088,798956,Risbrough; Victoria Blythe,9998,0,9999,1
1731506756758,BGGN 271,089,798958,Rose; Noah Hartmann,9999,0,9999,0
1731506756758,BGGN 271,090,798962,Rosenfeld; Michael G,9999,0,9999,0
1731506756758,BGGN 271,091,798964,Saier; Milton H.,9998,0,9999,1
1731506756758,BGGN 271,092,798966,Saltiel; Alan,9997,0,9999,2
1731506756758,BGGN 271,093,798967,Sanchez-Lopez; Elsa,9998,0,9999,1
1731506756758,BGGN 271,094,798969,Schroeder; Julian I,9998,0,9999,1
1731506756758,BGGN 271,095,798970,Sebat; Lilia Mikhailovna,9997,0,9999,2
1731506756758,BGGN 271,096,798972,Sen; George L,9999,0,9999,0
1731506756758,BGGN 271,097,798974,Shaner; Nathan C.,9999,0,9999,0
1731506756758,BGGN 271,098,798976,Shurin; Jonathan,9997,0,9999,2
1731506756758,BGGN 271,099,798982,Sicklick; Jason Keith,9999,0,9999,0
1731506756758,BGGN 271,100,798985,Signer; Robert,9999,0,9999,0
1731506756758,BGGN 271,101,798986,Simonson; Tatum Sasha Summ,9998,0,9999,1
1731506756758,BGGN 271,102,798990,Steinmetz; Nicole F,9999,0,9999,0
1731506756758,BGGN 271,103,798992,Su; Chih-Ying,9999,0,9999,0
1731506756758,BGGN 271,104,798994,Suel; Gurol Mehmet,9999,0,9999,0
1731506756758,BGGN 271,105,799024,Telese; Francesca,9999,0,9999,0
1731506756758,BGGN 271,106,799032,Towers; Christina Garlingt,9997,0,9999,2
1731506756758,BGGN 271,107,799089,Valdez-Jasso; Daniela,9999,0,9999,0
1731506756758,BGGN 271,108,799108,Wahlin; Karl Jonas,9997,0,9999,2
1731506756758,BGGN 271,109,799109,Webster; Nicholas J G,9999,0,9999,0
1731506756758,BGGN 271,110,799127,Welsbie; Derek,9999,0,9999,0
1731506756758,BGGN 271,111,799128,Wildonger; Jill Cathleen,9997,0,9999,2
1731506756758,BGGN 271,112,799129,Yaksh; Tony L.,9999,0,9999,0
1731506756758,BGGN 271,113,799150,Yeo; Eugene Wei-Ming,9998,0,9999,1
1731506756758,BGGN 271,114,799151,Ying; Wei,9997,0,9999,2
1731506756758,BGGN 271,115,799152,Young; Jared W.,9999,0,9999,0
1731506756758,BGGN 271,116,799153,Zage; Peter,9999,0,9999,0
1731506756758,BGGN 271,117,799154,Zengler; Karsten B,9998,0,9999,1
1731506756758,BGGN 271,118,799155,Zhang; Jin,9999,0,9999,0
1731506756758,BGGN 271,119,799156,Zhao; Yunde,9999,0,9999,0
1731506756758,BGGN 271,120,799157,Zheng; Ye,9998,0,9999,1
1731506756758,BGGN 271,121,799158,Zhou; Huilin,9999,0,9999,0
1731506756758,BGGN 271,122,799159,Zou; Yimin,9998,0,9999,1
1731506757786,BGGN 275,A00,765242,Flagg; Matthew Paul,0,0,0,12
1731506758814,BGGN 276,A00,765243,Flagg; Matthew Paul,0,0,0,12
1731506759841,BGGN 290,A00,765245,Pasquinelli; Amy & Hampton; Randolph Y.,0,0,0,8
1731506760871,BGGN 293,A00,765250,Tour; Ella,0,0,30,30
1731506760871,BGGN 293,B00,765260,Petrie; Katherine Lynn,0,0,0,12
1731506761903,BGJC 204,A00,765301,Lu; Li-Fan & Chang; John Tzu-yu,9982,0,9999,17
1731506763049,BGRD 200,001,799275,Ackerman; Susan,9999,0,9999,0
1731506763049,BGRD 200,002,799276,Akbari; Omar Sultan,9997,0,9999,2
1731506763049,BGRD 200,003,799277,Allen; Eric,9999,0,9999,0
1731506763049,BGRD 200,004,799278,Allen; Nicola J,9998,0,9999,1
1731506763049,BGRD 200,005,799279,Alperin; Mariann,9998,0,9999,1
1731506763049,BGRD 200,006,799280,Amaro; Rommie E,9999,0,9999,0
1731506763049,BGRD 200,007,799281,Antal; Corina Elena,9998,0,9999,1
1731506763049,BGRD 200,008,799282,Asahina; Kenta,9999,0,9999,0
1731506763049,BGRD 200,009,799283,Augustine; Vineet,9999,0,9999,0
1731506763049,BGRD 200,010,799284,Ayres; Janelle Samantha,9998,0,9999,1
1731506763049,BGRD 200,011,799285,Banghart; Matthew Ryan,9999,0,9999,0
1731506763049,BGRD 200,012,799286,Barton; Andrew David,9999,0,9999,0
1731506763049,BGRD 200,013,799287,Benna; Marcus K,9999,0,9999,0
1731506763049,BGRD 200,014,799288,Bennett; Eric J,9999,0,9999,0
1731506763049,BGRD 200,015,799289,Biering; Scott B,9999,0,9999,0
1731506763049,BGRD 200,016,799290,Bloodgood; Brenda Laurie,9999,0,9999,0
1731506763049,BGRD 200,017,799291,Bouvet; Michael,9999,0,9999,0
1731506763049,BGRD 200,018,799292,Breen; Ellen C.,9999,0,9999,0
1731506763049,BGRD 200,019,799293,Briggs; Steven,9999,0,9999,0
1731506763049,BGRD 200,020,799294,Bui; Jack D,9998,0,9999,1
1731506763049,BGRD 200,021,799295,Burnett; Lindsey,9998,0,9999,1
1731506763049,BGRD 200,022,799296,Caffrey; Conor,9998,0,9999,1
1731506763049,BGRD 200,023,799297,Callaway; Edward M,9999,0,9999,0
1731506763049,BGRD 200,024,799298,Castle; Michael James,9999,0,9999,0
1731506763049,BGRD 200,025,799299,Chaim; Isaac,9999,0,9999,0
1731506763049,BGRD 200,026,799300,Chang; John Tzu-yu,9998,0,9999,1
1731506763049,BGRD 200,027,799301,Chen; Xu,9999,0,9999,0
1731506763049,BGRD 200,028,799302,Cheng; Christine Shiang-Ling,9999,0,9999,0
1731506763049,BGRD 200,029,799303,Cheresh; David A.,9998,0,9999,1
1731506763049,BGRD 200,030,799304,Cherqui; Stephanie,9999,0,9999,0
1731506763049,BGRD 200,031,799305,Chu; Hiutung,9998,0,9999,1
1731506763049,BGRD 200,032,799306,Church; Kellie Breen,9999,0,9999,0
1731506763049,BGRD 200,033,799307,Cleland; Elsa Eleanor,9997,0,9999,2
1731506763049,BGRD 200,034,799308,Cooper; Kimberly Lynn,9999,0,9999,0
1731506763049,BGRD 200,035,799309,Coufal; Nicole Gabriele,9999,0,9999,0
1731506763049,BGRD 200,036,799310,Croker; Ben Adam,9999,0,9999,0
1731506763049,BGRD 200,037,799311,Crotty Alexander; Laura E,9997,0,9999,2
1731506763049,BGRD 200,038,799313,Daugherty; Matthew Dorton,9998,0,9999,1
1731506763049,BGRD 200,039,799314,De Silva; Shermin,9999,0,9999,0
1731506763049,BGRD 200,040,799315,Desai; Arshad,9999,0,9999,0
1731506763049,BGRD 200,041,799316,Dhar; Debanjan,9998,0,9999,1
1731506763049,BGRD 200,042,799317,Dickinson; Alexandra Jazz,9999,0,9999,0
1731506763049,BGRD 200,043,799318,Dixon; Jesse,9998,0,9999,1
1731506763049,BGRD 200,044,799319,Doherty; Taylor Alan,9997,0,9999,2
1731506763049,BGRD 200,045,799320,Dore; Kim Bohemie,9997,0,9999,2
1731506763049,BGRD 200,046,799321,Dulawa; Stephanie Carole,9999,0,9999,0
1731506763049,BGRD 200,047,799323,Ecker; Joseph R,9998,0,9999,1
1731506763049,BGRD 200,048,799324,Engle; Dannielle D,9999,0,9999,0
1731506763049,BGRD 200,049,799325,Ernst; Andreas,9998,0,9999,1
1731506763049,BGRD 200,050,799326,Esko; Jeffrey D.,9999,0,9999,0
1731506763049,BGRD 200,051,799327,Farley; Emma Kristen,9998,0,9999,1
1731506763049,BGRD 200,052,799328,Feldstein; Ariel E,9999,0,9999,0
1731506763049,BGRD 200,053,799329,Feng; Gen-Sheng,9999,0,9999,0
1731506763049,BGRD 200,054,799330,Fisch; Kathleen Marie,9995,0,9999,4
1731506763049,BGRD 200,055,799331,Friedman; Rick Adam,9999,0,9999,0
1731506763049,BGRD 200,056,799332,Furnari; Frank,9999,0,9999,0
1731506763049,BGRD 200,057,799333,Gage; Fred H,9999,0,9999,0
1731506763049,BGRD 200,058,799334,George; Olivier,9998,0,9999,1
1731506763049,BGRD 200,059,799335,Ghosh; Pradipta,9998,0,9999,1
1731506763049,BGRD 200,060,799336,Glasgow; Stacey Marie,9998,0,9999,1
1731506763049,BGRD 200,061,799337,Glass; Christopher,9999,0,9999,0
1731506763049,BGRD 200,062,799338,Golden; James W,9998,0,9999,1
1731506763049,BGRD 200,063,799339,Golden; Susan S.,9999,0,9999,0
1731506763049,BGRD 200,064,799340,Goren; Alon M,9998,0,9999,1
1731506763049,BGRD 200,065,799341,Guatelli; John C,9998,0,9999,1
1731506763049,BGRD 200,066,799342,Guma; Monica,9998,0,9999,1
1731506763049,BGRD 200,067,799343,Gustafsson; Asa Birgitta,9999,0,9999,0
1731506763049,BGRD 200,068,799344,Gutkind; Jorge Silvio,9999,0,9999,0
1731506763049,BGRD 200,069,799345,Hamdoun; Amr,9999,0,9999,0
1731506763049,BGRD 200,070,799346,Hampton; Randolph Y.,9998,0,9999,1
1731506763049,BGRD 200,071,799347,Hao; Nan,9999,0,9999,0
1731506763049,BGRD 200,072,799348,Hargreaves; Diana Clare,9998,0,9999,1
1731506763049,BGRD 200,073,799349,Hasty; Jeff M,9999,0,9999,0
1731506763049,BGRD 200,074,799350,Hollern; Daniel Patrick,9998,0,9999,1
1731506763049,BGRD 200,075,799351,Holway; David A.,9999,0,9999,0
1731506763049,BGRD 200,076,799352,Huffaker; Alisa,9998,0,9999,1
1731506763049,BGRD 200,077,799353,Hui; Enfu,9999,0,9999,0
1731506763049,BGRD 200,078,799354,Hwa; Terence T.,9999,0,9999,0
1731506763049,BGRD 200,079,799355,Ideker; Trey,9999,0,9999,0
1731506763049,BGRD 200,080,799356,Jackrel; Sara,9997,0,9999,2
1731506763049,BGRD 200,081,799357,Jiang; Qingfei,9998,0,9999,1
1731506763049,BGRD 200,082,799358,Jin; Yishi,9997,0,9999,2
1731506763049,BGRD 200,083,799359,Joshi; Shweta,9999,0,9999,0
1731506763049,BGRD 200,084,799360,Ju; Won-Kyu,9998,0,9999,1
1731506763049,BGRD 200,085,799361,Jun; Suckjoon,9999,0,9999,0
1731506763049,BGRD 200,086,799362,Kadonaga; James T,9999,0,9999,0
1731506763049,BGRD 200,087,799363,Kaech; Susan Michelle,9995,0,9999,4
1731506763049,BGRD 200,088,799364,Kauffman; Alexander,9997,0,9999,2
1731506763049,BGRD 200,089,799365,Kleinfeld; David,9999,0,9999,0
1731506763049,BGRD 200,090,799366,Knight; Robin,9999,0,9999,0
1731506763049,BGRD 200,091,799367,Koloski; Miranda Jane,9998,0,9999,1
1731506763049,BGRD 200,092,799368,Komiyama; Takaki,9997,0,9999,2
1731506763049,BGRD 200,093,799369,Kosuri; Pallav,9998,0,9999,1
1731506763049,BGRD 200,094,799370,Kronenberg; Mitchell E.,9999,0,9999,0
1731506763049,BGRD 200,095,799371,Staff,9999,0,9999,0
1731506763049,BGRD 200,096,799372,Kryazhimskiy; Sergey A,9999,0,9999,0
1731506763049,BGRD 200,097,799373,Kufareva; Irina,9999,0,9999,0
1731506763049,BGRD 200,098,799374,Lee; Kuo Fen,9999,0,9999,0
1731506763049,BGRD 200,099,799375,Lee; Yun Sok,9999,0,9999,0
1731506763049,BGRD 200,100,799376,Leutgeb; Jill K.,9999,0,9999,0
1731506763049,BGRD 200,101,799377,Leutgeb; Stefan,9999,0,9999,0
1731506763049,BGRD 200,102,799378,Li; Willis Xiaowei,9998,0,9999,1
1731506763049,BGRD 200,103,799379,Lim; Byungkook,9998,0,9999,1
1731506763049,BGRD 200,104,799380,Lo; Stanley M.,9999,0,9999,0
1731506763049,BGRD 200,105,799381,Looger; Loren Lee,9998,0,9999,1
1731506763049,BGRD 200,106,799382,Lopez Ramirez; Miguel Alej,9998,0,9999,1
1731506763049,BGRD 200,107,799383,Lovett-Barron; Matthew Rod,9997,0,9999,2
1731506763049,BGRD 200,108,799384,Lu; Li-Fan,9998,0,9999,1
1731506763049,BGRD 200,109,799385,Lu; Pengzhe,9998,0,9999,1
1731506763049,BGRD 200,110,799386,Lykke-Andersen; Jens,9998,0,9999,1
1731506763049,BGRD 200,111,799387,Lyons; Deirdre Colleen,9998,0,9999,1
1731506763049,BGRD 200,112,799388,Lyumkis; Dmitry Evgenievich,9998,0,9999,1
1731506763049,BGRD 200,113,799389,Manor; Uri,9999,0,9999,0
1731506763049,BGRD 200,114,799390,Mayfield; Stephen P.,9998,0,9999,1
1731506763049,BGRD 200,115,799391,McConville; Patrick James,9999,0,9999,0
1731506763049,BGRD 200,116,799392,McDonnell; Lisa Marie,9999,0,9999,0
1731506763049,BGRD 200,117,799393,Mertens; Jerome Stefan,9999,0,9999,0
1731506763049,BGRD 200,118,799394,Meyer; Justin Raymond,9999,0,9999,0
1731506763049,BGRD 200,119,799395,Morris; Gerald P,9999,0,9999,0
1731506763049,BGRD 200,120,799396,Mueller; Lena,9998,0,9999,1
1731506763049,BGRD 200,121,799397,Muotri; Alysson,9999,0,9999,0
1731506763049,BGRD 200,122,799398,Muroyama; Andrew David,9995,0,9999,4
1731506763049,BGRD 200,123,799399,Murre; Cornelis,9998,0,9999,1
1731506763049,BGRD 200,124,799400,Reyes De Barboza; Nabora S,9999,0,9999,0
1731506763049,BGRD 200,125,799401,Neal; Sonya E,9998,0,9999,1
1731506763049,BGRD 200,126,799402,Nieh; James Charles,9997,0,9999,2
1731506763049,BGRD 200,127,799403,Nimmerjahn; Axel,9999,0,9999,0
1731506763049,BGRD 200,128,799404,Niwa; Maho,9999,0,9999,0
1731506763049,BGRD 200,129,799405,Nizet; Victor F.,9999,0,9999,0
1731506763049,BGRD 200,130,799406,Oegema; Karen,9999,0,9999,0
1731506763049,BGRD 200,131,799407,Panda; Satchidananda,9998,0,9999,1
1731506763049,BGRD 200,132,799408,Parast; Mana,9999,0,9999,0
1731506763049,BGRD 200,133,799409,Pasquinelli; Amy,9998,0,9999,1
1731506763049,BGRD 200,134,799410,Pekkurnaz Banghart; Gulcin,9999,0,9999,0
1731506763049,BGRD 200,135,799411,Perry; Michael William,9999,0,9999,0
1731506763049,BGRD 200,136,799413,Pillus; Lorraine,9998,0,9999,1
1731506763049,BGRD 200,137,799414,Pogliano; Joseph,9999,0,9999,0
1731506763049,BGRD 200,138,799415,Pogliano; Kit J.,9999,0,9999,0
1731506763049,BGRD 200,139,799416,Pride; David Tevis,9999,0,9999,0
1731506763049,BGRD 200,140,799417,Pruneda-Paz; Jose L.,9998,0,9999,1
1731506763049,BGRD 200,141,799418,Ramanan; Deepshika,9998,0,9999,1
1731506763049,BGRD 200,142,799419,Rana; Tariq,9998,0,9999,1
1731506763049,BGRD 200,143,799420,Rao; Anjana,9999,0,9999,0
1731506763049,BGRD 200,144,799421,Raz; Eyal,9997,0,9999,2
1731506763049,BGRD 200,145,799422,Reck-Peterson; Samara L,9999,0,9999,0
1731506763049,BGRD 200,146,799423,Ren; Bing,9999,0,9999,0
1731506763049,BGRD 200,147,799424,Rennison; Diana,9998,0,9999,1
1731506763049,BGRD 200,148,799425,Rifkin; Scott,9999,0,9999,0
1731506763049,BGRD 200,149,799426,Risbrough; Victoria Blythe,9998,0,9999,1
1731506763049,BGRD 200,150,799427,Rivera; Fabian Chavez,9997,0,9999,2
1731506763049,BGRD 200,151,799428,Rohner; Patrick Thomas,9999,0,9999,0
1731506763049,BGRD 200,152,799429,Rose; Noah Hartmann,9999,0,9999,0
1731506763049,BGRD 200,153,799430,Rosenfeld; Michael G,9999,0,9999,0
1731506763049,BGRD 200,154,799431,Russell; Alistair B,9999,0,9999,0
1731506763049,BGRD 200,155,799432,Saier; Milton H.,9998,0,9999,1
1731506763049,BGRD 200,156,799433,Saltiel; Alan,9997,0,9999,2
1731506763049,BGRD 200,157,799434,Sanchez-Lopez; Elsa,9999,0,9999,0
1731506763049,BGRD 200,158,799435,Saphire; Erica Ollmann,9999,0,9999,0
1731506763049,BGRD 200,159,799436,Schroeder; Julian I,9997,0,9999,2
1731506763049,BGRD 200,160,799437,Sebat; Lilia Mikhailovna,9997,0,9999,2
1731506763049,BGRD 200,161,799438,Sen; George L,9999,0,9999,0
1731506763049,BGRD 200,162,799439,Shah; Sameer B,9999,0,9999,0
1731506763049,BGRD 200,163,799440,Shaner; Nathan C.,9999,0,9999,0
1731506763049,BGRD 200,164,799441,Sharpee; Tatyana,9999,0,9999,0
1731506763049,BGRD 200,165,799442,Shaw; Reuben,9999,0,9999,0
1731506763049,BGRD 200,166,799443,Shurin; Jonathan,9997,0,9999,2
1731506763049,BGRD 200,167,799444,Sicklick; Jason Keith,9999,0,9999,0
1731506763049,BGRD 200,168,799445,Signer; Robert,9999,0,9999,0
1731506763049,BGRD 200,169,799446,Simonson; Tatum Sasha Summ,9998,0,9999,1
1731506763049,BGRD 200,170,799447,Soncin; Francesca,9999,0,9999,0
1731506763049,BGRD 200,171,799448,Steinmetz; Nicole F,9999,0,9999,0
1731506763049,BGRD 200,172,799449,Su; Chih-Ying,9998,0,9999,1
1731506763049,BGRD 200,173,799450,Suel; Gurol Mehmet,9997,0,9999,2
1731506763049,BGRD 200,174,799451,Sun; Xin,9998,0,9999,1
1731506763049,BGRD 200,175,799452,Telese; Francesca,9998,0,9999,1
1731506763049,BGRD 200,176,799453,Towers; Christina Garlingt,9995,0,9999,4
1731506763049,BGRD 200,177,799454,Traver; David,9999,0,9999,0
1731506763049,BGRD 200,178,799455,Troemel; Emily Ruth,9998,0,9999,1
1731506763049,BGRD 200,179,799456,Valdez-Jasso; Daniela,9999,0,9999,0
1731506763049,BGRD 200,180,799457,Vijayanand; Pandurangan,9999,0,9999,0
1731506763049,BGRD 200,181,799458,Villa Rodriguez; Elizabeth,9999,0,9999,0
1731506763049,BGRD 200,182,799459,Wahlin; Karl Jonas,9997,0,9999,2
1731506763049,BGRD 200,183,799460,Wang; Jean Yin Jen,9999,0,9999,0
1731506763049,BGRD 200,184,799461,Webster; Nicholas J G,9999,0,9999,0
1731506763049,BGRD 200,185,799462,Welsbie; Derek,9999,0,9999,0
1731506763049,BGRD 200,186,799463,Wildonger; Jill Cathleen,9996,0,9999,3
1731506763049,BGRD 200,187,799464,Winzeler; Elizabeth A,9999,0,9999,0
1731506763049,BGRD 200,188,799465,Yaksh; Tony L.,9999,0,9999,0
1731506763049,BGRD 200,189,799466,Yelon; Deborah,9997,0,9999,2
1731506763049,BGRD 200,190,799467,Yeo; Eugene Wei-Ming,9998,0,9999,1
1731506763049,BGRD 200,191,799468,Ying; Wei,9997,0,9999,2
1731506763049,BGRD 200,192,799469,Young; Jared W.,9999,0,9999,0
1731506763049,BGRD 200,193,799470,Zage; Peter,9999,0,9999,0
1731506763049,BGRD 200,194,799471,Zengler; Karsten B,9997,0,9999,2
1731506763049,BGRD 200,195,799472,Zhang; Dong-Er,9999,0,9999,0
1731506763049,BGRD 200,196,799473,Zhang; Jin,9999,0,9999,0
1731506763049,BGRD 200,197,799474,Zhao; Yunde,9999,0,9999,0
1731506763049,BGRD 200,198,799475,Zheng; Binhai,9999,0,9999,0
1731506763049,BGRD 200,199,799476,Zheng; Ye,9998,0,9999,1
1731506763049,BGRD 200,200,799477,Zhou; Huilin,9999,0,9999,0
1731506763049,BGRD 200,201,799478,Zou; Yimin,9998,0,9999,1
1731506763049,BGRD 200,202,799479,Zuniga; Elina I,9998,0,9999,1
1731506764076,BGSE 200,A00,765304,Tour; Ella & Petrie; Katherine Lynn,9987,0,9999,12
1731506765103,BGSE 205,A00,765321,Bennett; Eric J,43,0,50,7
1731506765103,BGSE 205,B00,765322,Bennett; Eric J,46,0,50,4
1731506765103,BGSE 205,C00,765369,Bennett; Eric J,36,0,50,14
1731506765103,BGSE 205,D00,765470,Bennett; Eric J,40,0,50,10
1731506765103,BGSE 205,E00,765471,Bennett; Eric J,45,0,50,5
1731506766131,BIBC 100,A01,786720,Hui; Enfu,70,0,73,3
1731506766131,BIBC 100,A02,786721,Hui; Enfu,64,0,73,9
1731506766131,BIBC 100,A03,786723,Hui; Enfu,67,0,73,6
1731506766131,BIBC 100,A04,786775,Hui; Enfu,67,0,73,6
1731506767158,BIBC 102,A01,786782,Feng; Gen-Sheng,72,0,73,1
1731506767158,BIBC 102,A02,786783,Feng; Gen-Sheng,71,0,73,2
1731506767158,BIBC 102,A03,786784,Feng; Gen-Sheng,73,0,73,0
1731506767158,BIBC 102,A04,786790,Feng; Gen-Sheng,73,0,73,0
1731506767158,BIBC 102,B01,786791,Dickinson; Alexandra Jazz,61,0,73,12
1731506767158,BIBC 102,B02,786792,Dickinson; Alexandra Jazz,64,0,73,9
1731506767158,BIBC 102,B03,786845,Dickinson; Alexandra Jazz,68,0,73,5
1731506767158,BIBC 102,B04,786859,Dickinson; Alexandra Jazz,50,0,73,23
1731506768186,BIBC 103,A01,757720,Coleman; Aaron B.,21,0,24,3
1731506768186,BIBC 103,A02,757773,Coleman; Aaron B.,22,0,24,2
1731506768186,BIBC 103,B01,757783,Coleman; Aaron B.,18,0,24,6
1731506768186,BIBC 103,B02,757784,Coleman; Aaron B.,21,0,24,3
1731506768186,BIBC 103,C01,758001,Burg; Michael,17,0,24,7
1731506768186,BIBC 103,C02,758019,Burg; Michael,24,0,24,0
1731506769213,BIBC 120,A01,758029,Hampton; Randolph Y.,61,0,87,26
1731506769213,BIBC 120,A02,758032,Hampton; Randolph Y.,65,0,87,22
1731506769213,BIBC 120,A03,758038,Hampton; Randolph Y.,77,0,87,10
1731506769213,BIBC 120,A04,758119,Hampton; Randolph Y.,74,0,87,13
1731506770243,BIBC 194,A00,758136,Hui; Enfu,25,0,32,7
1731506770243,BIBC 194,B00,758137,Niwa; Maho,25,0,32,7
1731506770243,BIBC 194,C00,758138,Corbett; Kevin Daniel,25,0,32,7
1731506771289,BICD 100,A01,786869,Troemel; Emily Ruth,72,0,73,1
1731506771289,BICD 100,A02,786870,Troemel; Emily Ruth,73,0,73,0
1731506771289,BICD 100,A03,786871,Troemel; Emily Ruth,73,0,73,0
1731506771289,BICD 100,A04,786872,Troemel; Emily Ruth,73,0,73,0
1731506771289,BICD 100,B01,786873,Grossman; Emily N,66,0,73,7
1731506771289,BICD 100,B02,786874,Grossman; Emily N,66,0,73,7
1731506771289,BICD 100,B03,786875,Grossman; Emily N,71,0,73,2
1731506771289,BICD 100,B04,786876,Grossman; Emily N,70,0,73,3
1731506771289,BICD 100,C01,786877,Grossman; Emily N,64,0,73,9
1731506771289,BICD 100,C02,786878,Grossman; Emily N,71,0,73,2
1731506771289,BICD 100,C03,786879,Grossman; Emily N,70,0,73,3
1731506771289,BICD 100,C04,786880,Grossman; Emily N,71,0,73,2
1731506772326,BICD 110,A01,758191,Chaim; Isaac,54,0,63,9
1731506772326,BICD 110,A02,758193,Chaim; Isaac,42,0,63,21
1731506772326,BICD 110,A03,758194,Chaim; Isaac,61,0,63,2
1731506772326,BICD 110,A04,758196,Chaim; Isaac,56,0,61,5
1731506772326,BICD 110,B01,758200,Manor; Uri,60,0,63,3
1731506772326,BICD 110,B02,758201,Manor; Uri,63,0,63,0
1731506772326,BICD 110,B03,758202,Manor; Uri,55,0,63,8
1731506772326,BICD 110,B04,758204,Manor; Uri,56,0,61,5
1731506773355,BICD 120,A01,758206,Estelle; Mark,20,0,23,3
1731506773355,BICD 120,A02,758208,Estelle; Mark,22,0,23,1
1731506773355,BICD 120,A03,758209,Estelle; Mark,23,0,23,0
1731506773355,BICD 120,A04,758214,Estelle; Mark,17,0,21,4
1731506774386,BICD 194,A00,758215,Hueschen; Christina Lynn,29,0,32,3
1731506775415,BIEB 102,A01,758218,Jackrel; Sara,46,0,48,2
1731506775415,BIEB 102,A02,758219,Jackrel; Sara,47,0,48,1
1731506775415,BIEB 102,A03,758220,Jackrel; Sara,48,0,48,0
1731506775415,BIEB 102,A04,758222,Jackrel; Sara,48,0,48,0
1731506776510,BIEB 121,A00,758224,Butler; Shannon Rhey,8,0,32,24
1731506776510,BIEB 121,B00,758225,Butler; Shannon Rhey,20,0,32,12
1731506777537,BIEB 134,A01,758227,Barton; Andrew David,10,0,11,1
1731506777537,BIEB 134,A02,758230,Barton; Andrew David,11,0,11,0
1731506777537,BIEB 134,A03,758231,Barton; Andrew David,9,0,11,2
1731506777537,BIEB 134,A04,758232,Barton; Andrew David,11,0,11,0
1731506777537,BIEB 134,A05,758233,Barton; Andrew David,7,0,11,4
1731506777537,BIEB 134,A06,758236,Barton; Andrew David,9,0,10,1
1731506777537,BIEB 134,A07,758237,Barton; Andrew David,10,0,10,0
1731506777537,BIEB 134,A08,758239,Barton; Andrew David,10,0,10,0
1731506778570,BIEB 135,A01,758241,Shurin; Jonathan,20,0,36,16
1731506779598,BIEB 140,A01,758243,Roy; Kaustuv,35,0,40,5
1731506779598,BIEB 140,A02,758248,Roy; Kaustuv,36,0,40,4
1731506779598,BIEB 140,A03,758250,Roy; Kaustuv,35,0,40,5
1731506779598,BIEB 140,A04,758251,Roy; Kaustuv,32,0,40,8
1731506780626,BIEB 152,A01,758255,Wodarz; Dominik Franz Xave,57,0,63,6
1731506780626,BIEB 152,A02,758256,Wodarz; Dominik Franz Xave,62,0,63,1
1731506780626,BIEB 152,A03,758257,Wodarz; Dominik Franz Xave,54,0,63,9
1731506780626,BIEB 152,A04,758260,Wodarz; Dominik Franz Xave,50,0,61,11
1731506781657,BIEB 156,A01,758262,Rose; Noah Hartmann & Rennison; Diana,26,0,29,3
1731506781657,BIEB 156,A02,758267,Rose; Noah Hartmann & Rennison; Diana,26,0,29,3
1731506781657,BIEB 156,A03,758269,Rose; Noah Hartmann & Rennison; Diana,29,0,29,0
1731506781657,BIEB 156,A04,758272,Rose; Noah Hartmann & Rennison; Diana,28,0,28,0
1731506782691,BILD 1,A01,786580,Ochoa Mikrut; Stacy Daniel,93,0,100,7
1731506782691,BILD 1,A02,786585,Ochoa Mikrut; Stacy Daniel,100,0,100,0
1731506782691,BILD 1,A03,786589,Ochoa Mikrut; Stacy Daniel,98,0,100,2
1731506782691,BILD 1,A04,786591,Ochoa Mikrut; Stacy Daniel,96,0,100,4
1731506782691,BILD 1,B01,786593,Madigan; Cressida Ariana,85,0,100,15
1731506782691,BILD 1,B02,786612,Madigan; Cressida Ariana,73,0,100,27
1731506782691,BILD 1,B03,786613,Madigan; Cressida Ariana,93,0,100,7
1731506782691,BILD 1,B04,786614,Madigan; Cressida Ariana,97,0,100,3
1731506782691,BILD 1,C01,786630,Cooper; Andrew Michael,97,0,100,3
1731506782691,BILD 1,C02,786631,Cooper; Andrew Michael,99,0,100,1
1731506782691,BILD 1,C03,786669,Cooper; Andrew Michael,100,0,100,0
1731506782691,BILD 1,C04,786704,Cooper; Andrew Michael,99,0,100,1
1731506783721,BILD 2,A01,786707,Owens; Melinda Tsao-Ying,64,0,65,1
1731506783721,BILD 2,A02,786708,Owens; Melinda Tsao-Ying,58,0,60,2
1731506783721,BILD 2,A03,786709,Owens; Melinda Tsao-Ying,57,0,60,3
1731506783721,BILD 2,A04,786710,Owens; Melinda Tsao-Ying,60,0,60,0
1731506783721,BILD 2,B01,786920,Owens; Melinda Tsao-Ying,59,0,60,1
1731506783721,BILD 2,B02,786975,Owens; Melinda Tsao-Ying,60,0,60,0
1731506783721,BILD 2,B03,786976,Owens; Melinda Tsao-Ying,64,0,65,1
1731506783721,BILD 2,B04,786979,Owens; Melinda Tsao-Ying,64,0,65,1
1731506783721,BILD 2,C01,786980,Su; Chih-Ying,61,0,63,2
1731506783721,BILD 2,C02,786981,Su; Chih-Ying,58,0,63,5
1731506783721,BILD 2,C03,786983,Su; Chih-Ying,60,0,63,3
1731506783721,BILD 2,C04,786985,Su; Chih-Ying,61,0,61,0
1731506784749,BILD 3,A01,786711,Hammond; LaTisha Marie,49,0,60,11
1731506784749,BILD 3,A02,786712,Hammond; LaTisha Marie,44,0,60,16
1731506784749,BILD 3,A03,786713,Hammond; LaTisha Marie,59,0,60,1
1731506784749,BILD 3,A04,786714,Hammond; LaTisha Marie,54,0,60,6
1731506784749,BILD 3,B01,786715,Hammond; LaTisha Marie,58,0,60,2
1731506784749,BILD 3,B02,786716,Hammond; LaTisha Marie,60,0,60,0
1731506784749,BILD 3,B03,786717,Hammond; LaTisha Marie,55,0,60,5
1731506784749,BILD 3,B04,786719,Hammond; LaTisha Marie,59,0,60,1
1731506784749,BILD 3,D01,786997,Pirino; Giorgia,58,0,60,2
1731506784749,BILD 3,D02,786998,Pirino; Giorgia,58,0,60,2
1731506784749,BILD 3,D03,786999,Pirino; Giorgia,58,0,60,2
1731506784749,BILD 3,D04,787001,Pirino; Giorgia,60,0,60,0
1731506785791,BILD 4,A01,757384,Gonzalez Gamboa; Ivonne,20,0,24,4
1731506785791,BILD 4,A02,757387,Gonzalez Gamboa; Ivonne,22,0,24,2
1731506785791,BILD 4,A03,757388,Gonzalez Gamboa; Ivonne,24,0,24,0
1731506785791,BILD 4,A04,757396,Gonzalez Gamboa; Ivonne,24,0,24,0
1731506785791,BILD 4,A05,757397,Gonzalez Gamboa; Ivonne,22,0,24,2
1731506785791,BILD 4,A06,757399,Gonzalez Gamboa; Ivonne,24,0,24,0
1731506785791,BILD 4,A07,757403,Gonzalez Gamboa; Ivonne,23,0,24,1
1731506785791,BILD 4,A08,757404,Gonzalez Gamboa; Ivonne,22,0,24,2
1731506785791,BILD 4,B01,757410,Gonzalez Gamboa; Ivonne,15,0,24,9
1731506785791,BILD 4,B02,757413,Gonzalez Gamboa; Ivonne,21,0,24,3
1731506785791,BILD 4,B03,757416,Gonzalez Gamboa; Ivonne,23,0,24,1
1731506785791,BILD 4,B04,757417,Gonzalez Gamboa; Ivonne,23,0,24,1
1731506785791,BILD 4,B05,757419,Gonzalez Gamboa; Ivonne,23,0,24,1
1731506785791,BILD 4,B06,757421,Gonzalez Gamboa; Ivonne,23,0,24,1
1731506785791,BILD 4,B07,757423,Gonzalez Gamboa; Ivonne,23,0,24,1
1731506785791,BILD 4,B08,757434,Gonzalez Gamboa; Ivonne,23,0,24,1
1731506785791,BILD 4,C01,757437,Ochoa Mikrut; Stacy Daniel,22,0,24,2
1731506785791,BILD 4,C02,757439,Ochoa Mikrut; Stacy Daniel,23,0,24,1
1731506785791,BILD 4,C03,757440,Ochoa Mikrut; Stacy Daniel,24,0,24,0
1731506785791,BILD 4,C04,757495,Ochoa Mikrut; Stacy Daniel,23,0,24,1
1731506785791,BILD 4,C05,757496,Ochoa Mikrut; Stacy Daniel,24,0,24,0
1731506785791,BILD 4,C06,757497,Ochoa Mikrut; Stacy Daniel,24,0,24,0
1731506785791,BILD 4,C07,757498,Ochoa Mikrut; Stacy Daniel,24,0,24,0
1731506785791,BILD 4,C08,757499,Ochoa Mikrut; Stacy Daniel,24,0,24,0
1731506785791,BILD 4,D01,757501,Lo; Stanley M.,14,0,24,10
1731506785791,BILD 4,D02,757502,Lo; Stanley M.,22,0,24,2
1731506785791,BILD 4,D03,757503,Lo; Stanley M.,24,0,24,0
1731506785791,BILD 4,D04,757504,Lo; Stanley M.,22,0,24,2
1731506785791,BILD 4,D05,757505,Lo; Stanley M.,22,0,24,2
1731506785791,BILD 4,D06,757506,Lo; Stanley M.,22,0,24,2
1731506785791,BILD 4,D07,757507,Lo; Stanley M.,24,0,24,0
1731506785791,BILD 4,D08,757508,Lo; Stanley M.,22,0,24,2
1731506786823,BILD 5,A01,786885,Mueller; Liam O'Connor,60,0,65,5
1731506786823,BILD 5,A02,786886,Mueller; Liam O'Connor,58,0,65,7
1731506786823,BILD 5,A03,786887,Mueller; Liam O'Connor,64,0,65,1
1731506786823,BILD 5,A04,786888,Mueller; Liam O'Connor,64,0,65,1
1731506786823,BILD 5,B01,786889,Reuther; Keefe,65,0,65,0
1731506786823,BILD 5,B02,786890,Reuther; Keefe,60,0,65,5
1731506786823,BILD 5,B03,786891,Reuther; Keefe,64,0,65,1
1731506786823,BILD 5,B04,786892,Reuther; Keefe,65,0,65,0
1731506787848,BILD 12,A01,757527,Komiyama; Takaki,24,0,24,0
1731506787848,BILD 12,A02,757530,Komiyama; Takaki,24,0,24,0
1731506787848,BILD 12,A03,757531,Komiyama; Takaki,21,0,24,3
1731506787848,BILD 12,A04,757532,Komiyama; Takaki,24,0,24,0
1731506788876,BILD 22,A01,757534,Strause; Linda G.,69,0,75,6
1731506788876,BILD 22,A02,757535,Strause; Linda G.,70,0,75,5
1731506788876,BILD 22,A03,757544,Strause; Linda G.,75,0,75,0
1731506788876,BILD 22,A04,757547,Strause; Linda G.,74,0,75,1
1731506789902,BILD 28,A01,757549,Idoyaga; Juliana,30,0,30,0
1731506789902,BILD 28,A02,757550,Idoyaga; Juliana,30,0,30,0
1731506789902,BILD 28,A03,757551,Idoyaga; Juliana,30,0,30,0
1731506789902,BILD 28,A04,757552,Idoyaga; Juliana,30,0,30,0
1731506790933,BILD 60,A01,757569,Meharena; Hiruy Sibhatu,16,0,16,0
1731506790933,BILD 60,A02,757570,Meharena; Hiruy Sibhatu,16,0,16,0
1731506790933,BILD 60,A03,757571,Meharena; Hiruy Sibhatu,16,0,16,0
1731506790933,BILD 60,A04,757572,Meharena; Hiruy Sibhatu,16,0,16,0
1731506791967,BILD 62,A01,757574,Juavinett; Ashley Lauren,22,0,24,2
1731506791967,BILD 62,A02,757575,Juavinett; Ashley Lauren,23,0,24,1
1731506791967,BILD 62,A03,757576,Juavinett; Ashley Lauren,21,0,24,3
1731506791967,BILD 62,A04,757712,Juavinett; Ashley Lauren,22,0,24,2
1731506792998,BILD 87,A00,757714,Saier; Milton H.,20,0,20,0
1731506792998,BILD 87,B00,757715,Saier; Milton H.,19,0,20,1
1731506794027,BIMM 100,A01,785694,Cook-Andersen; Heidi Leigh,46,0,48,2
1731506794027,BIMM 100,A02,785696,Cook-Andersen; Heidi Leigh,48,0,48,0
1731506794027,BIMM 100,A03,785706,Cook-Andersen; Heidi Leigh,42,0,48,6
1731506794027,BIMM 100,A04,785714,Cook-Andersen; Heidi Leigh,48,0,48,0
1731506794027,BIMM 100,B01,785715,Akbari; Omar Sultan,45,0,48,3
1731506794027,BIMM 100,B02,785716,Akbari; Omar Sultan,39,0,48,9
1731506794027,BIMM 100,B03,785717,Akbari; Omar Sultan,46,0,48,2
1731506794027,BIMM 100,B04,785718,Akbari; Omar Sultan,46,0,48,2
1731506795068,BIMM 101,A01,758279,Meaders; Clara Leigh,0,0,24,24
1731506795068,BIMM 101,A02,758280,Meaders; Clara Leigh,0,0,24,24
1731506795068,BIMM 101,B01,758282,Tour; Ella,8,0,24,16
1731506795068,BIMM 101,B02,758283,Tour; Ella,14,0,24,10
1731506795068,BIMM 101,C01,758285,Day; Christopher D,19,0,24,5
1731506795068,BIMM 101,C02,758286,Day; Christopher D,22,0,24,2
1731506795068,BIMM 101,D01,758293,Cooper; Andrew Michael,19,0,24,5
1731506795068,BIMM 101,D02,758323,Cooper; Andrew Michael,20,0,24,4
1731506795068,BIMM 101,E01,758342,Rusert; Jessica Marie,21,0,24,3
1731506795068,BIMM 101,E02,758343,Rusert; Jessica Marie,24,0,24,0
1731506795068,BIMM 101,F01,758345,Rusert; Jessica Marie,23,0,24,1
1731506795068,BIMM 101,F02,758346,Rusert; Jessica Marie,24,0,24,0
1731506796094,BIMM 112,A01,758422,Kadonaga; James T,38,0,40,2
1731506796094,BIMM 112,A02,758427,Kadonaga; James T,33,0,40,7
1731506796094,BIMM 112,A03,758428,Kadonaga; James T,35,0,40,5
1731506796094,BIMM 112,A04,758429,Kadonaga; James T,39,0,40,1
1731506797120,BIMM 114,A01,758433,Daugherty; Matthew Dorton,39,0,48,9
1731506797120,BIMM 114,A02,758434,Daugherty; Matthew Dorton,46,0,48,2
1731506797120,BIMM 114,A03,758441,Daugherty; Matthew Dorton,45,0,48,3
1731506797120,BIMM 114,A04,758449,Daugherty; Matthew Dorton,42,0,48,6
1731506798147,BIMM 121,A01,758694,Gustafson-Brown; Cindy,13,0,24,11
1731506798147,BIMM 121,A02,758695,Gustafson-Brown; Cindy,20,0,24,4
1731506798147,BIMM 121,B01,758854,Gustafson-Brown; Cindy,18,0,24,6
1731506798147,BIMM 121,B02,758855,Gustafson-Brown; Cindy,19,0,24,5
1731506798147,BIMM 121,C01,758859,Pirino; Giorgia,4,0,24,20
1731506798147,BIMM 121,C02,758860,Pirino; Giorgia,11,0,24,13
1731506799181,BIMM 134,A01,758866,Burg; Michael,76,0,103,27
1731506799181,BIMM 134,A02,758867,Burg; Michael,102,0,103,1
1731506799181,BIMM 134,A03,758868,Burg; Michael,84,0,103,19
1731506799181,BIMM 134,A04,758870,Burg; Michael,97,0,101,4
1731506800212,BIMM 143,A01,758872,Grant; Barry J,12,0,40,28
1731506800212,BIMM 143,B01,759109,Bozinovic; Goran,30,0,40,10
1731506801237,BIMM 143R,A01,759111,Bozinovic; Goran,23,0,40,17
1731506802266,BIMM 172,A01,759115,Briggs; Steven,10,0,15,5
1731506802266,BIMM 172,A02,759116,Briggs; Steven,11,0,15,4
1731506802266,BIMM 172,A03,759117,Briggs; Steven,5,0,15,10
1731506802266,BIMM 172,A04,759119,Briggs; Steven,10,0,15,5
1731506803292,BIMM 181,A01,759121,Pevzner; Pavel Arkadjevich,31,0,60,29
1731506804321,BIMM 194,A00,759122,Akbari; Omar Sultan,31,0,32,1
1731506804321,BIMM 194,B00,759123,Lykke-Andersen; Jens,11,0,32,21
1731506804321,BIMM 194,C00,759125,Hasty; Jeff M,29,0,32,3
1731506805349,BIOM 200C,A00,734458,Benner; Christopher William,2,0,28,26
1731506806379,BIOM 202,A01,734460,Corbett; Kevin Daniel,23,0,35,12
1731506807404,BIOM 203B,A00,800936,Gustafsson; Asa Birgitta,35,0,35,0
1731506808429,BIOM 218,A00,734462,Gagneux; Pascal,12,0,12,0
1731506809465,BIOM 246,A00,796600,Gordts; Philip & Lewis; Amanda Lark & Godula; Kamil & Gagneux; Pascal & Esko; Jeffrey D. & Bode; Lars,0,0,0,0
1731506810492,BIOM 253,A00,734463,Nizet; Victor F.,7,0,15,8
1731506811523,BIOM 255,A00,734466,Joiner; William J.,0,0,0,0
1731506812552,BIOM 256,A00,734467,Yang; Jing,0,0,0,0
1731506813580,BIOM 262,A01,734469,Goren; Alon M,19,0,20,1
1731506814611,BIOM 275,A01,734471,Antal; Corina Elena & Obara; Christopher & Mendiola; Andrew & Gonzalez; David J,1,0,28,27
1731506815639,BIOM 277,A01,797835,Klemke; Richard,0,0,0,0
1731506816667,BIOM 287,A00,734472,Khojah; Reem I,0,0,0,0
1731506817693,BIOM 295,A00,734474,Joiner; William J.,0,0,0,0
1731506818723,BIPN 100,A01,787002,Maita; Isabella Vincenza,57,0,61,4
1731506818723,BIPN 100,A02,787005,Maita; Isabella Vincenza,58,0,61,3
1731506818723,BIPN 100,A03,787008,Maita; Isabella Vincenza,58,0,61,3
1731506818723,BIPN 100,A04,787009,Maita; Isabella Vincenza,60,0,62,2
1731506818723,BIPN 100,B01,786881,Reyes Gonzalez; Catalina,61,0,61,0
1731506818723,BIPN 100,B02,786882,Reyes Gonzalez; Catalina,60,0,61,1
1731506818723,BIPN 100,B03,786883,Reyes Gonzalez; Catalina,55,0,61,6
1731506818723,BIPN 100,B04,786884,Reyes Gonzalez; Catalina,55,0,62,7
1731506818723,BIPN 100,C01,787011,Marino; Marc J,53,0,61,8
1731506818723,BIPN 100,C02,787013,Marino; Marc J,56,0,61,5
1731506818723,BIPN 100,C03,787014,Marino; Marc J,59,0,61,2
1731506818723,BIPN 100,C04,787015,Marino; Marc J,53,0,62,9
1731506818723,BIPN 100,D01,794575,Yang; Mingyu,35,0,36,1
1731506818723,BIPN 100,D02,794600,Yang; Mingyu,35,0,36,1
1731506818723,BIPN 100,D03,794576,Yang; Mingyu,35,0,36,1
1731506818723,BIPN 100,D04,794601,Yang; Mingyu,37,0,37,0
1731506819749,BIPN 102,A01,759131,Reyes Gonzalez; Catalina,36,0,61,25
1731506819749,BIPN 102,A02,759133,Reyes Gonzalez; Catalina,56,0,61,5
1731506819749,BIPN 102,A03,759134,Reyes Gonzalez; Catalina,56,0,61,5
1731506819749,BIPN 102,A04,759135,Reyes Gonzalez; Catalina,59,0,62,3
1731506820777,BIPN 105,A01,759139,Armour; Jon Christopher,4,0,21,17
1731506820777,BIPN 105,A02,759140,Armour; Jon Christopher,15,0,21,6
1731506820777,BIPN 105,B01,759144,Armour; Jon Christopher,14,0,21,7
1731506820777,BIPN 105,B02,759147,Armour; Jon Christopher,21,0,21,0
1731506821803,BIPN 140,A01,759149,Lovett-Barron; Matthew Rod,31,0,40,9
1731506821803,BIPN 140,A02,759150,Lovett-Barron; Matthew Rod,40,0,40,0
1731506821803,BIPN 140,A03,759152,Lovett-Barron; Matthew Rod,38,0,40,2
1731506821803,BIPN 140,A04,759154,Lovett-Barron; Matthew Rod,37,0,38,1
1731506822851,BIPN 145,A01,759171,Juavinett; Ashley Lauren,34,0,42,8
1731506822851,BIPN 145,B01,759173,Maita; Isabella Vincenza,40,0,42,2
1731506822851,BIPN 145,C01,759176,Marino; Marc J,30,0,42,12
1731506823880,BIPN 154,A01,759178,Lim; Byungkook,26,0,30,4
1731506823880,BIPN 154,A02,759179,Lim; Byungkook,28,0,30,2
1731506823880,BIPN 154,A03,759180,Lim; Byungkook,28,0,30,2
1731506823880,BIPN 154,A04,759181,Lim; Byungkook,26,0,31,5
1731506824912,BIPN 160,A01,759183,Root; Cory Matthew,45,0,62,17
1731506824912,BIPN 160,A02,759186,Root; Cory Matthew,58,0,62,4
1731506824912,BIPN 160,A03,759187,Root; Cory Matthew,61,0,62,1
1731506824912,BIPN 160,A04,759188,Root; Cory Matthew,51,0,61,10
1731506825941,BIPN 162,A01,759190,Benna; Marcus K,4,0,7,3
1731506825941,BIPN 162,A02,759191,Benna; Marcus K,2,0,7,5
1731506825941,BIPN 162,A03,759192,Benna; Marcus K,4,0,7,3
1731506825941,BIPN 162,A04,759194,Benna; Marcus K,8,0,9,1
1731506826968,BIPN 194,A00,759195,Ackerman; Susan,31,0,32,1
1731506826968,BIPN 194,B00,759196,Leutgeb; Jill K.,14,0,32,18
1731506826968,BIPN 194,C00,759197,Banghart; Matthew Ryan,28,0,32,4
1731506826968,BIPN 194,E00,759201,Meharena; Hiruy Sibhatu,32,0,32,0
1731506827994,BISP 193,001,795783,Maita; Isabella Vincenza,9999,0,9999,0
1731506829020,BISP 194,A00,759202,Newsam; John,14,0,32,18
1731506829020,BISP 194,B00,759203,Cooper; Kimberly Lynn,20,0,32,12
1731506830051,BNFO 262,A01,734447,Goren; Alon M,4,0,5,1
1731506831082,BNFO 281,A00,734448,Gaasterland; Theresa,74,0,100,26
1731506832116,BNFO 283,A00,734456,Fisch; Kathleen Marie & Sahoo; Debashis,7,0,23,16
1731506832116,BNFO 283,B00,734457,Abagyan; Ruben & Bansal; Vikas,11,0,23,12
1731506833144,BNFO 286,A00,734451,Ideker; Trey,26,0,30,4
1731506834168,BNFO 294,A01,734453,Ross; Camille,45,0,50,5
1731506835207,CAT 2,A01,740617,Bronstein; Phoebe Malan,16,0,16,0
1731506835207,CAT 2,A02,740618,Bronstein; Phoebe Malan,9,0,16,7
1731506835207,CAT 2,A03,740619,Bronstein; Phoebe Malan,0,0,16,16
1731506835207,CAT 2,A04,740620,Bronstein; Phoebe Malan,9,0,16,7
1731506835207,CAT 2,A05,740621,Bronstein; Phoebe Malan,8,0,16,8
1731506835207,CAT 2,A06,740623,Bronstein; Phoebe Malan,12,0,16,4
1731506835207,CAT 2,A07,740625,Bronstein; Phoebe Malan,14,0,16,2
1731506835207,CAT 2,A08,740628,Bronstein; Phoebe Malan,15,0,16,1
1731506835207,CAT 2,A09,740629,Bronstein; Phoebe Malan,16,0,16,0
1731506835207,CAT 2,A10,740679,Bronstein; Phoebe Malan,16,0,16,0
1731506835207,CAT 2,A11,740681,Bronstein; Phoebe Malan,13,0,16,3
1731506835207,CAT 2,A12,740686,Bronstein; Phoebe Malan,13,0,16,3
1731506835207,CAT 2,A13,740698,Bronstein; Phoebe Malan,12,0,16,4
1731506835207,CAT 2,A14,740703,Bronstein; Phoebe Malan,12,0,16,4
1731506835207,CAT 2,A15,740704,Bronstein; Phoebe Malan,15,0,16,1
1731506835207,CAT 2,A16,740709,Bronstein; Phoebe Malan,13,0,16,3
1731506835207,CAT 2,B01,740715,Bigham; David Joseph,15,0,16,1
1731506835207,CAT 2,B02,740761,Bigham; David Joseph,14,0,16,2
1731506835207,CAT 2,B03,740762,Bigham; David Joseph,12,0,16,4
1731506835207,CAT 2,B04,740763,Bigham; David Joseph,12,0,16,4
1731506835207,CAT 2,B05,740764,Bigham; David Joseph,16,0,16,0
1731506835207,CAT 2,B06,740765,Bigham; David Joseph,13,0,16,3
1731506835207,CAT 2,B07,740767,Bigham; David Joseph,16,0,16,0
1731506835207,CAT 2,B08,740768,Bigham; David Joseph,16,0,16,0
1731506835207,CAT 2,B09,740770,Bigham; David Joseph,16,0,16,0
1731506835207,CAT 2,B10,740772,Bigham; David Joseph,12,0,16,4
1731506835207,CAT 2,B11,740773,Bigham; David Joseph,15,0,16,1
1731506835207,CAT 2,B12,740774,Bigham; David Joseph,16,0,16,0
1731506835207,CAT 2,B13,740777,Bigham; David Joseph,14,0,16,2
1731506835207,CAT 2,B14,740780,Bigham; David Joseph,12,0,16,4
1731506835207,CAT 2,B15,740781,Bigham; David Joseph,16,0,16,0
1731506835207,CAT 2,B16,740848,Bigham; David Joseph,16,0,16,0
1731506835207,CAT 2,C01,740895,Marchisotto; Jennifer Anne,16,0,16,0
1731506835207,CAT 2,C02,740896,Marchisotto; Jennifer Anne,13,0,16,3
1731506835207,CAT 2,C03,740908,Marchisotto; Jennifer Anne,12,0,16,4
1731506835207,CAT 2,C04,740944,Marchisotto; Jennifer Anne,14,0,16,2
1731506835207,CAT 2,C05,740945,Marchisotto; Jennifer Anne,15,0,16,1
1731506835207,CAT 2,C06,740946,Marchisotto; Jennifer Anne,16,0,16,0
1731506835207,CAT 2,C07,740947,Marchisotto; Jennifer Anne,14,0,16,2
1731506835207,CAT 2,C08,740949,Marchisotto; Jennifer Anne,16,0,16,0
1731506835207,CAT 2,C09,740960,Marchisotto; Jennifer Anne,16,0,16,0
1731506835207,CAT 2,C10,740966,Marchisotto; Jennifer Anne,15,0,16,1
1731506835207,CAT 2,C11,741017,Marchisotto; Jennifer Anne,15,0,16,1
1731506835207,CAT 2,C12,741018,Marchisotto; Jennifer Anne,14,0,16,2
1731506835207,CAT 2,C13,741019,Marchisotto; Jennifer Anne,16,0,16,0
1731506835207,CAT 2,C14,741024,Marchisotto; Jennifer Anne,15,0,16,1
1731506835207,CAT 2,D01,741027,Nguyen; Hoang A.,14,0,16,2
1731506835207,CAT 2,D02,741028,Nguyen; Hoang A.,6,0,16,10
1731506835207,CAT 2,D03,741029,Nguyen; Hoang A.,9,0,16,7
1731506835207,CAT 2,D04,741031,Nguyen; Hoang A.,15,0,16,1
1731506835207,CAT 2,D05,741033,Nguyen; Hoang A.,16,0,16,0
1731506835207,CAT 2,D06,741034,Nguyen; Hoang A.,15,0,16,1
1731506835207,CAT 2,D07,741035,Nguyen; Hoang A.,16,0,16,0
1731506835207,CAT 2,D08,741036,Nguyen; Hoang A.,16,0,16,0
1731506835207,CAT 2,D09,741039,Nguyen; Hoang A.,14,0,16,2
1731506835207,CAT 2,D10,741042,Nguyen; Hoang A.,14,0,16,2
1731506835207,CAT 2,D11,741045,Nguyen; Hoang A.,15,0,16,1
1731506835207,CAT 2,D12,741047,Nguyen; Hoang A.,15,0,16,1
1731506835207,CAT 2,D13,741049,Nguyen; Hoang A.,15,0,16,1
1731506835207,CAT 2,D14,741054,Nguyen; Hoang A.,15,0,16,1
1731506836235,CAT 2CE,A01,741072,Popko; Elizabeth Ashley,24,0,25,1
1731506837262,CAT 87,A00,741105,Bronstein; Phoebe Malan,20,0,20,0
1731506837262,CAT 87,B00,795240,Delaville; Romain,20,0,20,0
1731506838290,CAT 124,A01,741118,Geibel; William,20,0,20,0
1731506838290,CAT 124,B01,799621,Staff,20,0,20,0
1731506839322,CAT 125,001,741143,Bigham; David Joseph,20,0,20,0
1731506839322,CAT 125,002,741149,Bigham; David Joseph,16,0,20,4
1731506839322,CAT 125,003,741152,Marchisotto; Jennifer Anne,20,0,20,0
1731506839322,CAT 125,004,741162,Marchisotto; Jennifer Anne,16,0,20,4
1731506839322,CAT 125,006,741164,Delaville; Romain,19,0,20,1
1731506839322,CAT 125,007,741180,Vanderschuit; Maya Alysia,19,0,20,1
1731506839322,CAT 125,008,741192,Vanderschuit; Maya Alysia,20,0,20,0
1731506839322,CAT 125,009,741193,Vanderschuit; Maya Alysia,19,0,20,1
1731506839322,CAT 125,010,741205,Morales; Celeste Georgianna,19,0,20,1
1731506839322,CAT 125,011,741207,Morales; Celeste Georgianna,20,0,20,0
1731506839322,CAT 125,012,741208,Morales; Celeste Georgianna,20,0,20,0
1731506839322,CAT 125,013,741209,Rose; Becca Rae,18,0,20,2
1731506839322,CAT 125,014,741215,Rose; Becca Rae,20,0,20,0
1731506839322,CAT 125,015,741222,Rose; Becca Rae,20,0,20,0
1731506839322,CAT 125,016,741224,Tosun; Adriana,18,0,20,2
1731506839322,CAT 125,017,741225,Tosun; Adriana,19,0,20,1
1731506840356,CAT 125R,A00,741229,Smith; Lauryn Alissa,17,0,20,3
1731506840356,CAT 125R,B00,741230,Smith; Lauryn Alissa,18,0,20,2
1731506840356,CAT 125R,C00,741231,Smith; Lauryn Alissa,16,0,20,4
1731506840356,CAT 125R,D00,741237,Hyland; Tina Mae,16,0,20,4
1731506840356,CAT 125R,E00,741240,Hyland; Tina Mae,17,0,20,3
1731506840356,CAT 125R,F00,741242,Hyland; Tina Mae,18,0,20,2
1731506840356,CAT 125R,G00,741243,Tosun; Adriana,15,0,20,5
1731506841403,CCE 1,001,744105,Labat Ii; Michael Luis,38,0,40,2
1731506841403,CCE 1,002,744106,Garcia; Kathryn Mary,37,0,40,3
1731506841403,CCE 1,003,744107,Lee; Kassandra,38,0,40,2
1731506841403,CCE 1,004,744108,Crawford; James,36,0,40,4
1731506841403,CCE 1,005,744109,Merryman; Ashley,39,0,40,1
1731506841403,CCE 1,006,744110,Santos; Vabianna Daria,39,0,40,1
1731506841403,CCE 1,007,744125,Bigley; Michele Heather,37,0,40,3
1731506842440,CCE 2,001,744126,Staff,19,0,20,1
1731506842440,CCE 2,002,744127,Garcia; Kathryn Mary,20,0,20,0
1731506842440,CCE 2,003,744128,Labat Ii; Michael Luis,20,0,20,0
1731506842440,CCE 2,004,744129,Labat Ii; Michael Luis,20,0,20,0
1731506842440,CCE 2,005,744130,Garcia; Kathryn Mary,20,0,20,0
1731506842440,CCE 2,006,744131,Lee; Kassandra,20,0,20,0
1731506842440,CCE 2,007,744132,Lee; Kassandra,20,0,20,0
1731506842440,CCE 2,008,744133,Santos; Vabianna Daria,20,0,20,0
1731506842440,CCE 2,009,744134,Santos; Vabianna Daria,19,0,20,1
1731506842440,CCE 2,010,744135,Bigley; Michele Heather,20,0,20,0
1731506842440,CCE 2,011,744167,Merryman; Ashley,20,0,20,0
1731506842440,CCE 2,012,744168,Merryman; Ashley,20,0,20,0
1731506843469,CCS 102,A00,795242,Werner; Bradley T.,15,0,20,5
1731506844496,CCS 123,A00,794510,Staff,25,0,25,0
1731506845523,CENG 15,A01,734482,Yang; Kesong,25,0,25,0
1731506846553,CENG 101A,A00,734483,Staff,49,0,50,1
1731506847577,CENG 101B,A00,734484,Liu; Ping,99,0,100,1
1731506848603,CENG 102,A00,734485,Powell; Alyssa,69,0,70,1
1731506848603,CENG 102,B00,734486,Powell; Alyssa,68,0,70,2
1731506849634,CENG 114,A00,734487,Jahed Motlagh; Zeinab,97,0,100,3
1731506850662,CENG 124A,A00,734488,Drews; Aaron,42,0,60,18
1731506850662,CENG 124A,B00,734489,Russ; Benjamin Edward,53,0,60,7
1731506851687,CENG 134,A00,734490,Pokorski; Jonathan Kyle,63,0,70,7
1731506852715,CENG 176A,A01,734492,Opatkiewicz; Justin Paul,11,0,48,37
1731506852715,CENG 176A,B01,734494,Zhang; Liangfang,55,0,60,5
1731506853741,CENG 205,A00,734495,Jahed Motlagh; Zeinab,40,0,60,20
1731506854768,CENG 213,A00,734496,Fenning; David,6,0,10,4
1731506855796,CENG 214,A00,734497,Li; Wan-Lu,10,0,10,0
1731506856821,CENG 215,A00,734498,Jokerst; Jesse Vincent,10,0,10,0
1731506857847,CENG 221B,A00,734499,Staff,28,0,50,22
1731506858873,CENG 251,A00,734500,Pascal; Tod A,29,0,50,21
1731506859903,CENG 252,A00,734501,Chen; Zheng,28,0,50,22
1731506860933,CENG 256,A00,734502,Meyers; Marc,10,0,10,0
1731506861961,CGS 101,A00,740473,Cuong; Marisol,35,0,35,0
1731506862989,CGS 108,A00,740486,Lu; Lillian,20,0,20,0
1731506864016,CGS 111,A00,740518,Martin Sandino; Amanda Maria Yoland,31,0,35,4
1731506865042,CGS 116,A00,740521,Cuong; Marisol,31,0,32,1
1731506866067,CGS 124,A00,740524,Martin Sandino; Amanda Maria Yoland,14,0,15,1
1731506867093,CGS 125,A00,740528,Browne; Errol Tsekani,19,0,20,1
1731506868123,CGS 135,A00,740534,Okonkwo; Holly,15,0,15,0
1731506869155,CGS 136,A00,740538,Chatti; Deepti,15,0,15,0
1731506870186,CGS 137,A00,740541,Martin Sandino; Amanda Maria Yoland,19,0,20,1
1731506871216,CGS 165,A00,740547,Browne; Errol Tsekani,13,0,15,2
1731506872242,CGS 167A,A00,740604,Patel; Shaista,11,0,12,1
1731506873275,CGS 187,A00,740608,Cuong; Marisol,13,0,15,2
1731506874304,CGS 196A,A00,740611,Taylor-Garcia; Daphne,1,0,1,0
1731506874304,CGS 196A,B00,799481,Hankins; Joseph D.,1,0,1,0
1731506874304,CGS 196A,C00,799482,Yapp; Hentyle T,1,0,1,0
1731506875333,CHEM 1,A00,734503,Brydges; Stacey,39,0,40,1
1731506876377,CHEM 6A,A01,784433,Lam; Tin Yiu,38,0,40,2
1731506876377,CHEM 6A,A02,784434,Lam; Tin Yiu,40,0,40,0
1731506876377,CHEM 6A,A03,784436,Lam; Tin Yiu,39,0,40,1
1731506876377,CHEM 6A,A04,784437,Lam; Tin Yiu,35,0,40,5
1731506876377,CHEM 6A,A05,784438,Lam; Tin Yiu,40,0,40,0
1731506876377,CHEM 6A,A06,784440,Lam; Tin Yiu,40,0,40,0
1731506876377,CHEM 6A,A07,784441,Lam; Tin Yiu,0,0,0,0
1731506876377,CHEM 6A,B01,784443,Lam; Tin Yiu,40,0,40,0
1731506876377,CHEM 6A,B02,784445,Lam; Tin Yiu,34,0,36,2
1731506876377,CHEM 6A,B03,784446,Lam; Tin Yiu,34,0,40,6
1731506876377,CHEM 6A,B04,784449,Lam; Tin Yiu,38,0,40,2
1731506876377,CHEM 6A,B05,784454,Lam; Tin Yiu,37,0,40,3
1731506876377,CHEM 6A,B06,784455,Lam; Tin Yiu,39,0,40,1
1731506876377,CHEM 6A,B07,784456,Lam; Tin Yiu,0,0,0,0
1731506876377,CHEM 6A,C01,784457,Ternansky; Robert J.,40,0,40,0
1731506876377,CHEM 6A,C02,784458,Ternansky; Robert J.,33,0,40,7
1731506876377,CHEM 6A,C03,784460,Ternansky; Robert J.,33,0,40,7
1731506876377,CHEM 6A,C04,784461,Ternansky; Robert J.,40,0,40,0
1731506876377,CHEM 6A,C05,784462,Ternansky; Robert J.,40,0,40,0
1731506876377,CHEM 6A,C06,784465,Ternansky; Robert J.,40,0,40,0
1731506876377,CHEM 6A,C07,784468,Ternansky; Robert J.,0,0,0,0
1731506877415,CHEM 6B,A01,784469,Kummel; Andrew C,40,0,40,0
1731506877415,CHEM 6B,A02,784470,Kummel; Andrew C,40,0,40,0
1731506877415,CHEM 6B,A03,784471,Kummel; Andrew C,39,0,40,1
1731506877415,CHEM 6B,A04,784472,Kummel; Andrew C,38,0,40,2
1731506877415,CHEM 6B,A05,784473,Kummel; Andrew C,37,0,40,3
1731506877415,CHEM 6B,A06,784474,Kummel; Andrew C,39,0,40,1
1731506877415,CHEM 6B,A07,784475,Kummel; Andrew C,0,0,0,0
1731506877415,CHEM 6B,B01,784481,Sailor; Michael Joseph,39,0,40,1
1731506877415,CHEM 6B,B02,784482,Sailor; Michael Joseph,39,0,40,1
1731506877415,CHEM 6B,B03,784483,Sailor; Michael Joseph,39,0,40,1
1731506877415,CHEM 6B,B04,784484,Sailor; Michael Joseph,40,0,40,0
1731506877415,CHEM 6B,B05,784485,Sailor; Michael Joseph,40,0,40,0
1731506877415,CHEM 6B,B06,784486,Sailor; Michael Joseph,40,0,40,0
1731506877415,CHEM 6B,B07,784487,Sailor; Michael Joseph,0,0,0,0
1731506877415,CHEM 6B,C01,784489,Stallings; Dontarie M,33,0,40,7
1731506877415,CHEM 6B,C02,784490,Stallings; Dontarie M,20,0,24,4
1731506877415,CHEM 6B,C03,784491,Stallings; Dontarie M,37,0,40,3
1731506877415,CHEM 6B,C04,784525,Stallings; Dontarie M,36,0,40,4
1731506877415,CHEM 6B,C05,784529,Stallings; Dontarie M,40,0,40,0
1731506877415,CHEM 6B,C06,784532,Stallings; Dontarie M,39,0,40,1
1731506877415,CHEM 6B,C07,784534,Stallings; Dontarie M,0,0,0,0
1731506877415,CHEM 6B,D01,784537,Stallings; Dontarie M,29,0,40,11
1731506877415,CHEM 6B,D02,784540,Stallings; Dontarie M,33,0,40,7
1731506877415,CHEM 6B,D03,784543,Stallings; Dontarie M,37,0,40,3
1731506877415,CHEM 6B,D04,784544,Stallings; Dontarie M,37,0,40,3
1731506877415,CHEM 6B,D05,784546,Stallings; Dontarie M,38,0,40,2
1731506877415,CHEM 6B,D06,784547,Stallings; Dontarie M,38,0,40,2
1731506877415,CHEM 6B,D07,784553,Stallings; Dontarie M,0,0,0,0
1731506877415,CHEM 6B,E01,784556,Young; Mark,40,0,40,0
1731506877415,CHEM 6B,E02,784557,Young; Mark,40,0,40,0
1731506877415,CHEM 6B,E03,784566,Young; Mark,40,0,40,0
1731506877415,CHEM 6B,E04,784568,Young; Mark,40,0,40,0
1731506877415,CHEM 6B,E05,784571,Young; Mark,40,0,40,0
1731506877415,CHEM 6B,E06,784572,Young; Mark,39,0,40,1
1731506877415,CHEM 6B,E07,784574,Young; Mark,0,0,0,0
1731506877415,CHEM 6B,F01,784578,Young; Mark,40,0,40,0
1731506877415,CHEM 6B,F02,784581,Young; Mark,40,0,40,0
1731506877415,CHEM 6B,F03,784582,Young; Mark,40,0,40,0
1731506877415,CHEM 6B,F04,784584,Young; Mark,40,0,40,0
1731506877415,CHEM 6B,F05,784585,Young; Mark,40,0,40,0
1731506877415,CHEM 6B,F06,784589,Young; Mark,40,0,40,0
1731506877415,CHEM 6B,F07,784591,Young; Mark,0,0,0,0
1731506877415,CHEM 6B,G01,785227,Schurmeier; Kimberly,35,0,40,5
1731506877415,CHEM 6B,G02,785228,Schurmeier; Kimberly,37,0,40,3
1731506877415,CHEM 6B,G03,785229,Schurmeier; Kimberly,35,0,40,5
1731506877415,CHEM 6B,G04,785230,Schurmeier; Kimberly,0,0,0,0
1731506877415,CHEM 6B,G05,785231,Schurmeier; Kimberly,39,0,40,1
1731506877415,CHEM 6B,G06,785233,Schurmeier; Kimberly,34,0,40,6
1731506877415,CHEM 6B,G07,785234,Schurmeier; Kimberly,39,0,40,1
1731506878443,CHEM 6BH,A01,785675,Yuen Zhou; Joel,49,0,50,1
1731506879470,CHEM 6C,A01,785073,Ternansky; Robert J.,40,0,40,0
1731506879470,CHEM 6C,A02,785074,Ternansky; Robert J.,37,0,40,3
1731506879470,CHEM 6C,A03,785148,Ternansky; Robert J.,38,0,40,2
1731506879470,CHEM 6C,A04,785155,Ternansky; Robert J.,40,0,40,0
1731506879470,CHEM 6C,A05,785158,Ternansky; Robert J.,0,0,0,0
1731506879470,CHEM 6C,A06,785159,Ternansky; Robert J.,36,0,40,4
1731506879470,CHEM 6C,A07,785160,Ternansky; Robert J.,40,0,40,0
1731506879470,CHEM 6C,B01,784597,Albizati; Kim F.,26,0,40,14
1731506879470,CHEM 6C,B02,784600,Albizati; Kim F.,38,0,40,2
1731506879470,CHEM 6C,B03,784603,Albizati; Kim F.,34,0,40,6
1731506879470,CHEM 6C,B04,784604,Albizati; Kim F.,34,0,40,6
1731506879470,CHEM 6C,B05,784606,Albizati; Kim F.,39,0,40,1
1731506879470,CHEM 6C,B06,784607,Albizati; Kim F.,38,0,40,2
1731506879470,CHEM 6C,B07,784610,Albizati; Kim F.,0,0,0,0
1731506880573,CHEM 7L,A01,734519,Leigh; Brian,24,0,24,0
1731506880573,CHEM 7L,A02,734520,Leigh; Brian,23,0,24,1
1731506880573,CHEM 7L,A03,734521,Leigh; Brian,24,0,24,0
1731506880573,CHEM 7L,A04,734522,Leigh; Brian,21,0,21,0
1731506880573,CHEM 7L,A05,734523,Leigh; Brian,22,0,24,2
1731506880573,CHEM 7L,A06,734524,Leigh; Brian,24,0,24,0
1731506880573,CHEM 7L,A07,734525,Leigh; Brian,23,0,24,1
1731506880573,CHEM 7L,A08,734526,Leigh; Brian,23,0,24,1
1731506880573,CHEM 7L,A09,734527,Leigh; Brian,23,0,24,1
1731506880573,CHEM 7L,A10,734528,Leigh; Brian,19,0,21,2
1731506880573,CHEM 7L,B01,734530,Leigh; Brian,14,0,24,10
1731506880573,CHEM 7L,B02,734531,Leigh; Brian,22,0,24,2
1731506880573,CHEM 7L,B03,734532,Leigh; Brian,24,0,24,0
1731506880573,CHEM 7L,B04,734533,Leigh; Brian,24,0,24,0
1731506880573,CHEM 7L,B05,734534,Leigh; Brian,24,0,24,0
1731506880573,CHEM 7L,B06,734535,Leigh; Brian,22,0,24,2
1731506880573,CHEM 7L,B07,734536,Leigh; Brian,20,0,21,1
1731506880573,CHEM 7L,B08,734537,Leigh; Brian,13,0,24,11
1731506880573,CHEM 7L,B09,734538,Leigh; Brian,21,0,24,3
1731506880573,CHEM 7L,B10,734539,Leigh; Brian,22,0,24,2
1731506880573,CHEM 7L,C01,734541,Leigh; Brian,21,0,24,3
1731506880573,CHEM 7L,C02,734542,Leigh; Brian,23,0,24,1
1731506880573,CHEM 7L,C03,734543,Leigh; Brian,23,0,24,1
1731506880573,CHEM 7L,C04,734624,Leigh; Brian,24,0,24,0
1731506880573,CHEM 7L,C05,734625,Leigh; Brian,20,0,24,4
1731506880573,CHEM 7L,C06,734626,Leigh; Brian,23,0,24,1
1731506880573,CHEM 7L,C07,734658,Leigh; Brian,21,0,24,3
1731506880573,CHEM 7L,C08,734668,Leigh; Brian,23,0,24,1
1731506880573,CHEM 7L,C09,734754,Leigh; Brian,24,0,24,0
1731506880573,CHEM 7L,C10,734758,Leigh; Brian,19,0,21,2
1731506881603,CHEM 11,A01,785161,Huang; Xuemei,36,0,40,4
1731506881603,CHEM 11,A02,785164,Huang; Xuemei,39,0,40,1
1731506881603,CHEM 11,A03,785168,Huang; Xuemei,39,0,40,1
1731506881603,CHEM 11,A04,785169,Huang; Xuemei,40,0,40,0
1731506881603,CHEM 11,A05,785175,Huang; Xuemei,39,0,40,1
1731506881603,CHEM 11,A06,785177,Huang; Xuemei,35,0,40,5
1731506881603,CHEM 11,A07,785178,Huang; Xuemei,39,0,40,1
1731506881603,CHEM 11,A08,785179,Huang; Xuemei,39,0,40,1
1731506882640,CHEM 40A,A01,784614,Cohen; Seth M,29,0,40,11
1731506882640,CHEM 40A,A02,784615,Cohen; Seth M,38,0,40,2
1731506882640,CHEM 40A,A03,784617,Cohen; Seth M,32,0,39,7
1731506882640,CHEM 40A,A04,784632,Cohen; Seth M,38,0,40,2
1731506882640,CHEM 40A,A05,784657,Cohen; Seth M,36,0,40,4
1731506882640,CHEM 40A,A06,784658,Cohen; Seth M,38,0,40,2
1731506882640,CHEM 40A,A07,784689,Cohen; Seth M,40,0,40,0
1731506882640,CHEM 40A,A08,784695,Cohen; Seth M,40,0,40,0
1731506883686,CHEM 40B,A01,785501,Weizman; Haim,38,0,40,2
1731506883686,CHEM 40B,A02,785503,Weizman; Haim,30,0,40,10
1731506883686,CHEM 40B,A03,785504,Weizman; Haim,25,0,40,15
1731506883686,CHEM 40B,A04,785505,Weizman; Haim,38,0,40,2
1731506883686,CHEM 40B,A05,785506,Weizman; Haim,39,0,40,1
1731506883686,CHEM 40B,A06,785507,Weizman; Haim,0,0,0,0
1731506883686,CHEM 40B,A07,798353,Weizman; Haim,35,0,40,5
1731506883686,CHEM 40B,A08,798354,Weizman; Haim,38,0,40,2
1731506883686,CHEM 40B,B01,785184,Romero; Erik Anthony,37,0,40,3
1731506883686,CHEM 40B,B02,785185,Romero; Erik Anthony,39,0,40,1
1731506883686,CHEM 40B,B03,785186,Romero; Erik Anthony,40,0,40,0
1731506883686,CHEM 40B,B04,785187,Romero; Erik Anthony,37,0,40,3
1731506883686,CHEM 40B,B05,785190,Romero; Erik Anthony,40,0,40,0
1731506883686,CHEM 40B,B06,785191,Romero; Erik Anthony,0,0,0,0
1731506883686,CHEM 40B,B07,795158,Romero; Erik Anthony,40,0,40,0
1731506883686,CHEM 40B,B08,795161,Romero; Erik Anthony,40,0,40,0
1731506883686,CHEM 40B,C01,785509,Pun; Andrew Brian,31,0,38,7
1731506883686,CHEM 40B,C02,785510,Pun; Andrew Brian,31,0,40,9
1731506883686,CHEM 40B,C03,785512,Pun; Andrew Brian,38,0,40,2
1731506883686,CHEM 40B,C04,785513,Pun; Andrew Brian,37,0,40,3
1731506883686,CHEM 40B,C05,785514,Pun; Andrew Brian,39,0,40,1
1731506883686,CHEM 40B,C06,785515,Pun; Andrew Brian,34,0,40,6
1731506883686,CHEM 40B,C07,795106,Pun; Andrew Brian,29,0,40,11
1731506883686,CHEM 40B,C08,795148,Pun; Andrew Brian,0,0,0,0
1731506884714,CHEM 41A,A01,785193,Yang; Jerry,35,0,36,1
1731506884714,CHEM 41A,A02,785220,Yang; Jerry,31,0,36,5
1731506884714,CHEM 41A,A03,785221,Yang; Jerry,35,0,37,2
1731506884714,CHEM 41A,A04,785222,Yang; Jerry,37,0,37,0
1731506885743,CHEM 41B,A01,785594,Theodorakis; Emmanuel,35,0,40,5
1731506885743,CHEM 41B,A02,785595,Theodorakis; Emmanuel,40,0,40,0
1731506885743,CHEM 41B,A03,785598,Theodorakis; Emmanuel,36,0,40,4
1731506885743,CHEM 41B,A04,785599,Theodorakis; Emmanuel,24,0,24,0
1731506885743,CHEM 41B,A05,785656,Theodorakis; Emmanuel,39,0,40,1
1731506885743,CHEM 41B,A06,785657,Theodorakis; Emmanuel,40,0,40,0
1731506885743,CHEM 41B,A07,785658,Theodorakis; Emmanuel,37,0,40,3
1731506886778,CHEM 43A,A01,734984,Figueroa; Joshua,13,0,24,11
1731506886778,CHEM 43A,A02,734985,Figueroa; Joshua,22,0,24,2
1731506886778,CHEM 43A,A03,734986,Figueroa; Joshua,24,0,24,0
1731506886778,CHEM 43A,A04,734987,Figueroa; Joshua,22,0,24,2
1731506886778,CHEM 43A,A05,734988,Figueroa; Joshua,0,0,0,0
1731506886778,CHEM 43A,A06,735039,Figueroa; Joshua,0,0,0,0
1731506886778,CHEM 43A,A07,735040,Figueroa; Joshua,0,0,0,0
1731506886778,CHEM 43A,A08,735130,Figueroa; Joshua,0,0,0,0
1731506886778,CHEM 43A,B01,735277,Tor; Yitzhak,0,0,24,24
1731506886778,CHEM 43A,B02,735279,Tor; Yitzhak,12,0,24,12
1731506886778,CHEM 43A,B03,735281,Tor; Yitzhak,19,0,24,5
1731506886778,CHEM 43A,B04,735282,Tor; Yitzhak,16,0,24,8
1731506886778,CHEM 43A,B05,735284,Tor; Yitzhak,0,0,0,0
1731506886778,CHEM 43A,B06,735288,Tor; Yitzhak,0,0,0,0
1731506886778,CHEM 43A,B07,735289,Tor; Yitzhak,0,0,0,0
1731506886778,CHEM 43A,B08,735290,Tor; Yitzhak,0,0,0,0
1731506886778,CHEM 43A,C01,735300,Klosterman; Jeremy K,0,0,0,0
1731506886778,CHEM 43A,C02,735304,Klosterman; Jeremy K,0,0,0,0
1731506886778,CHEM 43A,C03,735308,Klosterman; Jeremy K,0,0,0,0
1731506886778,CHEM 43A,C04,735312,Klosterman; Jeremy K,20,0,24,4
1731506886778,CHEM 43A,C05,735317,Klosterman; Jeremy K,23,0,24,1
1731506886778,CHEM 43A,C06,735319,Klosterman; Jeremy K,24,0,24,0
1731506886778,CHEM 43A,C07,735320,Klosterman; Jeremy K,16,0,17,1
1731506886778,CHEM 43A,C08,735331,Klosterman; Jeremy K,24,0,24,0
1731506887814,CHEM 100A,A01,735347,Slade; Jonathan,19,0,23,4
1731506887814,CHEM 100A,A02,735632,Slade; Jonathan,21,0,24,3
1731506887814,CHEM 100A,A03,735636,Slade; Jonathan,19,0,23,4
1731506887814,CHEM 100A,A04,735637,Slade; Jonathan,21,0,24,3
1731506887814,CHEM 100A,A05,735638,Slade; Jonathan,19,0,24,5
1731506887814,CHEM 100A,A06,735639,Slade; Jonathan,22,0,23,1
1731506888842,CHEM 100B,A01,735649,Pomeroy; Robert S.,18,0,26,8
1731506889873,CHEM 105A,A01,735653,Sinha; Amitabha,31,0,42,11
1731506890904,CHEM 108,A01,735655,Jennings; Patricia A.,9,0,20,11
1731506890904,CHEM 108,A02,735658,Jennings; Patricia A.,23,0,24,1
1731506890904,CHEM 108,B01,735663,Jennings; Patricia A.,13,0,20,7
1731506890904,CHEM 108,B02,735666,Jennings; Patricia A.,21,0,24,3
1731506891934,CHEM 109,A01,735680,Piercy; Marc Anthony,6,0,20,14
1731506891934,CHEM 109,A02,735689,Piercy; Marc Anthony,19,0,24,5
1731506891934,CHEM 109,B01,735768,Piercy; Marc Anthony,17,0,20,3
1731506891934,CHEM 109,B02,735769,Piercy; Marc Anthony,23,0,24,1
1731506892964,CHEM 114A,A01,784696,Komor; Alexis C,39,0,40,1
1731506892964,CHEM 114A,A02,784723,Komor; Alexis C,38,0,40,2
1731506892964,CHEM 114A,A03,784725,Komor; Alexis C,38,0,40,2
1731506893993,CHEM 114B,A01,785242,Budin; Itay,26,0,40,14
1731506893993,CHEM 114B,A02,785299,Budin; Itay,40,0,40,0
1731506893993,CHEM 114B,A03,785306,Budin; Itay,37,0,40,3
1731506893993,CHEM 114B,A04,785309,Budin; Itay,39,0,40,1
1731506893993,CHEM 114B,B01,785313,Ghosh; Partho,39,0,40,1
1731506893993,CHEM 114B,B02,785375,Ghosh; Partho,38,0,40,2
1731506893993,CHEM 114B,B03,785407,Ghosh; Partho,40,0,40,0
1731506893993,CHEM 114B,B04,785410,Ghosh; Partho,40,0,40,0
1731506895019,CHEM 115,A00,735864,Komor; Alexis C,1,0,30,29
1731506896046,CHEM 120A,A01,785412,Stauber; Julia Megan,28,0,40,12
1731506896046,CHEM 120A,A02,785415,Stauber; Julia Megan,37,0,40,3
1731506896046,CHEM 120A,A03,785417,Stauber; Julia Megan,39,0,39,0
1731506896046,CHEM 120A,A04,785423,Stauber; Julia Megan,38,0,39,1
1731506897080,CHEM 126A,A01,784731,Yong; Haiwang,39,0,40,1
1731506897080,CHEM 126A,A02,784732,Yong; Haiwang,38,0,40,2
1731506897080,CHEM 126A,A03,784737,Yong; Haiwang,38,0,40,2
1731506898105,CHEM 126B,A01,785659,Tauber; Michael,14,0,40,26
1731506898105,CHEM 126B,A02,785664,Tauber; Michael,32,0,40,8
1731506898105,CHEM 126B,A03,785665,Tauber; Michael,20,0,40,20
1731506898105,CHEM 126B,A04,785668,Tauber; Michael,39,0,40,1
1731506898105,CHEM 126B,A05,785669,Tauber; Michael,35,0,40,5
1731506898105,CHEM 126B,A06,785671,Tauber; Michael,33,0,40,7
1731506899143,CHEM 131,A01,785425,Galperin; Michael,37,0,40,3
1731506899143,CHEM 131,A02,785499,Galperin; Michael,38,0,40,2
1731506899143,CHEM 131,A03,785500,Galperin; Michael,39,0,40,1
1731506900175,CHEM 134,A00,735869,Pokorski; Jonathan Kyle,16,0,18,2
1731506901204,CHEM 143B,A01,735871,Weizman; Haim,21,0,24,3
1731506901204,CHEM 143B,A02,735872,Weizman; Haim,20,0,24,4
1731506901204,CHEM 143B,A03,735914,Weizman; Haim,11,0,24,13
1731506901204,CHEM 143B,A04,735916,Weizman; Haim,0,0,0,0
1731506901204,CHEM 143B,A05,735918,Weizman; Haim,0,0,0,0
1731506902230,CHEM 151,A00,735919,Donoghue; Daniel J.,86,0,100,14
1731506903255,CHEM 154,A00,735922,Romero; Nathan A & Schmidt; Valerie A,29,0,30,1
1731506904280,CHEM 155,A00,735925,Theodorakis; Emmanuel,10,0,10,0
1731506905307,CHEM 168,A01,785516,Devaraj; Neal Krishna,39,0,40,1
1731506905307,CHEM 168,A02,785551,Devaraj; Neal Krishna,39,0,40,1
1731506905307,CHEM 168,A03,785554,Devaraj; Neal Krishna,37,0,40,3
1731506905307,CHEM 168,A04,785557,Devaraj; Neal Krishna,37,0,40,3
1731506905307,CHEM 168,A05,785559,Devaraj; Neal Krishna,34,0,40,6
1731506905307,CHEM 168,A06,785566,Devaraj; Neal Krishna,36,0,40,4
1731506906337,CHEM 169,A00,794456,Jinich; Adrian,48,0,50,2
1731506907362,CHEM 172,A01,785676,Pomeroy; Robert S.,46,0,50,4
1731506908394,CHEM 187,A00,735955,Brydges; Stacey,19,0,20,1
1731506909422,CHEM 194,A00,735956,Newsam; John,13,0,18,5
1731506910452,CHEM 200B,A00,735957,Pomeroy; Robert S.,8,0,20,12
1731506911480,CHEM 212,A00,735958,Budin; Itay,14,0,30,16
1731506912507,CHEM 213B,A00,735990,Debelouchina; Galia T,32,0,50,18
1731506913535,CHEM 215,A00,735991,Komor; Alexis C,12,0,30,18
1731506914562,CHEM 219C,A00,735992,Jennings; Patricia A.,9,0,15,6
1731506915593,CHEM 223,A00,735993,Oconnor; Joseph M.,25,0,30,5
1731506916619,CHEM 227,A00,735994,Stauber; Julia Megan,28,0,30,2
1731506917651,CHEM 229,A00,735995,Cohen; Seth M,15,0,20,5
1731506918676,CHEM 232A,A00,735996,Yuen Zhou; Joel,13,0,15,2
1731506919703,CHEM 254,A00,735997,Romero; Nathan A & Schmidt; Valerie A,27,0,30,3
1731506920733,CHEM 255,A00,735998,Theodorakis; Emmanuel,18,0,20,2
1731506921758,CHEM 269,A00,794455,Jinich; Adrian,8,0,25,17
1731506922787,CHEM 291,A00,735999,Debelouchina; Galia T,30,0,30,0
1731506923813,CHEM 294,A00,736000,Romero; Nathan A,48,0,50,2
1731506924843,CHIN 10BD,A01,736053,Liu; Mingming,16,0,16,0
1731506924843,CHIN 10BD,A02,736054,Liu; Mingming,16,0,16,0
1731506925871,CHIN 10BM,A01,736056,Chen; Pei-Chia,18,0,20,2
1731506925871,CHIN 10BM,A02,736057,Chen; Pei-Chia,14,0,15,1
1731506926900,CHIN 10BN,A01,736063,Xu; Li,13,0,13,0
1731506926900,CHIN 10BN,A02,736064,Xu; Li,11,0,13,2
1731506926900,CHIN 10BN,B01,736084,Xu; Li,10,0,13,3
1731506926900,CHIN 10BN,B02,736097,Xu; Li,12,0,13,1
1731506926900,CHIN 10BN,C01,736345,Xu; Li,9,0,13,4
1731506926900,CHIN 10BN,C02,736346,Xu; Li,0,0,0,0
1731506927927,CHIN 20BD,A01,795569,Liu; Mingming,14,0,14,0
1731506927927,CHIN 20BD,A02,795570,Liu; Mingming,14,0,14,0
1731506928961,CHIN 20BM,A01,736414,Wang; Xiao,15,0,16,1
1731506928961,CHIN 20BM,A02,736421,Wang; Xiao,16,0,16,0
1731506929988,CHIN 20BN,A01,736427,Anderson; Qin-Hong,13,0,14,1
1731506929988,CHIN 20BN,A02,736430,Anderson; Qin-Hong,13,0,14,1
1731506929988,CHIN 20BN,B01,736434,Anderson; Qin-Hong,0,0,0,0
1731506929988,CHIN 20BN,B02,736440,Anderson; Qin-Hong,0,0,0,0
1731506931012,CHIN 100BM,A00,736443,Wang; Xiao,20,0,20,0
1731506932038,CHIN 100BN,A00,736444,Chen; Pei-Chia,20,0,21,1
1731506933068,CHIN 169A,A00,736447,Wang; Xiao,20,0,20,0
1731506934095,CHIN 182A,A00,736468,Liu; Mingming,19,0,20,1
1731506935123,CLAS 87,A00,736801,Herbst; Matthew,20,0,20,0
1731506936148,CLIN 227A,A01,799589,Gold; Jeffrey Joseph,20,0,20,0
1731506937173,CLIN 227B,A00,799590,Gold; Jeffrey Joseph,20,0,20,0
1731506938201,CLIN 228,A01,799594,Gold; Jeffrey Joseph,20,0,20,0
1731506939227,CLIN 294B,A00,799595,Thomas; Kelsey Rae,10,0,10,0
1731506940253,CLIN 296,001,799596,Brookman; Lauren Irene,100,0,100,0
1731506940253,CLIN 296,002,799597,Brookman; Lauren Irene,10,0,10,0
1731506941285,CLRE 236R,A00,736762,Mehta; Ravindra L.,9994,0,9999,5
1731506942315,CLRE 237,A00,736763,Morris; Sheldon,9994,0,9999,5
1731506943342,CLRE 250R,A01,736787,Graves; Jennifer Sharon Ol,9999,0,9999,0
1731506944367,CLRE 251R,A00,795042,Mehta; Ravindra L.,9999,0,9999,0
1731506945393,CLRE 253,A00,736792,Vaida; Florin,9998,0,9999,1
1731506946419,CLRE 259,A00,736793,Patel; Hemal,9996,0,9999,3
1731506947447,CLRE 260,A00,736795,Cuomo; Raphael Eduardo,9996,0,9999,3
1731506947447,CLRE 260,B00,800937,Cuomo; Raphael Eduardo,9999,0,9999,0
1731506948476,CLRE 267,A00,795044,Vaida; Florin,9995,0,9999,4
1731506949501,CLRE 295B,A00,736798,Cuomo; Raphael Eduardo,9999,0,9999,0
1731506950528,CLRE 297,001,736799,Cuomo; Raphael Eduardo,9999,0,9999,0
1731506951560,CMM 246,A00,796595,Gordts; Philip & Lewis; Amanda Lark & Godula; Kamil & Gagneux; Pascal & Esko; Jeffrey D. & Bode; Lars,10,0,10,0
1731506952586,COGR 200B,A00,738801,Cordoba Azcarate; Matilde,5,0,5,0
1731506953612,COGR 200C,A00,738803,Geiger; Richard Stuart,5,0,5,0
1731506954638,COGR 201J,A00,738804,Hallin; Daniel C,8,0,10,2
1731506955666,COGR 225C,A00,738805,McKenzie; Kerry V.,4,0,5,1
1731506956691,COGR 225D,A00,738806,Lampland; Martha,5,0,5,0
1731506957719,COGR 237,A00,738807,Anderson; Patrick W.,3,0,10,7
1731506958744,COGR 275,A00,738808,Dominguez Rubio; Fernando,10,0,10,0
1731506959770,COGS 1,A01,737008,Kiyonaga; Anastasia,55,0,62,7
1731506959770,COGS 1,A02,737010,Kiyonaga; Anastasia,62,0,65,3
1731506959770,COGS 1,A03,737011,Kiyonaga; Anastasia,65,0,66,1
1731506959770,COGS 1,A04,737014,Kiyonaga; Anastasia,56,0,56,0
1731506959770,COGS 1,A05,737015,Kiyonaga; Anastasia,56,0,56,0
1731506959770,COGS 1,A06,737016,Kiyonaga; Anastasia,50,0,56,6
1731506959770,COGS 1,A07,737018,Kiyonaga; Anastasia,55,0,56,1
1731506960797,COGS 9,A01,737025,Staff,55,0,56,1
1731506960797,COGS 9,A02,737028,Staff,54,0,56,2
1731506960797,COGS 9,A03,737029,Staff,55,0,56,1
1731506960797,COGS 9,A04,737030,Staff,53,0,56,3
1731506960797,COGS 9,A05,737031,Staff,54,0,56,2
1731506960797,COGS 9,A06,737033,Staff,45,0,48,3
1731506961825,COGS 10,A01,737044,Morgan; Eric,48,0,56,8
1731506961825,COGS 10,A02,737045,Morgan; Eric,51,0,58,7
1731506961825,COGS 10,A03,737047,Morgan; Eric,52,0,56,4
1731506961825,COGS 10,A04,737049,Morgan; Eric,53,0,56,3
1731506961825,COGS 10,A05,737050,Morgan; Eric,51,0,52,1
1731506961825,COGS 10,A06,737051,Morgan; Eric,48,0,50,2
1731506962854,COGS 11,A01,737077,Boyle; Mary E. T.,46,0,50,4
1731506962854,COGS 11,A02,737078,Boyle; Mary E. T.,50,0,50,0
1731506962854,COGS 11,A03,737135,Boyle; Mary E. T.,44,0,47,3
1731506963885,COGS 13,A01,737138,Staff,63,0,65,2
1731506963885,COGS 13,A02,737139,Staff,53,0,56,3
1731506963885,COGS 13,A03,737142,Staff,54,0,56,2
1731506963885,COGS 13,A04,737144,Staff,56,0,56,0
1731506963885,COGS 13,A05,737145,Staff,53,0,56,3
1731506963885,COGS 13,A06,737148,Staff,56,0,56,0
1731506963885,COGS 13,A07,737149,Staff,65,0,65,0
1731506964911,COGS 14A,A01,737151,Barrera; Steven James,57,0,60,3
1731506964911,COGS 14A,A02,737152,Barrera; Steven James,55,0,60,5
1731506964911,COGS 14A,A03,737153,Barrera; Steven James,59,0,60,1
1731506964911,COGS 14A,A04,737154,Barrera; Steven James,58,0,60,2
1731506964911,COGS 14A,A05,737155,Barrera; Steven James,59,0,60,1
1731506965937,COGS 14B,A01,737157,Hoffman; Drew Ellen,46,0,50,4
1731506965937,COGS 14B,A02,737158,Hoffman; Drew Ellen,48,0,50,2
1731506965937,COGS 14B,A03,737159,Hoffman; Drew Ellen,48,0,50,2
1731506965937,COGS 14B,A04,737160,Hoffman; Drew Ellen,49,0,50,1
1731506965937,COGS 14B,A05,737189,Hoffman; Drew Ellen,50,0,50,0
1731506966969,COGS 17,A01,737193,Johnson; Christine M.,56,0,60,4
1731506966969,COGS 17,A02,737200,Johnson; Christine M.,57,0,60,3
1731506966969,COGS 17,A03,737210,Johnson; Christine M.,57,0,60,3
1731506966969,COGS 17,A04,737211,Johnson; Christine M.,59,0,60,1
1731506966969,COGS 17,A05,737234,Johnson; Christine M.,57,0,60,3
1731506966969,COGS 17,A06,737237,Johnson; Christine M.,58,0,60,2
1731506967997,COGS 18,A01,737254,Morgan; Eric,32,0,35,3
1731506967997,COGS 18,A02,737255,Morgan; Eric,33,0,35,2
1731506967997,COGS 18,A03,737256,Morgan; Eric,31,0,35,4
1731506967997,COGS 18,A04,737257,Morgan; Eric,31,0,35,4
1731506967997,COGS 18,A05,737264,Morgan; Eric,28,0,35,7
1731506967997,COGS 18,A06,737265,Morgan; Eric,32,0,35,3
1731506967997,COGS 18,A07,737288,Morgan; Eric,32,0,35,3
1731506967997,COGS 18,A08,737333,Morgan; Eric,35,0,35,0
1731506967997,COGS 18,A09,737334,Morgan; Eric,33,0,35,2
1731506969026,COGS 87,A00,737335,Deak; Gedeon O.,19,0,20,1
1731506970060,COGS 100,A01,737386,Allen; Michael Gordon,49,0,56,7
1731506970060,COGS 100,A02,737387,Allen; Michael Gordon,56,0,56,0
1731506970060,COGS 100,A03,737390,Allen; Michael Gordon,55,0,56,1
1731506970060,COGS 100,A04,737392,Allen; Michael Gordon,55,0,56,1
1731506970060,COGS 100,A05,737393,Allen; Michael Gordon,58,0,61,3
1731506970060,COGS 100,A06,737394,Allen; Michael Gordon,65,0,65,0
1731506971092,COGS 101A,A01,737396,Barrera; Steven James,57,0,61,4
1731506971092,COGS 101A,A02,737399,Barrera; Steven James,61,0,65,4
1731506971092,COGS 101A,A03,737400,Barrera; Steven James,53,0,56,3
1731506971092,COGS 101A,A04,737401,Barrera; Steven James,53,0,56,3
1731506971092,COGS 101A,A05,737404,Barrera; Steven James,54,0,56,2
1731506971092,COGS 101A,A06,737405,Barrera; Steven James,56,0,56,0
1731506972121,COGS 101B,A01,737408,Allen; Michael Gordon,46,0,50,4
1731506972121,COGS 101B,A02,737412,Allen; Michael Gordon,49,0,50,1
1731506972121,COGS 101B,A03,737413,Allen; Michael Gordon,49,0,50,1
1731506972121,COGS 101B,A04,737414,Allen; Michael Gordon,50,0,50,0
1731506972121,COGS 101B,A05,737415,Allen; Michael Gordon,49,0,50,1
1731506972121,COGS 101B,A06,737417,Allen; Michael Gordon,50,0,50,0
1731506973151,COGS 107A,A01,737419,Boyle; Mary E. T.,51,0,56,5
1731506973151,COGS 107A,A02,737421,Boyle; Mary E. T.,44,0,56,12
1731506973151,COGS 107A,A03,737423,Boyle; Mary E. T.,43,0,56,13
1731506973151,COGS 107A,A04,737424,Boyle; Mary E. T.,49,0,56,7
1731506973151,COGS 107A,A05,737425,Boyle; Mary E. T.,50,0,56,6
1731506973151,COGS 107A,A06,737426,Boyle; Mary E. T.,56,0,65,9
1731506973151,COGS 107A,A07,737429,Boyle; Mary E. T.,51,0,65,14
1731506974179,COGS 107B,A01,737431,Mooshagian; Eric Frederick,49,0,50,1
1731506974179,COGS 107B,A02,737435,Mooshagian; Eric Frederick,49,0,50,1
1731506974179,COGS 107B,A03,737436,Mooshagian; Eric Frederick,55,0,65,10
1731506974179,COGS 107B,A04,737438,Mooshagian; Eric Frederick,61,0,63,2
1731506974179,COGS 107B,A05,737439,Mooshagian; Eric Frederick,47,0,50,3
1731506974179,COGS 107B,A06,737440,Mooshagian; Eric Frederick,50,0,50,0
1731506975210,COGS 108,A01,737442,Ellis; Shannon Elizabeth,46,0,56,10
1731506975210,COGS 108,A02,737447,Ellis; Shannon Elizabeth,52,0,56,4
1731506975210,COGS 108,A03,737450,Ellis; Shannon Elizabeth,54,0,56,2
1731506975210,COGS 108,A04,737451,Ellis; Shannon Elizabeth,52,0,56,4
1731506975210,COGS 108,A05,737452,Ellis; Shannon Elizabeth,52,0,56,4
1731506975210,COGS 108,A06,737454,Ellis; Shannon Elizabeth,59,0,65,6
1731506975210,COGS 108,A07,737455,Ellis; Shannon Elizabeth,61,0,65,4
1731506975210,COGS 108,B01,737457,Ellis; Shannon Elizabeth,47,0,56,9
1731506975210,COGS 108,B02,737459,Ellis; Shannon Elizabeth,48,0,56,8
1731506975210,COGS 108,B03,737460,Ellis; Shannon Elizabeth,47,0,56,9
1731506975210,COGS 108,B04,737461,Ellis; Shannon Elizabeth,41,0,56,15
1731506975210,COGS 108,B05,737462,Ellis; Shannon Elizabeth,35,0,56,21
1731506975210,COGS 108,B06,737471,Ellis; Shannon Elizabeth,62,0,65,3
1731506975210,COGS 108,B07,737472,Ellis; Shannon Elizabeth,64,0,65,1
1731506976236,COGS 109,A01,737475,Staff,34,0,35,1
1731506976236,COGS 109,A02,737476,Staff,33,0,35,2
1731506976236,COGS 109,A03,737477,Staff,35,0,35,0
1731506976236,COGS 109,A04,737478,Staff,31,0,35,4
1731506977265,COGS 111,A01,737480,Hoffman; Drew Ellen,49,0,50,1
1731506977265,COGS 111,A02,737482,Hoffman; Drew Ellen,49,0,50,1
1731506977265,COGS 111,A03,737483,Hoffman; Drew Ellen,49,0,50,1
1731506977265,COGS 111,A04,737485,Hoffman; Drew Ellen,45,0,50,5
1731506978294,COGS 115,A01,737487,Deak; Gedeon O.,52,0,60,8
1731506979324,COGS 116,A01,737490,Greene; Deanna Jacquelyn,42,0,49,7
1731506979324,COGS 116,A02,737491,Greene; Deanna Jacquelyn,45,0,49,4
1731506980354,COGS 118C,A01,737493,Mukamel; Eran A,47,0,75,28
1731506981385,COGS 120,A01,737503,Xia; Haijun,44,0,50,6
1731506981385,COGS 120,A02,737763,Xia; Haijun,40,0,50,10
1731506981385,COGS 120,A03,737765,Xia; Haijun,50,0,50,0
1731506981385,COGS 120,A04,737766,Xia; Haijun,44,0,50,6
1731506981385,COGS 120,A05,737775,Xia; Haijun,50,0,50,0
1731506981385,COGS 120,A06,737781,Xia; Haijun,37,0,50,13
1731506982411,COGS 122,A01,737787,Dow; Steven P,0,0,0,5
1731506983442,COGS 126,A01,737795,Hollan; James D.,47,0,50,3
1731506984467,COGS 127,A01,737801,Guo; Philip J,46,0,50,4
1731506984467,COGS 127,A02,737805,Guo; Philip J,41,0,50,9
1731506984467,COGS 127,A03,737806,Guo; Philip J,44,0,50,6
1731506984467,COGS 127,A04,737811,Guo; Philip J,40,0,50,10
1731506984467,COGS 127,A05,737818,Guo; Philip J,3,0,50,47
1731506985497,COGS 144,A01,737824,Rossano; Federico,48,0,50,2
1731506986528,COGS 153,A00,737829,Staff,138,0,149,11
1731506987558,COGS 155,A01,737836,Cooperrider; Kensy A,48,0,50,2
1731506988584,COGS 156,A01,737841,Creel; Sarah,69,0,75,6
1731506989617,COGS 160,A00,737849,Kirsh; David Joel,25,0,25,0
1731506989617,COGS 160,B00,796034,Beatty-Martinez; Anne,74,0,75,1
1731506989617,COGS 160,C00,796035,Staff,149,0,149,0
1731506990643,COGS 164,A01,737961,Chiba; Andrea,40,0,45,5
1731506990643,COGS 164,A02,796040,Chiba; Andrea,28,0,45,17
1731506991670,COGS 177,A00,737964,Staff,110,0,120,10
1731506992700,COGS 181,A01,796038,Tu; Zhuowen,37,0,50,13
1731506992700,COGS 181,A02,796039,Tu; Zhuowen,31,0,50,19
1731506993726,COGS 187B,A01,737972,Kirsh; David Joel,47,0,50,3
1731506993726,COGS 187B,A02,738380,Kirsh; David Joel,17,0,50,33
1731506994752,COGS 188,A01,738029,Fleischer; Jason G,39,0,60,21
1731506994752,COGS 188,A02,738030,Fleischer; Jason G,56,0,60,4
1731506995780,COGS 189,A00,738031,De Sa; Virginia,165,0,200,35
1731506996820,COGS 190B,:00,796056,Staff,20,0,20,0
1731506996820,COGS 190B,A00,738176,Chiba; Andrea,9999,0,9999,0
1731506996820,COGS 190B,B00,738177,Fleischer; Jason G,20,0,20,0
1731506996820,COGS 190B,C00,738258,Hoffman; Drew Ellen,20,0,20,0
1731506996820,COGS 190B,D00,738259,Voytek; Bradley Thomas,20,0,20,0
1731506996820,COGS 190B,E00,738272,Kirsh; David Joel,20,0,20,0
1731506996820,COGS 190B,F00,738287,Kiyonaga; Anastasia,20,0,20,0
1731506996820,COGS 190B,G00,796051,Beatty-Martinez; Anne,20,0,20,0
1731506996820,COGS 190B,H00,796052,Nitz; Douglas A.,20,0,20,0
1731506996820,COGS 190B,I00,796053,De Sa; Virginia,20,0,20,0
1731506996820,COGS 190B,J00,796054,Rangel; Lara M,20,0,20,0
1731506996820,COGS 190B,K00,796055,Boyle; Mary E. T.,20,0,20,0
1731506996820,COGS 190B,L00,796058,Jernigan; Terry Lynne,20,0,20,0
1731506996820,COGS 190B,M00,796059,Deak; Gedeon O.,20,0,20,0
1731506996820,COGS 190B,N00,796060,Tu; Zhuowen,20,0,20,0
1731506996820,COGS 190B,O00,796061,Creel; Sarah,20,0,20,0
1731506997846,COGS 194,A00,738288,Hill; Seth J,9999,0,9999,0
1731506998875,COGS 198,001,738361,Voytek; Bradley Thomas,20,0,20,0
1731506999904,COGS 205,A00,738365,Chiba; Andrea,17,0,20,3
1731507000936,COGS 210B,001,736818,Nitz; Douglas A.,9998,0,9999,1
1731507000936,COGS 210B,002,736819,Xia; Haijun,9999,0,9999,0
1731507000936,COGS 210B,003,736820,Bergen; Benjamin,9998,0,9999,1
1731507000936,COGS 210B,004,736822,Kirsh; David Joel,9999,0,9999,0
1731507000936,COGS 210B,005,736824,Rangel; Lara M,9998,0,9999,1
1731507000936,COGS 210B,006,736825,Rossano; Federico,9999,0,9999,0
1731507000936,COGS 210B,007,736826,Guo; Philip J,9999,0,9999,0
1731507000936,COGS 210B,008,736829,De Sa; Virginia,9999,0,9999,0
1731507000936,COGS 210B,009,796069,Greene; Deanna Jacquelyn,9999,0,9999,0
1731507000936,COGS 210B,010,796070,Hollan; James D.,9999,0,9999,0
1731507000936,COGS 210B,011,796071,Kiyonaga; Anastasia,9999,0,9999,0
1731507000936,COGS 210B,012,796073,Coulson; Seana M,9999,0,9999,0
1731507000936,COGS 210B,013,796074,Dow; Steven P,9999,0,9999,0
1731507001971,COGS 211B,A00,736830,Coulson; Seana M,17,0,20,3
1731507003000,COGS 219,A01,736835,Zettersten; Martin,0,0,0,17
1731507004028,COGS 223,A00,736836,Dow; Steven P,18,0,25,7
1731507005057,COGS 229,A00,736842,Vaccaro; Kristen Marie,9,0,10,1
1731507006087,COGS 260,A00,736843,Kiyonaga; Anastasia,16,0,25,9
1731507007116,COMM 10,A01,738505,Armenta; John E,21,0,25,4
1731507007116,COMM 10,A02,738683,Armenta; John E,21,0,25,4
1731507007116,COMM 10,A03,738685,Armenta; John E,18,0,25,7
1731507007116,COMM 10,A04,738686,Armenta; John E,23,0,25,2
1731507007116,COMM 10,A05,738687,Armenta; John E,23,0,25,2
1731507007116,COMM 10,A06,738688,Armenta; John E,23,0,25,2
1731507007116,COMM 10,A07,738689,Armenta; John E,25,0,25,0
1731507007116,COMM 10,A08,738690,Armenta; John E,25,0,25,0
1731507007116,COMM 10,A09,738691,Armenta; John E,25,0,25,0
1731507007116,COMM 10,A10,738693,Armenta; John E,25,0,25,0
1731507007116,COMM 10,A11,738694,Armenta; John E,25,0,25,0
1731507007116,COMM 10,A12,738695,Armenta; John E,24,0,25,1
1731507008142,COMM 20,A01,738704,McKenna; Denise,73,0,75,2
1731507009169,COMM 30,A00,738705,Schmidt; Thomas Rainer,72,0,75,3
1731507010198,COMM 50,A00,738706,Armenta; John E,24,0,25,1
1731507011228,COMM 80,A01,738710,Campbell; Robert Harold,79,0,80,1
1731507012254,COMM 87,A00,795241,Serlin; David,20,0,20,0
1731507013286,COMM 100C,A01,738712,Dewaard; Andrew Michael,22,0,25,3
1731507013286,COMM 100C,A02,738713,Dewaard; Andrew Michael,25,0,25,0
1731507013286,COMM 100C,A03,738714,Dewaard; Andrew Michael,22,0,25,3
1731507013286,COMM 100C,A04,738715,Dewaard; Andrew Michael,21,0,25,4
1731507013286,COMM 100C,A05,738716,Dewaard; Andrew Michael,24,0,25,1
1731507013286,COMM 100C,A06,738718,Dewaard; Andrew Michael,23,0,25,2
1731507013286,COMM 100C,A07,738720,Dewaard; Andrew Michael,24,0,25,1
1731507013286,COMM 100C,A09,738724,Dewaard; Andrew Michael,24,0,25,1
1731507013286,COMM 100C,A11,738726,Dewaard; Andrew Michael,24,0,25,1
1731507013286,COMM 100C,A12,738727,Dewaard; Andrew Michael,24,0,25,1
1731507014312,COMM 101,A01,738730,Ahn; Patricia Jeehyun,14,0,15,1
1731507014312,COMM 101,A02,738731,Ahn; Patricia Jeehyun,15,0,15,0
1731507014312,COMM 101,A03,738732,Ahn; Patricia Jeehyun,12,0,15,3
1731507014312,COMM 101,A04,738733,Ahn; Patricia Jeehyun,13,0,15,2
1731507015339,COMM 101D,A00,738737,Martinico; Daniel J,16,0,16,0
1731507016365,COMM 101K,A00,738743,Ahn; Patricia Jeehyun,13,0,16,3
1731507017396,COMM 101N,A00,738746,Martinico; Daniel J,16,0,16,0
1731507018434,COMM 101T,A00,738749,Halm; Gavin Patrick,14,0,18,4
1731507018434,COMM 101T,B00,738752,Halm; Gavin Patrick,18,0,18,0
1731507018434,COMM 101T,C00,795163,Dewey; Matthew D,10,0,10,0
1731507019459,COMM 102B,A01,738754,Peacher; Amanda M,8,0,9,1
1731507019459,COMM 102B,A02,738755,Peacher; Amanda M,9,0,9,0
1731507020486,COMM 102C,A01,738757,Campion; Camille E,3,0,6,3
1731507020486,COMM 102C,A02,738758,Campion; Camille E,6,0,6,0
1731507020486,COMM 102C,A03,738759,Campion; Camille E,6,0,6,0
1731507021518,COMM 103D,A00,799575,Davis; Zeinabu I.,30,0,30,0
1731507022548,COMM 103E,A00,738763,Dewey; Matthew D,29,0,30,1
1731507023574,COMM 106,A00,738764,Kidman; Shawna F,138,0,140,2
1731507024604,COMM 106M,A00,738765,Whitworth-Smith; Andrew C,67,0,75,8
1731507025632,COMM 106N,A00,738766,Schmidt; Thomas Rainer,21,0,30,9
1731507026661,COMM 107,A00,738767,Serlin; David,30,0,30,0
1731507027690,COMM 111A,A00,738769,Pavon Aramburu; Maria Laur,29,0,30,1
1731507028717,COMM 111B,A00,738770,Zilberg; Elana,38,0,40,2
1731507029748,COMM 111P,A00,738771,Ruskiewicz; Eva Marie,29,0,30,1
1731507030782,COMM 113T,A00,738774,Abuelhiga; Soraya Jill,28,0,30,2
1731507030782,COMM 113T,B00,738775,Fields; Gary,30,0,30,0
1731507030782,COMM 113T,C00,738776,McKenna; Denise,29,0,30,1
1731507031809,COMM 114I,A00,738780,Leuning; Grant Maurstad,30,0,30,0
1731507032835,COMM 114T,A00,738781,Walkover; Lillian B,29,0,30,1
1731507033865,COMM 120M,A00,738783,Lazitski Torres; Olga,30,0,30,0
1731507034892,COMM 124A,A00,738784,Irani; Lilly C,73,0,75,2
1731507035919,COMM 134,A00,738785,Kidman; Shawna F,29,0,30,1
1731507037972,COMM 138,A00,738786,Boateng; Boatema,30,0,30,0
1731507039000,COMM 145,A00,738788,Rojo Solis; Juan Jose,29,0,30,1
1731507040032,COMM 146,A00,738789,Ybarra; Megan,28,0,30,2
1731507041060,COMM 156,A00,738791,Staff,30,0,30,0
1731507042085,COMM 159,A00,738792,Cordoba Azcarate; Matilde,23,0,30,7
1731507043109,COMM 164,A00,738793,Dominguez Rubio; Fernando,25,0,25,0
1731507044136,COMM 177,A00,795164,Rojo Solis; Juan Jose,25,0,25,0
1731507045167,COMM 190,A00,738795,Boateng; Boatema,23,0,23,0
1731507045167,COMM 190,B00,738797,Staff,19,0,23,4
1731507045167,COMM 190,C00,738798,Wiering; Liesbeth,21,0,23,2
1731507046197,COMM 194,A00,770727,Hill; Seth J,9999,0,9999,0
1731507047280,COMM 196B,A00,738800,Dewaard; Andrew Michael,10,0,10,0
1731507048322,CSE 8A,A50,738815,Alvarado; Christine J.,39,0,40,1
1731507048322,CSE 8A,A51,738819,Alvarado; Christine J.,40,0,40,0
1731507048322,CSE 8A,A52,738823,Alvarado; Christine J.,40,0,40,0
1731507048322,CSE 8A,A53,738825,Alvarado; Christine J.,35,0,40,5
1731507048322,CSE 8A,A54,738826,Alvarado; Christine J.,37,0,40,3
1731507048322,CSE 8A,A55,799488,Alvarado; Christine J.,0,0,0,0
1731507049356,CSE 8B,A01,788635,Ochoa; Benjamin Lawrence,59,0,70,11
1731507050389,CSE 11,A01,788660,Cao; Yingjun,161,0,175,14
1731507051418,CSE 12,A01,788668,Cao; Yingjun,25,0,50,25
1731507052445,CSE 20,A01,786527,Jones; Miles E,18,0,25,7
1731507052445,CSE 20,A02,786528,Jones; Miles E,19,0,25,6
1731507053472,CSE 21,A01,786539,Jones; Miles E,46,0,50,4
1731507053472,CSE 21,A02,786540,Jones; Miles E,49,0,50,1
1731507054502,CSE 29,A50,738835,Soosai Raj; Adalbert Geral,0,0,5,5
1731507054502,CSE 29,A51,738840,Soosai Raj; Adalbert Geral,4,0,5,1
1731507054502,CSE 29,A52,738842,Soosai Raj; Adalbert Geral,3,0,5,2
1731507054502,CSE 29,A53,738844,Soosai Raj; Adalbert Geral,4,0,4,0
1731507054502,CSE 29,B50,738846,Soosai Raj; Adalbert Geral,0,0,5,5
1731507054502,CSE 29,B51,738847,Soosai Raj; Adalbert Geral,0,0,5,5
1731507054502,CSE 29,B52,738848,Soosai Raj; Adalbert Geral,1,0,5,4
1731507054502,CSE 29,B53,738849,Soosai Raj; Adalbert Geral,3,0,4,1
1731507055533,CSE 30,A01,788669,Chin; Bryan W.,42,0,50,8
1731507056561,CSE 87,A00,738901,Moshiri; Niema,19,0,20,1
1731507056561,CSE 87,B00,739036,Cottrell; Garrison W,20,0,20,0
1731507057589,CSE 95,A00,739094,Minnes Kemp; Mor Mia,100,0,100,0
1731507058619,CSE 100,A01,788682,Moshiri; Niema,21,0,50,29
1731507059648,CSE 100R,A01,739414,Moshiri; Niema,25,0,50,25
1731507060678,CSE 101,A01,788685,Saha; Barna,0,0,20,20
1731507060678,CSE 101,B01,788713,Saha; Barna,0,0,20,20
1731507061705,CSE 105,A01,786574,Minnes Kemp; Mor Mia,113,0,150,37
1731507062739,CSE 107,A01,786529,Heninger; Nadia A,136,0,146,10
1731507063768,CSE 110,A50,739705,Griswold; William G.,58,0,75,17
1731507063768,CSE 110,A51,739706,Griswold; William G.,74,0,75,1
1731507063768,CSE 110,A52,739707,Griswold; William G.,70,0,75,5
1731507064800,CSE 120,A01,786531,Pasquale; Joseph,88,0,146,58
1731507065833,CSE 122,A01,739739,Pannuto; Patrick William,0,0,25,25
1731507066861,CSE 127,A01,788718,Munyaka; Imani N. S.,174,0,192,18
1731507067887,CSE 130,A01,788720,Jhala; Ranjit,172,0,192,20
1731507068918,CSE 132A,A01,788721,Vianu; Victor Dan,163,0,196,33
1731507069951,CSE 134B,A01,788723,Powell; Thomas Allan,172,0,192,20
1731507070979,CSE 140,A01,786577,Rosing; Tajana Simunic,274,0,300,26
1731507072011,CSE 140L,A01,739761,Eldon; John,148,0,196,48
1731507073041,CSE 142,A01,788724,Swanson; Steven James,179,0,196,17
1731507074068,CSE 147,A00,739766,Rosing; Tajana Simunic,0,0,60,60
1731507075096,CSE 148,A01,785688,Tullsen; Dean Michael,13,0,20,7
1731507076128,CSE 150A,A01,788727,Solares; Edwin A,182,0,196,14
1731507077155,CSE 151A,A01,788728,Shang; Jingbo,171,0,250,79
1731507078180,CSE 151B,A01,787804,Cottrell; Garrison W,163,0,192,29
1731507079210,CSE 152A,A01,788729,Chandraker; Manmohan Krishna,163,0,192,29
1731507080244,CSE 156,A01,786532,Qin; Lianhui,133,0,146,13
1731507081276,CSE 160,A01,788730,Kastner; Ryan Charles,195,0,250,55
1731507082307,CSE 167,A01,788731,Chern; Albert Ren-Haur,176,0,192,16
1731507083336,CSE 169,A01,785224,Rotenberg; Steven Paul,0,0,0,0
1731507084364,CSE 181,A01,770733,Pevzner; Pavel Arkadjevich,31,0,35,4
1731507085401,CSE 190,A00,739790,Bandeira; Nuno Filipe Cabrita,45,0,50,5
1731507085401,CSE 190,B00,739791,Shalev; Aaron D,43,0,50,7
1731507085401,CSE 190,C00,739821,Ousterhout; Amy,36,0,50,14
1731507085401,CSE 190,D00,739834,McAuley; Julian John,189,0,196,7
1731507086429,CSE 191,A00,739839,Minnes Kemp; Mor Mia,9999,0,9999,0
1731507087454,CSE 197,001,799832,Minnes Kemp; Mor Mia,9999,0,9999,0
1731507088487,CSE 202,A00,739848,Impagliazzo; Russell,0,0,0,0
1731507089513,CSE 203B,A01,788732,Cheng; Chung Kuan,0,0,0,0
1731507090540,CSE 207A,A00,739858,Bellare; Mihir,0,0,0,0
1731507091570,CSE 209A,A00,739859,Grier; Daniel T,0,0,0,0
1731507092601,CSE 210,A00,739873,Coblenz; Michael J,0,0,0,0
1731507093629,CSE 219,A00,739901,Vaccaro; Kristen Marie,0,0,0,0
1731507094655,CSE 220,A01,796042,Staff,0,0,0,0
1731507095687,CSE 222C,A01,739906,Pannuto; Patrick William,0,0,0,0
1731507096715,CSE 227,A00,739923,Kumar; Deepak,0,0,0,0
1731507097747,CSE 229A,A00,739925,Zhang; Yiying,0,0,0,0
1731507098777,CSE 230,A00,740210,Jhala; Ranjit,0,0,0,0
1731507099805,CSE 232B,A00,740214,Deutsch; Alin Bernard,0,0,0,0
1731507100837,CSE 234,A01,788733,Zhang; Hao,0,0,0,0
1731507101863,CSE 237A,A00,740218,Rosing; Tajana Simunic,0,0,0,0
1731507102889,CSE 239A,A00,740222,Deutsch; Alin Bernard,0,0,0,0
1731507103914,CSE 240A,A00,740228,Tullsen; Dean Michael,0,0,0,0
1731507104941,CSE 240B,A00,740234,Zhao; Jishen,0,0,0,0
1731507105968,CSE 244A,A00,740240,Orailoglu; Alex,0,0,0,0
1731507106995,CSE 251A,A01,788735,Berg-Kirkpatrick; Taylor D,0,0,0,0
1731507108021,CSE 251B,A01,787805,Cottrell; Garrison W,0,0,0,0
1731507109052,CSE 251C,A01,785687,Dasgupta; Sanjoy,0,0,0,0
1731507110079,CSE 252A,A00,740250,Ochoa; Benjamin Lawrence,0,0,0,0
1731507111109,CSE 257,A01,788739,Gao; Sicun,0,0,0,0
1731507112136,CSE 272,A00,740254,Li; Tzumao,0,0,0,0
1731507113167,CSE 280A,A00,740297,Bafna; Vineet,0,0,0,0
1731507114192,CSE 282,A00,740308,Pevzner; Pavel Arkadjevich,0,0,0,0
1731507115219,CSE 290,A00,740312,Chandraker; Manmohan Krishna,0,0,0,0
1731507115219,CSE 290,C00,740327,Christensen; Henrik I,0,0,0,0
1731507115219,CSE 290,D00,740402,Pevzner; Pavel Arkadjevich,0,0,0,0
1731507115219,CSE 290,E00,740403,Munyaka; Imani N. S.,0,0,0,0
1731507115219,CSE 290,G00,740411,Qin; Lianhui,0,0,0,0
1731507115219,CSE 290,H00,740413,Shalev; Aaron D,0,0,0,0
1731507115219,CSE 290,I00,796145,Lovett; Shachar,0,0,0,0
1731507115219,CSE 290,J00,796174,Yu; Qi,0,0,0,0
1731507115219,CSE 290,B00,740325,Orailoglu; Alex,0,0,0,0
1731507116252,CSE 291,A00,740416,Liu; Qipeng,0,0,0,0
1731507116252,CSE 291,B00,740420,Pasquale; Joseph,0,0,0,0
1731507116252,CSE 291,C00,740421,Savage; Stefan & Voelker; Geoffrey M.,0,0,0,0
1731507116252,CSE 291,D00,740441,Ding; Yufei,0,0,0,0
1731507116252,CSE 291,E00,740442,Vaccaro; Kristen Marie,0,0,0,0
1731507116252,CSE 291,F00,740443,Fernandes; Earlence T,0,0,0,0
1731507116252,CSE 291,G00,740447,Paturi; Ramamohan,0,0,0,0
1731507116252,CSE 291,H00,740448,Prithviraj; Ammanabrolu,0,0,0,0
1731507116252,CSE 291,I00,740468,Zhang; Yiying,0,0,0,0
1731507116252,CSE 291,J00,740469,McAuley; Julian John,0,0,0,0
1731507117293,CSE 293,001,796628,Bafna; Vineet,9999,0,9999,0
1731507117293,CSE 293,002,796638,Bellare; Mihir,9999,0,9999,0
1731507117293,CSE 293,003,796645,Berg-Kirkpatrick; Taylor D,9999,0,9999,0
1731507117293,CSE 293,004,796646,Chandraker; Manmohan Krishna,9999,0,9999,0
1731507117293,CSE 293,005,796647,Cheng; Chung Kuan,9999,0,9999,0
1731507117293,CSE 293,006,796648,Christensen; Henrik I,9998,0,9999,1
1731507117293,CSE 293,007,796649,Coblenz; Michael J,9999,0,9999,0
1731507117293,CSE 293,008,796650,Cottrell; Garrison W,9999,0,9999,0
1731507117293,CSE 293,009,796651,Deutsch; Alin Bernard,9999,0,9999,0
1731507117293,CSE 293,010,796652,Esmaeilzadeh; Hadi,9999,0,9999,0
1731507117293,CSE 293,011,796653,Freund; Yoav,9999,0,9999,0
1731507117293,CSE 293,012,796654,Griswold; William G.,9999,0,9999,0
1731507117293,CSE 293,013,796655,Gymrek; Melissa Ann,9999,0,9999,0
1731507117293,CSE 293,014,796656,Heninger; Nadia A,9999,0,9999,0
1731507117293,CSE 293,015,796657,Impagliazzo; Russell,9999,0,9999,0
1731507117293,CSE 293,016,796658,Jhala; Ranjit,9999,0,9999,0
1731507117293,CSE 293,017,796659,Kahng; Andrew Byun,9999,0,9999,0
1731507117293,CSE 293,018,796660,Kane; Daniel Mertz,9999,0,9999,0
1731507117293,CSE 293,019,796661,Kriegman; David J,9999,0,9999,0
1731507117293,CSE 293,020,796662,Kumar; Arun Kumar,9999,0,9999,0
1731507117293,CSE 293,021,796663,Lerner; Sorin,9999,0,9999,0
1731507117293,CSE 293,022,796664,Lovett; Shachar,9999,0,9999,0
1731507117293,CSE 293,023,796665,McAuley; Julian John,9998,0,9999,1
1731507117293,CSE 293,024,796666,Micciancio; Daniele,9999,0,9999,0
1731507117293,CSE 293,025,796667,Orailoglu; Alex,9999,0,9999,0
1731507117293,CSE 293,026,796668,Pannuto; Patrick William,9999,0,9999,0
1731507117293,CSE 293,027,796669,Paturi; Ramamohan,9999,0,9999,0
1731507117293,CSE 293,028,796670,Polikarpova; Nadezhda,9999,0,9999,0
1731507117293,CSE 293,029,796671,Politz; Joseph Gibbs,9999,0,9999,0
1731507117293,CSE 293,030,796672,Porter; George M,9998,0,9999,1
1731507117293,CSE 293,031,796673,Porter; Leonard Emerson,9999,0,9999,0
1731507117293,CSE 293,032,796674,Ramamoorthi; Ravi,9999,0,9999,0
1731507117293,CSE 293,033,796675,Riek; Laurel D,9999,0,9999,0
1731507117293,CSE 293,034,796676,Sahoo; Debashis,9999,0,9999,0
1731507117293,CSE 293,035,796677,Saul; Lawrence,9999,0,9999,0
1731507117293,CSE 293,036,796678,Savage; Stefan,9999,0,9999,0
1731507117293,CSE 293,037,796679,Schulze; Jurgen P.,9999,0,9999,0
1731507117293,CSE 293,038,796680,Snoeren; Alex C.,9999,0,9999,0
1731507117293,CSE 293,039,796681,Shang; Jingbo,9997,0,9999,2
1731507117293,CSE 293,040,796682,Stefan; Deian,9999,0,9999,0
1731507117293,CSE 293,041,796683,Su; Hao,9999,0,9999,0
1731507117293,CSE 293,042,796684,Swanson; Steven James,9999,0,9999,0
1731507117293,CSE 293,043,796685,Tullsen; Dean Michael,9999,0,9999,0
1731507117293,CSE 293,044,796686,Vaccaro; Kristen Marie,9999,0,9999,0
1731507117293,CSE 293,045,796687,Voelker; Geoffrey M.,9999,0,9999,0
1731507117293,CSE 293,046,796688,Zhao; Jishen,9999,0,9999,0
1731507117293,CSE 293,047,796689,Zhou; Yuan-Yuan,9999,0,9999,0
1731507117293,CSE 293,048,796690,Gao; Sicun,9999,0,9999,0
1731507117293,CSE 293,049,796691,Weibel; Nadir,9998,0,9999,1
1731507117293,CSE 293,050,796692,Gupta; Rajesh K.,9999,0,9999,0
1731507117293,CSE 293,051,796693,Soosai Raj; Adalbert Geral,9999,0,9999,0
1731507117293,CSE 293,052,800753,Wang; Xiaolong,9999,0,9999,0
1731507118320,CSE 294,A00,740471,Snoeren; Alex C.,0,0,0,0
1731507119354,CSS 2,A01,785225,Mignozzetti; Umberto,42,0,45,3
1731507119354,CSS 2,A02,785226,Mignozzetti; Umberto,42,0,45,3
1731507120381,CSS 205,A00,738810,Ahlquist; John S.,4,0,24,20
1731507121405,CSS 209,A00,738811,Mignozzetti; Umberto,17,0,40,23
1731507122436,CSS 296,001,796149,Mignozzetti; Umberto,0,0,0,5
1731507122436,CSS 296,002,796150,Mignozzetti; Umberto,0,0,0,2
1731507122436,CSS 296,003,796157,Leas; Eric Craig,0,0,0,0
1731507122436,CSS 296,004,796158,Okonkwo; Holly,0,0,0,1
1731507122436,CSS 296,005,796159,Fleischer; Jason G,0,0,0,1
1731507122436,CSS 296,006,796162,Creel; Sarah,0,0,0,1
1731507122436,CSS 296,007,796165,Patel; Hemal,0,0,0,1
1731507122436,CSS 296,008,796168,Martin; Isaac,0,0,0,1
1731507122436,CSS 296,009,796169,Styler; William Francis,0,0,0,1
1731507122436,CSS 296,010,796171,Grigoryan; Aram,0,0,0,3
1731507122436,CSS 296,011,796172,Bonjour; Trevor,0,0,0,1
1731507122436,CSS 296,012,796173,Martin; Isaac,0,0,0,0
1731507123469,DDPM 204,A00,742646,Ma; Joseph David,30,0,35,5
1731507124496,DDPM 208,A00,742647,Ma; Joseph David,30,0,35,5
1731507125521,DDPM 213,A00,742648,Cuomo; Raphael Eduardo,30,0,35,5
1731507126550,DERM 296,001,791572,Hightower; George Kimet,9,0,10,1
1731507126550,DERM 296,002,791573,Eichenfield; Dawn Zhang,9,0,10,1
1731507126550,DERM 296,003,791575,Staff,10,0,10,0
1731507127595,DOC 2,A01,741984,Strom; Megan C.,0,0,0,0
1731507127595,DOC 2,A02,741987,Strom; Megan C.,0,0,0,0
1731507127595,DOC 2,A03,741989,Strom; Megan C.,0,0,0,0
1731507127595,DOC 2,A04,741990,Strom; Megan C.,0,0,0,0
1731507127595,DOC 2,A05,741993,Strom; Megan C.,0,0,0,0
1731507127595,DOC 2,A06,741994,Strom; Megan C.,0,0,0,0
1731507127595,DOC 2,A07,741995,Strom; Megan C.,0,0,0,0
1731507127595,DOC 2,A08,741996,Strom; Megan C.,0,0,0,0
1731507127595,DOC 2,A09,741999,Strom; Megan C.,0,0,0,0
1731507127595,DOC 2,A10,742000,Strom; Megan C.,0,0,0,0
1731507127595,DOC 2,A11,742002,Strom; Megan C.,0,0,0,0
1731507127595,DOC 2,A12,742005,Strom; Megan C.,0,0,0,0
1731507127595,DOC 2,A13,742007,Strom; Megan C.,0,0,0,0
1731507127595,DOC 2,A14,742009,Strom; Megan C.,0,0,0,0
1731507127595,DOC 2,A15,742010,Strom; Megan C.,0,0,0,0
1731507127595,DOC 2,A16,742153,Strom; Megan C.,0,0,0,0
1731507127595,DOC 2,B01,742170,Strom; Megan C.,0,0,0,0
1731507127595,DOC 2,B02,742175,Strom; Megan C.,0,0,0,0
1731507127595,DOC 2,B03,742192,Strom; Megan C.,0,0,0,0
1731507127595,DOC 2,B04,742193,Strom; Megan C.,0,0,0,0
1731507127595,DOC 2,B05,742197,Strom; Megan C.,0,0,0,0
1731507127595,DOC 2,B06,742198,Strom; Megan C.,0,0,0,0
1731507127595,DOC 2,B07,742201,Strom; Megan C.,0,0,0,0
1731507127595,DOC 2,B08,742204,Strom; Megan C.,0,0,0,0
1731507127595,DOC 2,B09,742206,Strom; Megan C.,0,0,0,0
1731507127595,DOC 2,B10,742211,Strom; Megan C.,0,0,0,0
1731507127595,DOC 2,B11,742214,Strom; Megan C.,0,0,0,0
1731507127595,DOC 2,B12,742215,Strom; Megan C.,0,0,0,0
1731507127595,DOC 2,B13,742224,Strom; Megan C.,0,0,0,0
1731507127595,DOC 2,B14,742230,Strom; Megan C.,0,0,0,0
1731507127595,DOC 2,B15,742290,Strom; Megan C.,0,0,0,0
1731507127595,DOC 2,B16,742292,Strom; Megan C.,0,0,0,0
1731507127595,DOC 2,C01,742295,Solomon; Amanda Lee Albaniel,0,0,0,0
1731507127595,DOC 2,C02,742296,Solomon; Amanda Lee Albaniel,0,0,0,0
1731507127595,DOC 2,C03,742297,Solomon; Amanda Lee Albaniel,0,0,0,0
1731507127595,DOC 2,C04,742303,Solomon; Amanda Lee Albaniel,0,0,0,0
1731507127595,DOC 2,C05,742304,Solomon; Amanda Lee Albaniel,0,0,0,0
1731507127595,DOC 2,C06,742306,Solomon; Amanda Lee Albaniel,0,0,0,0
1731507127595,DOC 2,C07,742309,Solomon; Amanda Lee Albaniel,0,0,0,0
1731507127595,DOC 2,C08,742310,Solomon; Amanda Lee Albaniel,0,0,0,0
1731507127595,DOC 2,C09,742352,Solomon; Amanda Lee Albaniel,0,0,0,0
1731507127595,DOC 2,C10,742363,Solomon; Amanda Lee Albaniel,0,0,0,0
1731507127595,DOC 2,C11,742372,Solomon; Amanda Lee Albaniel,0,0,0,0
1731507127595,DOC 2,C12,742381,Solomon; Amanda Lee Albaniel,0,0,0,0
1731507127595,DOC 2,C13,742382,Solomon; Amanda Lee Albaniel,0,0,0,0
1731507127595,DOC 2,C14,742383,Solomon; Amanda Lee Albaniel,0,0,0,0
1731507127595,DOC 2,C15,798384,Solomon; Amanda Lee Albaniel,0,0,0,0
1731507127595,DOC 2,C16,798386,Solomon; Amanda Lee Albaniel,0,0,0,0
1731507127595,DOC 2,D01,742489,Villegas; Karen Eliza,0,0,0,0
1731507127595,DOC 2,D02,742493,Villegas; Karen Eliza,0,0,0,0
1731507127595,DOC 2,D03,742551,Villegas; Karen Eliza,0,0,0,0
1731507127595,DOC 2,D04,742552,Villegas; Karen Eliza,0,0,0,0
1731507127595,DOC 2,D05,742553,Villegas; Karen Eliza,0,0,0,0
1731507127595,DOC 2,D06,742556,Villegas; Karen Eliza,0,0,0,0
1731507127595,DOC 2,D07,742559,Villegas; Karen Eliza,0,0,0,0
1731507127595,DOC 2,D08,742560,Villegas; Karen Eliza,0,0,0,0
1731507127595,DOC 2,D09,742608,Villegas; Karen Eliza,0,0,0,0
1731507127595,DOC 2,D10,742635,Villegas; Karen Eliza,0,0,0,0
1731507127595,DOC 2,D11,742636,Villegas; Karen Eliza,0,0,0,0
1731507127595,DOC 2,D12,742637,Villegas; Karen Eliza,0,0,0,0
1731507127595,DOC 2,D13,742638,Villegas; Karen Eliza,0,0,0,0
1731507127595,DOC 2,D14,742639,Villegas; Karen Eliza,0,0,0,0
1731507127595,DOC 2,D15,742640,Villegas; Karen Eliza,0,0,0,0
1731507127595,DOC 2,D16,742641,Villegas; Karen Eliza,0,0,0,0
1731507127595,DOC 2,D17,742642,Villegas; Karen Eliza,0,0,0,0
1731507128620,DOC 100D,A00,742643,Pass; Natalye,25,0,25,0
1731507128620,DOC 100D,B00,742644,Pass; Natalye,24,0,25,1
1731507129656,DSC 10,A01,741312,Tiefenbruck; Janine LoBue,136,0,145,9
1731507129656,DSC 10,B01,741322,Tiefenbruck; Janine LoBue,143,0,145,2
1731507130683,DSC 20,A01,741392,Langlois; Marina,192,0,192,0
1731507130683,DSC 20,B01,741530,Langlois; Marina,192,0,192,0
1731507131710,DSC 30,A01,741532,Liao; Soohyun Nam,70,0,70,0
1731507131710,DSC 30,B01,741538,Liao; Soohyun Nam,69,0,70,1
1731507132738,DSC 40A,A01,741544,Shannon; Kyle Michael,187,0,192,5
1731507133765,DSC 40B,A01,741549,Wang; Yusu,143,0,145,2
1731507134791,DSC 80,A01,741553,Watson-Parris; Duncan,149,0,149,0
1731507135820,DSC 95,A01,741617,Langlois; Marina,35,0,35,0
1731507136846,DSC 96,A00,741618,Quer; Giorgio,39,0,40,1
1731507137876,DSC 100,A01,741627,Salimi; Babak,141,0,145,4
1731507138909,DSC 106,A01,741636,Lau; Samuel Ethan,144,0,146,2
1731507138909,DSC 106,B01,741638,Lau; Samuel Ethan,144,0,146,2
1731507139941,DSC 140A,A01,741642,Eldridge; Justin Matthew,136,0,145,9
1731507139941,DSC 140A,B01,741646,Eldridge; Justin Matthew,143,0,145,2
1731507140967,DSC 140B,A01,741682,Huang; Biwei,137,0,145,8
1731507141996,DSC 148,A01,794521,Shang; Jingbo,122,0,125,3
1731507143031,DSC 170,A01,741684,Zaslavsky; Ilya,28,0,40,12
1731507144066,DSC 180B,A01,741686,Bellur; Umesh,8,0,8,0
1731507144066,DSC 180B,A02,741687,Bellur; Umesh,4,0,4,0
1731507144066,DSC 180B,A03,741688,Bellur; Umesh,8,0,8,0
1731507144066,DSC 180B,A04,741707,Bellur; Umesh,6,0,6,0
1731507144066,DSC 180B,A05,741708,Bellur; Umesh,6,0,6,0
1731507144066,DSC 180B,A06,741709,Bellur; Umesh,8,0,8,0
1731507144066,DSC 180B,A07,741710,Bellur; Umesh,6,0,6,0
1731507144066,DSC 180B,A08,741711,Bellur; Umesh,4,0,4,0
1731507144066,DSC 180B,A09,741712,Bellur; Umesh,10,0,10,0
1731507144066,DSC 180B,A10,741713,Bellur; Umesh,10,0,10,0
1731507144066,DSC 180B,A11,741714,Bellur; Umesh,6,0,6,0
1731507144066,DSC 180B,A12,741715,Bellur; Umesh,4,0,4,0
1731507144066,DSC 180B,A13,741716,Bellur; Umesh,6,0,6,0
1731507144066,DSC 180B,A14,741717,Bellur; Umesh,6,0,6,0
1731507144066,DSC 180B,A15,741718,Bellur; Umesh,8,0,8,0
1731507144066,DSC 180B,A16,741719,Bellur; Umesh,10,0,10,0
1731507144066,DSC 180B,A17,741720,Bellur; Umesh,4,0,4,0
1731507144066,DSC 180B,B01,741724,Bellur; Umesh,8,0,8,0
1731507144066,DSC 180B,B02,741725,Bellur; Umesh,10,0,10,0
1731507144066,DSC 180B,B03,741733,Bellur; Umesh,6,0,6,0
1731507144066,DSC 180B,B04,741734,Bellur; Umesh,6,0,6,0
1731507144066,DSC 180B,B05,741736,Bellur; Umesh,4,0,4,0
1731507144066,DSC 180B,B06,741778,Bellur; Umesh,6,0,6,0
1731507144066,DSC 180B,B07,741780,Bellur; Umesh,8,0,8,0
1731507144066,DSC 180B,B08,741782,Bellur; Umesh,6,0,6,0
1731507144066,DSC 180B,B09,741785,Bellur; Umesh,6,0,6,0
1731507144066,DSC 180B,B10,741786,Bellur; Umesh,6,0,6,0
1731507144066,DSC 180B,B11,741788,Bellur; Umesh,4,0,4,0
1731507144066,DSC 180B,B12,741789,Bellur; Umesh,10,0,10,0
1731507144066,DSC 180B,B13,741791,Bellur; Umesh,6,0,6,0
1731507144066,DSC 180B,B14,741793,Bellur; Umesh,8,0,8,0
1731507144066,DSC 180B,B15,741794,Bellur; Umesh,8,0,8,0
1731507144066,DSC 180B,B16,741797,Bellur; Umesh,8,0,8,0
1731507144066,DSC 180B,B17,741855,Bellur; Umesh,4,0,4,0
1731507144066,DSC 180B,B18,741857,Bellur; Umesh,4,0,4,0
1731507145101,DSC 190,A01,741874,Silberman; Jack,19,0,20,1
1731507145101,DSC 190,B01,741877,Smarr; Benjamin,36,0,40,4
1731507145101,DSC 190,C01,741879,Mishne; Gal,18,0,20,2
1731507146126,DSC 197,001,741880,Eldridge; Justin Matthew,9999,0,9999,0
1731507147153,DSC 202,A00,741881,Gupta; Amarnath,0,0,70,70
1731507148183,DSC 206,A00,741883,Mazumdar; Arya,16,0,100,84
1731507149274,DSC 207R,A01,741885,Staff,77,0,80,3
1731507150300,DSC 208R,A01,741887,Salimi; Babak,36,0,80,44
1731507151326,DSC 211,A00,741888,Wang; Jun-Kun,16,0,70,54
1731507152353,DSC 215R,A01,741890,Staff,77,0,80,3
1731507153380,DSC 240,A00,741892,Wang; Yuxiang,33,0,100,67
1731507154407,DSC 244,A00,741893,Schwartzman; Armin,76,0,90,14
1731507155439,DSC 250,A00,741894,Hu; Zhiting,0,0,90,90
1731507156465,DSC 255R,A01,741898,Dasgupta; Sanjoy,39,0,80,41
1731507157494,DSC 266R,A01,741900,Weibel; Nadir,39,0,60,21
1731507158523,DSC 288R,A01,741902,Bellur; Umesh,38,0,60,22
1731507159559,DSC 291,A00,741904,Smarr; Benjamin,0,0,30,30
1731507159559,DSC 291,B00,741905,Freund; Yoav,47,0,60,13
1731507159559,DSC 291,C00,741906,Belkin; Mikhail,59,0,80,21
1731507159559,DSC 291,D00,741907,Li; Aobo,31,0,40,9
1731507159559,DSC 291,E00,741908,Ma; Yian,39,0,60,21
1731507159559,DSC 291,F00,794449,Jin; Haojian,55,0,60,5
1731507159559,DSC 291,G00,797963,Mishne; Gal,0,0,20,20
1731507159559,DSC 291,H00,797964,Zhang; Hao,32,0,80,48
1731507160585,DSC 293,A00,741911,Ustun; Tevfik Berk,9990,0,9999,9
1731507161611,DSE 201,A00,741279,Deutsch; Alin Bernard,25,0,25,0
1731507162637,DSE 210,A00,741281,Staff,25,0,25,0
1731507163663,DSE 241,A00,741286,Staff,25,0,25,0
1731507164689,DSE 260A,A00,741290,Altintas De Callaf; Ilkay,25,0,25,0
1731507165715,DSGN 1,A01,737377,Meyer; Michael Wayne,47,0,50,3
1731507165715,DSGN 1,A02,737382,Meyer; Michael Wayne,35,0,50,15
1731507166742,DSGN 100,A01,736806,Rill; Bryan,24,0,25,1
1731507166742,DSGN 100,A02,736809,Rill; Bryan,24,0,25,1
1731507166742,DSGN 100,A03,736810,Rill; Bryan,23,0,25,2
1731507166742,DSGN 100,A04,736812,Rill; Bryan,18,0,25,7
1731507167768,DSGN 119,A00,736813,Vaccaro; Kristen Marie,85,0,100,15
1731507168796,DSGN 219,A00,736817,Vaccaro; Kristen Marie,14,0,15,1
1731507169827,ECE 5,A01,744925,Morris; Karcher William,22,0,26,4
1731507169827,ECE 5,A02,744926,Morris; Karcher William,23,0,26,3
1731507169827,ECE 5,A03,744927,Morris; Karcher William,26,0,26,0
1731507169827,ECE 5,A04,744929,Morris; Karcher William,26,0,26,0
1731507170854,ECE 15,A01,744931,Sahay; Rajeev,188,0,192,4
1731507171880,ECE 16,A01,744935,Khoshabeh; Ramsin,25,0,30,5
1731507172915,ECE 25,A50,744939,Morris; Karcher William,26,0,30,4
1731507172915,ECE 25,A51,744940,Morris; Karcher William,29,0,30,1
1731507172915,ECE 25,A52,744941,Morris; Karcher William,27,0,30,3
1731507172915,ECE 25,A53,744942,Morris; Karcher William,28,0,30,2
1731507172915,ECE 25,A54,744944,Morris; Karcher William,30,0,30,0
1731507173944,ECE 35,A50,744954,Schurgers; Curt,27,0,30,3
1731507173944,ECE 35,A51,744955,Schurgers; Curt,30,0,30,0
1731507173944,ECE 35,A52,745033,Schurgers; Curt,30,0,30,0
1731507173944,ECE 35,A53,745037,Schurgers; Curt,25,0,30,5
1731507173944,ECE 35,A54,745046,Schurgers; Curt,30,0,30,0
1731507173944,ECE 35,A55,745047,Schurgers; Curt,30,0,30,0
1731507174975,ECE 45,A01,745170,Heath Jr.; Robert Wendell,90,0,98,8
1731507174975,ECE 45,A02,745252,Heath Jr.; Robert Wendell,94,0,98,4
1731507176002,ECE 65,A50,745256,Baghdadchi; Saharnaz,28,0,30,2
1731507176002,ECE 65,A51,745257,Baghdadchi; Saharnaz,29,0,30,1
1731507176002,ECE 65,A52,745258,Baghdadchi; Saharnaz,26,0,30,4
1731507176002,ECE 65,A53,745259,Baghdadchi; Saharnaz,29,0,30,1
1731507176002,ECE 65,A54,745260,Baghdadchi; Saharnaz,29,0,30,1
1731507176002,ECE 65,A55,745261,Baghdadchi; Saharnaz,29,0,30,1
1731507177033,ECE 101,A01,745263,Gonzalez Prelcic; Nuria,83,0,90,7
1731507177033,ECE 101,A02,745264,Gonzalez Prelcic; Nuria,88,0,90,2
1731507178060,ECE 102,A00,745265,Le; Hanh-Phuc,91,0,100,9
1731507179088,ECE 103,A01,745273,Lo; Yu-Hwa,50,0,60,10
1731507180122,ECE 107,A01,745309,Fullerton; Eric E,93,0,100,7
1731507181149,ECE 109,A01,745315,Poveda Fonseca; Jorge,168,0,180,12
1731507182175,ECE 111,A01,745319,Eldon; John,201,0,220,19
1731507183213,ECE 115,A01,745321,Yip; Michael,22,0,28,6
1731507184241,ECE 121B,A50,745324,Esmaili; Gholamreza,11,0,12,1
1731507184241,ECE 121B,A51,745326,Esmaili; Gholamreza,12,0,12,0
1731507184241,ECE 121B,A52,745327,Esmaili; Gholamreza,9,0,12,3
1731507184241,ECE 121B,A53,745328,Esmaili; Gholamreza,12,0,12,0
1731507185270,ECE 125A,A50,745332,Le; Hanh-Phuc,9,0,12,3
1731507185270,ECE 125A,A51,745333,Le; Hanh-Phuc,11,0,12,1
1731507185270,ECE 125A,A52,745334,Le; Hanh-Phuc,9,0,12,3
1731507185270,ECE 125A,A53,745336,Le; Hanh-Phuc,11,0,12,1
1731507186295,ECE 128B,A00,745337,Esmaili; Gholamreza,70,0,75,5
1731507187323,ECE 135B,A00,745339,Dayeh; Shadi Ahmad,19,0,25,6
1731507188539,ECE 140A,A01,745345,Khoshabeh; Ramsin,0,0,0,0
1731507188539,ECE 140A,A02,745346,Khoshabeh; Ramsin,0,0,0,0
1731507188539,ECE 140A,A03,745347,Khoshabeh; Ramsin,0,0,0,0
1731507188539,ECE 140A,A04,745348,Khoshabeh; Ramsin,0,0,0,0
1731507189568,ECE 141A,A01,745351,Gessner; Richard K.,64,0,75,11
1731507190595,ECE 143,A00,745352,Unpingco; Jose H.,0,0,0,3
1731507191621,ECE 148,A01,745355,Silberman; Jack,22,0,24,2
1731507192650,ECE 158B,A01,745357,Zhang; Xinyu,19,0,25,6
1731507193675,ECE 161B,A00,745361,Nguyen; Truong Quang,62,0,65,3
1731507194703,ECE 172A,A01,745372,Parhi; Rahul,115,0,120,5
1731507195732,ECE 175A,A01,745378,Vasconcelos; Nuno,82,0,90,8
1731507196763,ECE 176,A00,745379,Wang; Xiaolong,158,0,196,38
1731507197790,ECE 181,A01,745381,Antipa; Nicholas A,18,0,25,7
1731507198815,ECE 184,A00,745382,Fainman; Yeshaiahu,10,0,15,5
1731507199846,ECE 191,A00,745387,Zhang; Xinyu,39,0,40,1
1731507200872,ECE 197,001,745394,Mercier; Patrick Philip,9999,0,9999,0
1731507201900,ECE 198,001,745395,Nguyen; Truong Quang,9999,0,9999,0
1731507201900,ECE 198,002,800722,Fullerton; Eric E,9999,0,9999,0
1731507202931,ECE 212BN,A00,745419,Ng; Tse Nga,0,0,0,0
1731507203959,ECE 222B,A00,745501,Lomakin; Vitaliy,0,0,0,0
1731507204983,ECE 226,A00,745504,Koushanfar; Farinaz,0,0,0,0
1731507206011,ECE 230B,A00,745505,Taur; Yuan,0,0,0,0
1731507207037,ECE 238A,A00,745507,Luo; Jian,0,0,0,0
1731507208066,ECE 240B,A00,745510,Rubin; Noah,0,0,0,0
1731507209096,ECE 247B,A00,745512,Wang; Joseph,0,0,0,0
1731507210123,ECE 250,A00,745515,Siegel; Paul H.,0,0,0,0
1731507211154,ECE 251A,A00,745518,Meyer; Florian,0,0,0,0
1731507212179,ECE 257B,A00,745519,Bharadia; Dinesh,0,0,0,0
1731507213209,ECE 258A,A00,745524,Milstein; Laurence B.,0,0,0,0
1731507214236,ECE 260B,A00,745525,Kang; Mingu,0,0,0,0
1731507215262,ECE 264A,A00,745526,Galton; Ian A,0,0,0,0
1731507216288,ECE 265A,A00,745530,Gudem; Prasad S.S.,0,0,0,0
1731507217316,ECE 265D,A00,745531,Gudem; Prasad S.S.,0,0,0,0
1731507218343,ECE 269,A01,745540,Pal; Piya,0,0,0,0
1731507219374,ECE 271B,A00,745541,Vasconcelos; Manuela,0,0,0,0
1731507220402,ECE 276A,A00,745543,Atanasov; Nikolay A.,0,0,0,0
1731507221429,ECE 277,A00,745544,An; Cheolhong,0,0,0,0
1731507222456,ECE 283,A00,745547,Hsueh; Tzu-Chien,0,0,0,0
1731507223486,ECE 285,A00,745548,Zheng; Yang,0,0,0,0
1731507224512,ECE 286,B00,795641,Poveda Fonseca; Jorge,0,0,0,0
1731507225540,ECON 1,A01,742650,Crane; Meredith Helen,143,0,150,7
1731507225540,ECON 1,B01,742652,Crane; Meredith Helen,149,0,150,1
1731507225540,ECON 1,C01,742655,Newhouse; Herbert S,71,0,75,4
1731507225540,ECON 1,C02,742656,Newhouse; Herbert S,75,0,75,0
1731507226567,ECON 2,A01,742660,Crane; Meredith Helen,78,0,78,0
1731507226567,ECON 2,A02,742661,Crane; Meredith Helen,80,0,80,0
1731507227602,ECON 3,A01,742663,Rondina; Giacomo,113,0,125,12
1731507227602,ECON 3,A02,742664,Rondina; Giacomo,125,0,125,0
1731507227602,ECON 3,B01,742667,Rondina; Giacomo,121,0,125,4
1731507227602,ECON 3,B02,742669,Rondina; Giacomo,125,0,125,0
1731507228632,ECON 4,A01,742672,Levkoff; Steven B.,73,0,75,2
1731507228632,ECON 4,A02,742673,Levkoff; Steven B.,71,0,75,4
1731507228632,ECON 4,A03,742674,Levkoff; Steven B.,73,0,75,2
1731507228632,ECON 4,B01,798340,Brooks; Marcus Raymond,2,0,3,1
1731507229668,ECON 5,A01,742676,Dai; Yinlin,51,0,54,3
1731507229668,ECON 5,A02,742677,Dai; Yinlin,53,0,54,1
1731507229668,ECON 5,A03,742678,Dai; Yinlin,51,0,54,3
1731507229668,ECON 5,A04,742679,Dai; Yinlin,54,0,54,0
1731507229668,ECON 5,A05,742680,Dai; Yinlin,54,0,54,0
1731507229668,ECON 5,B01,742682,Dai; Yinlin,53,0,54,1
1731507229668,ECON 5,B02,742684,Dai; Yinlin,52,0,54,2
1731507229668,ECON 5,B03,742686,Dai; Yinlin,53,0,54,1
1731507229668,ECON 5,B04,742687,Dai; Yinlin,50,0,54,4
1731507229668,ECON 5,B05,742723,Dai; Yinlin,51,0,54,3
1731507230698,ECON 86,A00,795622,Muendler; Marc,98,0,100,2
1731507231728,ECON 100A,A01,742728,Grigoryan; Aram,98,0,100,2
1731507231728,ECON 100A,A02,742730,Grigoryan; Aram,94,0,100,6
1731507231728,ECON 100A,A03,742733,Grigoryan; Aram,93,0,100,7
1731507231728,ECON 100A,A04,742735,Grigoryan; Aram,97,0,100,3
1731507232757,ECON 100B,A01,742738,Levkoff; Steven B.,90,0,96,6
1731507232757,ECON 100B,A02,742742,Levkoff; Steven B.,102,0,104,2
1731507232757,ECON 100B,A03,742744,Levkoff; Steven B.,99,0,100,1
1731507232757,ECON 100B,A04,742745,Levkoff; Steven B.,98,0,100,2
1731507233784,ECON 100C,A01,742757,Newhouse; Herbert S,100,0,100,0
1731507233784,ECON 100C,B01,742768,Newhouse; Herbert S,92,0,100,8
1731507234812,ECON 102,A01,742785,Muendler; Marc,109,0,120,11
1731507235841,ECON 105,A00,742834,Vespa; Emanuel Ignacio,97,0,100,3
1731507236868,ECON 109,A01,742838,Watson; Joel Christopher,107,0,120,13
1731507236868,ECON 109,A02,742841,Watson; Joel Christopher,118,0,120,2
1731507236868,ECON 109,A03,742843,Watson; Joel Christopher,0,0,0,0
1731507237899,ECON 109T,A00,742844,Watson; Joel Christopher,18,0,20,2
1731507238929,ECON 110A,A01,742847,Jaimovich; Nir,95,0,100,5
1731507238929,ECON 110A,B01,742852,Jaimovich; Nir,99,0,100,1
1731507239955,ECON 110B,A01,742854,Hamilton; James D.,93,0,98,5
1731507239955,ECON 110B,A02,742858,Hamilton; James D.,98,0,98,0
1731507239955,ECON 110B,B01,742861,Hamilton; James D.,90,0,98,8
1731507239955,ECON 110B,B02,742863,Hamilton; James D.,98,0,98,0
1731507240982,ECON 110BH,A00,742865,Hamilton; James D.,20,0,20,0
1731507242012,ECON 116,A00,742866,Lowes; Sara Rachel,69,0,70,1
1731507242012,ECON 116,B00,742868,Lowes; Sara Rachel,43,0,44,1
1731507243041,ECON 120A,A01,742871,Idoux; Clemence Marie,97,0,100,3
1731507243041,ECON 120A,B01,742873,Candido; Maria Teresa,91,0,95,4
1731507243041,ECON 120A,B02,742877,Candido; Maria Teresa,88,0,90,2
1731507243041,ECON 120A,C01,742879,Candido; Maria Teresa,109,0,115,6
1731507244077,ECON 120B,A01,742884,Berman; Eli,26,0,30,4
1731507244077,ECON 120B,B01,742889,Dahl; Gordon B.,18,0,30,12
1731507244077,ECON 120B,C01,742892,Dahl; Gordon B.,109,0,120,11
1731507244077,ECON 120B,C02,742893,Dahl; Gordon B.,116,0,120,4
1731507245103,ECON 120BH,A00,742895,Dahl; Gordon B.,20,0,20,0
1731507246134,ECON 120C,A01,742902,Candido; Maria Teresa,66,0,70,4
1731507246134,ECON 120C,A02,742905,Candido; Maria Teresa,69,0,70,1
1731507247162,ECON 138,A00,742908,Bharadwaj; Prashant,188,0,200,12
1731507248195,ECON 145,A00,742909,Squires; Dale E,144,0,150,6
1731507249221,ECON 149,A00,742910,Grigoryan; Aram,98,0,100,2
1731507250252,ECON 175,A00,742911,Wu; Pak Yeung,44,0,50,6
1731507250252,ECON 175,B00,742912,Wu; Pak Yeung,42,0,44,2
1731507251280,ECON 178,A01,742915,Zhu; Ying,48,0,60,12
1731507252311,ECON 181,A00,742916,Staff,99,0,100,1
1731507253338,ECON 185,A01,742919,Bharadwaj; Prashant,13,0,18,5
1731507254369,ECON 186,A00,742966,Ross; Stephen Geoffrey,92,0,100,8
1731507255395,ECON 190,A00,742967,Vespa; Emanuel Ignacio,47,0,50,3
1731507255395,ECON 190,B00,742968,Vespa; Emanuel Ignacio,50,0,50,0
1731507256426,ECON 200B,A00,742971,Watson; Joel Christopher,33,0,35,2
1731507257457,ECON 208,A00,742972,Vespa; Emanuel Ignacio & Watson; Joel Christopher,17,0,20,3
1731507258487,ECON 210B,A00,742979,Rondina; Giacomo,34,0,35,1
1731507259513,ECON 220B,A00,743008,Ma; Xinwei,32,0,35,3
1731507260539,ECON 220E,A00,743012,Ma; Xinwei,24,0,30,6
1731507261568,ECON 231,A00,743013,Cullen; Julie,8,0,12,4
1731507262614,ECON 237,A00,743015,Lowes; Sara Rachel & Bazzi; Samuel A,16,0,20,4
1731507263641,ECON 250B,A00,743043,Dahl; Gordon B.,24,0,25,1
1731507264669,ECON 267,A00,743122,Graff Zivin; Joshua,21,0,25,4
1731507265697,ECON 284,A00,743123,Niehaus; Paul,21,0,25,4
1731507266726,ECON 286,A00,743124,Wu; Pak Yeung,19,0,20,1
1731507267752,EDS 23,A01,743187,Staff,0,0,0,0
1731507267752,EDS 23,B01,743239,Staff,0,0,0,0
1731507268781,EDS 39,A01,743242,Heinzman; Erica M.,24,0,25,1
1731507269807,EDS 103,A01,743244,Halter; Christopher P.,33,0,35,2
1731507270833,EDS 111,A00,743245,Staff,58,0,60,2
1731507271858,EDS 112,A01,743247,Chapman; Thandeka K,22,0,30,8
1731507271858,EDS 112,A02,743248,Chapman; Thandeka K,30,0,30,0
1731507272889,EDS 114,A01,743280,Eguchi; Emi,17,0,18,1
1731507272889,EDS 114,A02,743307,Eguchi; Emi,17,0,17,0
1731507273915,EDS 115,A00,743316,Mamas; Christoforos,52,0,60,8
1731507274944,EDS 117,A01,743398,Jones; Gabrielle Anastasia,20,0,23,3
1731507274944,EDS 117,A02,743402,Jones; Gabrielle Anastasia,23,0,23,0
1731507274944,EDS 117,A03,743403,Jones; Gabrielle Anastasia,22,0,22,0
1731507274944,EDS 117,A04,743404,Jones; Gabrielle Anastasia,22,0,22,0
1731507274944,EDS 117,B01,743428,Aragon; Maria Jose,23,0,25,2
1731507274944,EDS 117,B02,743429,Aragon; Maria Jose,25,0,25,0
1731507275971,EDS 122,A00,743489,Brydges; Stacey,10,0,10,0
1731507277002,EDS 124AR,A00,743510,Simon; Elizabeth A,86,0,100,14
1731507277002,EDS 124AR,B00,743511,Simon; Elizabeth A,195,0,200,5
1731507277002,EDS 124AR,C00,794870,Simon; Elizabeth A,40,0,40,0
1731507278032,EDS 124BR,A00,743513,Eguchi; Emi,65,0,75,10
1731507278032,EDS 124BR,B00,795833,Eguchi; Emi,25,0,25,0
1731507279059,EDS 125,A00,743515,Jones; Gabrielle Anastasia,49,0,60,11
1731507280090,EDS 126,A01,743522,Jones; Makeba,30,0,33,3
1731507280090,EDS 126,A02,743617,Jones; Makeba,33,0,33,0
1731507280090,EDS 126,A03,743688,Jones; Makeba,34,0,34,0
1731507281122,EDS 128A,A01,743693,Fargason; Sharon Gayle,11,0,15,4
1731507281122,EDS 128A,A02,743694,Fargason; Sharon Gayle,14,0,15,1
1731507281122,EDS 128A,A03,743695,Fargason; Sharon Gayle,18,0,20,2
1731507282150,EDS 129B,A01,743702,Black; Alison Michelle,42,0,45,3
1731507283176,EDS 130,A01,743709,Choi; Bailey Miyeon,17,0,20,3
1731507283176,EDS 130,A02,743710,Choi; Bailey Miyeon,20,0,20,0
1731507283176,EDS 130,A03,743711,Choi; Bailey Miyeon,19,0,20,1
1731507284214,EDS 131,A01,743718,Cohen; Shana R,20,0,20,0
1731507284214,EDS 131,A02,743722,Cohen; Shana R,20,0,20,0
1731507285241,EDS 133,A01,743741,Bintliff; Amy S.V.,23,0,25,2
1731507285241,EDS 133,A02,743748,Bintliff; Amy S.V.,20,0,20,0
1731507286272,EDS 139,A00,743749,Fargason; Sharon Gayle,43,0,50,7
1731507286272,EDS 139,B00,743825,Black; Alison Michelle,41,0,45,4
1731507286272,EDS 139,C00,743847,Choi; Bailey Miyeon,56,0,60,4
1731507286272,EDS 139,D00,743848,Cohen; Shana R,40,0,40,0
1731507286272,EDS 139,E00,743849,Bintliff; Amy S.V.,43,0,45,2
1731507286272,EDS 139,F00,743851,Bintliff; Amy S.V.,19,0,20,1
1731507286272,EDS 139,G00,743853,Hemans; Patricia Ann Benitez,31,0,35,4
1731507286272,EDS 139,H00,743854,Hemans; Patricia Ann Benitez,20,0,20,0
1731507287298,EDS 140,A00,743898,Hemans; Patricia Ann Benitez,30,0,35,5
1731507288324,EDS 146,A01,743953,Hemans; Patricia Ann Benitez,24,0,25,1
1731507288324,EDS 146,A02,794684,Hemans; Patricia Ann Benitez,0,0,0,0
1731507289353,EDS 149,A00,799976,Millstone; Rachel Diana,20,0,20,0
1731507289353,EDS 149,B00,799977,Heinzman; Erica M.,20,0,20,0
1731507290390,EDS 162,A01,797962,Phuong; Andrew,19,0,20,1
1731507291417,EDS 205A,A00,743983,Halter; Christopher P.,33,0,40,7
1731507292443,EDS 205B,A00,744003,Halter; Christopher P.,32,0,45,13
1731507293473,EDS 232,A00,744009,Clarke; Sherice Nicole,14,0,15,1
1731507294499,EDS 256,A00,744012,Mamas; Christoforos,15,0,15,0
1731507295525,EDS 259A,A00,744013,Aragon; Maria Jose,14,0,15,1
1731507296551,EDS 259B,A00,744014,Aragon; Maria Jose,14,0,15,1
1731507297582,EDS 264,A00,744016,Clarke; Sherice Nicole,14,0,15,1
1731507298609,EDS 280,A00,744017,Datnow; Amanda Lee,11,0,18,7
1731507299636,EDS 287A,A00,744018,Daly; Alan J.,9,0,15,6
1731507300661,EDS 287C,A00,744019,Daly; Alan J.,15,0,15,0
1731507301687,EDS 288B,A00,744020,Fine; Sarah,15,0,15,0
1731507302713,EDS 289A,A01,744022,Hofstetter; Carolyn,15,0,15,0
1731507303738,EDS 291A,A01,744024,Daly; Alan J.,9,0,15,6
1731507304772,EDS 293A,A01,744026,Burrell; Sade Renee,15,0,15,0
1731507305802,EDS 294A,A00,744027,Meyerott; Theresa Ann,15,0,15,0
1731507306834,EDS 296,001,773835,Aragon; Maria Jose,10,0,10,0
1731507306834,EDS 296,002,773846,Bintliff; Amy S.V.,10,0,10,0
1731507306834,EDS 296,003,773906,Clarke; Sherice Nicole,10,0,10,0
1731507306834,EDS 296,004,773907,Chapman; Thandeka K,10,0,10,0
1731507306834,EDS 296,005,773910,Cohen; Shana R,10,0,10,0
1731507306834,EDS 296,006,773911,Datnow; Amanda Lee,10,0,10,0
1731507306834,EDS 296,007,773913,Halter; Christopher P.,10,0,10,0
1731507306834,EDS 296,008,773916,Hopkins; Megan Beth,9,0,10,1
1731507306834,EDS 296,009,773922,Jones; Makeba,10,0,10,0
1731507306834,EDS 296,010,773923,Jones; Gabrielle Anastasia,10,0,10,0
1731507306834,EDS 296,011,773924,Daly; Alan J.,10,0,10,0
1731507306834,EDS 296,012,773925,Simon; Elizabeth A,10,0,10,0
1731507306834,EDS 296,013,773933,Eguchi; Emi,10,0,10,0
1731507306834,EDS 296,014,773977,Hofstetter; Carolyn,10,0,10,0
1731507306834,EDS 296,015,800629,Wishard Guerra; Alison G.,10,0,10,0
1731507306834,EDS 296,016,800644,Mamas; Christoforos,10,0,10,0
1731507306834,EDS 296,017,800654,Fine; Sarah,10,0,10,0
1731507306834,EDS 296,018,800656,Pollock; Mica,10,0,10,0
1731507306834,EDS 296,019,800657,Cohen; Shana R,10,0,10,0
1731507307861,EMED 296,001,791584,Staff,10,0,10,0
1731507307861,EMED 296,002,791585,Staff,10,0,10,0
1731507307861,EMED 296,003,791586,Staff,10,0,10,0
1731507308890,ENG 10,A00,741913,Evdokimenko; Ekaterina,59,0,60,1
1731507309918,ENG 100D,A00,741921,Ngo; Anh-Thu T.,36,0,40,4
1731507309918,ENG 100D,B00,794892,Ngo; Anh-Thu T.,38,0,40,2
1731507310957,ENG 100L,A00,741969,Kleissl; Jan,6,0,6,0
1731507310957,ENG 100L,B00,741970,Bratton; Maryann,6,0,6,0
1731507310957,ENG 100L,C00,741972,Yu; Paul K L,8,0,8,0
1731507310957,ENG 100L,D00,741973,Bratton; Maryann,6,0,6,0
1731507310957,ENG 100L,E00,741974,de Oliveira; Mauricio,6,0,6,0
1731507310957,ENG 100L,F00,741975,Bratton; Maryann,6,0,6,0
1731507310957,ENG 100L,G00,741976,Boyle; Mary E. T.,19,0,20,1
1731507310957,ENG 100L,H00,795155,Boyle; Mary E. T.,14,0,15,1
1731507311988,ENVR 102,A00,744170,Staff,25,0,25,0
1731507311988,ENVR 102,C00,744214,Staff,24,0,25,1
1731507313015,ENVR 120,A00,744215,Uyeda; Kellie Ann,13,0,16,3
1731507314043,ENVR 141,A00,744320,Siapno; Jacqueline A,10,0,10,0
1731507314043,ENVR 141,B00,744328,Siapno; Jacqueline A,15,0,15,0
1731507315070,ENVR 144,A01,744490,Herbst; Matthew,10,0,10,0
1731507317128,ERC 20,A00,744169,Evans; Ivan T,39,0,40,1
1731507318154,ESYS 10,A01,799973,Staff,35,0,35,0
1731507318154,ESYS 10,A02,799974,Staff,35,0,35,0
1731507319184,ESYS 102,A01,744506,Haase; Jennifer Susan,29,0,30,1
1731507319184,ESYS 102,A02,744507,Haase; Jennifer Susan,28,0,30,2
1731507319184,ESYS 102,A03,744520,Haase; Jennifer Susan,27,0,30,3
1731507319184,ESYS 102,A04,744534,Haase; Jennifer Susan,29,0,30,1
1731507320212,ESYS 187B,A01,744536,Hetherington; Elizabeth Dorsey,42,0,45,3
1731507320212,ESYS 187B,B01,794869,Hetherington; Elizabeth Dorsey,41,0,45,4
1731507321249,ETHN 2R,A01,744558,Perreira; Christopher Michael,21,0,25,4
1731507321249,ETHN 2R,A02,744559,Perreira; Christopher Michael,24,0,25,1
1731507321249,ETHN 2R,A03,744560,Perreira; Christopher Michael,22,0,25,3
1731507321249,ETHN 2R,A04,744561,Perreira; Christopher Michael,25,0,25,0
1731507321249,ETHN 2R,A05,744562,Perreira; Christopher Michael,25,0,25,0
1731507321249,ETHN 2R,A06,744563,Perreira; Christopher Michael,24,0,25,1
1731507321249,ETHN 2R,A07,744639,Perreira; Christopher Michael,24,0,25,1
1731507321249,ETHN 2R,A08,744644,Perreira; Christopher Michael,21,0,25,4
1731507321249,ETHN 2R,A09,744646,Perreira; Christopher Michael,24,0,25,1
1731507321249,ETHN 2R,A10,744651,Perreira; Christopher Michael,25,0,25,0
1731507321249,ETHN 2R,A11,744657,Perreira; Christopher Michael,25,0,25,0
1731507321249,ETHN 2R,A12,744664,Perreira; Christopher Michael,25,0,25,0
1731507321249,ETHN 2R,A13,744665,Perreira; Christopher Michael,24,0,25,1
1731507321249,ETHN 2R,A14,744673,Perreira; Christopher Michael,24,0,25,1
1731507321249,ETHN 2R,A15,744749,Perreira; Christopher Michael,24,0,25,1
1731507321249,ETHN 2R,A16,744751,Perreira; Christopher Michael,23,0,25,2
1731507322280,ETHN 100B,A00,744761,Streeby; Shelley,29,0,32,3
1731507323311,ETHN 100H,A00,744765,Frank; Ross H.,0,0,0,0
1731507324340,ETHN 101TV,A01,744838,Marez; Curtis F.,21,0,23,2
1731507324340,ETHN 101TV,A02,744842,Marez; Curtis F.,23,0,23,0
1731507324340,ETHN 101TV,A03,796142,Marez; Curtis F.,23,0,23,0
1731507324340,ETHN 101TV,A04,796143,Marez; Curtis F.,22,0,23,1
1731507325369,ETHN 102,A00,744846,Okonkwo; Holly,38,0,40,2
1731507326397,ETHN 112B,A00,744847,Klann; Mary Cameron,22,0,30,8
1731507327426,ETHN 119,A00,744849,Fuste; Jose Ignacio,31,0,35,4
1731507328453,ETHN 122,A00,744853,Tran; Ly Thi Hai,32,0,35,3
1731507329481,ETHN 125R,A00,744875,Sasaki; Christen T,31,0,50,19
1731507330508,ETHN 133,A00,744880,Power; Jade Yukana,3,0,5,2
1731507331535,ETHN 134,A00,744905,Gosin; Monika N.,19,0,20,1
1731507332566,ETHN 137,A00,744906,Martin Sandino; Amanda Maria Yoland,19,0,20,1
1731507333596,ETHN 138,A00,744907,Gosin; Monika N.,35,0,35,0
1731507334626,ETHN 139,A00,744908,Ruiz; Ariana,20,0,20,0
1731507335654,ETHN 143,A00,744909,Marez; Curtis F.,29,0,30,1
1731507336686,ETHN 163F,A00,744911,Burelle; Julie Sara Veronique,15,0,15,0
1731507337712,ETHN 165,A00,744912,Browne; Errol Tsekani,11,0,15,4
1731507338742,ETHN 167A,A00,744913,Patel; Shaista,11,0,12,1
1731507339774,ETHN 174,A00,744915,Childs; Dennis R.,20,0,20,0
1731507340806,ETHN 179,A00,744916,Dresser; Mark Stuart,24,0,25,1
1731507341833,ETHN 187,A00,744917,Cuong; Marisol,15,0,15,0
1731507342863,ETHN 200B,A00,744918,Patel; Shaista,11,0,15,4
1731507343892,ETHN 230,A00,744919,Perreira; Christopher Michael,10,0,15,5
1731507344917,ETHN 268,A00,744920,Fuste; Jose Ignacio,4,0,10,6
1731507345946,ETIM 289,A00,744923,Sasaki; Christen T,11,0,15,4
1731507346973,EXPR 100,A00,794937,Staff,9999,0,9999,0
1731507348000,EXPR 105,A00,794941,Staff,9999,0,9999,0
1731507349026,EXPR 201,A00,794944,Staff,9999,0,9999,0
1731507350056,EXPR 205,A00,794948,Staff,9999,0,9999,0
1731507351090,FILM 87,A00,745666,Rahimi; Babak,20,0,20,0
1731507351090,FILM 87,B00,745671,Rahimi; Babak,19,0,20,1
1731507351090,FILM 87,C00,745673,Adler; Steven,20,0,20,0
1731507352117,FMPH 277,A00,745558,Gilmer; Todd,9,0,15,6
1731507353145,FMPH 291,A00,745561,Silverstein; Donna K & Wynn; Adriane Michelle,9,0,15,6
1731507354171,FPM 278,A00,745585,Strong; David R,10,0,15,5
1731507355199,FPM 286,A00,791598,Johnson; Michelle Lee,120,0,120,0
1731507356226,FPM 288,A00,799968,Hurst; Samantha,4,0,5,1
1731507357258,FPM 296,001,791599,Allison; Matthew,8,0,10,2
1731507357258,FPM 296,002,791600,Staff,10,0,10,0
1731507357258,FPM 296,003,791601,Staff,10,0,10,0
1731507358283,FPM 297,001,745665,Strong; David R,99,0,99,0
1731507359308,GLBH 20,A00,745680,Walkover; Lillian B,146,0,146,0
1731507360341,GLBH 100,A00,745702,Staff,40,0,40,0
1731507360341,GLBH 100,B00,745703,Schonberg; Jeffrey,40,0,40,0
1731507361367,GLBH 109,A00,745704,Olivas Hernandez; Olga Lid,47,0,48,1
1731507362403,GLBH 111,A01,745712,Burgos; Jose L.,0,0,0,0
1731507362403,GLBH 111,B01,745771,Burgos; Jose L.,0,0,0,0
1731507363434,GLBH 113,A00,745821,Wilson; Brenda K,63,0,70,7
1731507364461,GLBH 139,A00,745834,Csordas; Thomas J.,19,0,20,1
1731507365487,GLBH 141,A00,745835,Sanghvi; Reema I,6,0,11,5
1731507366517,GLBH 146,A00,745836,Kang; Byung Chu,68,0,70,2
1731507367544,GLBH 148,A00,745837,Schonberg; Jeffrey,90,0,100,10
1731507368574,GLBH 150,A00,745838,Sloane; Julia Kathryn,35,0,35,0
1731507369602,GLBH 150A,A00,745839,Kaiser; Bronwyn Nicole,0,0,0,0
1731507370629,GLBH 160,A00,745840,Mackey; Timothy Ken,61,0,68,7
1731507371655,GLBH 171R,A00,745841,Jenkins; Janis A.,17,0,25,8
1731507371655,GLBH 171R,B00,795776,Jenkins; Janis A.,15,0,15,0
1731507372685,GLBH 181,A00,745842,Burgos; Jose L.,213,0,216,3
1731507373711,GLBH 214,A00,745843,Bhavsar; Radhika,4,0,19,15
1731507374741,GLBH 241,A00,745877,Sanghvi; Reema I,7,0,21,14
1731507375766,GLBH 249,A00,745948,Villarino; Margarita,5,0,20,15
1731507376800,GPEC 244,A00,765594,Levy; Morgan,20,0,20,0
1731507377828,GSS 22,A00,746032,Kokinis; Troy Andreas,26,0,30,4
1731507378854,GSS 27,A00,746039,Siapno; Jacqueline A,27,0,30,3
1731507379884,HDS 60,A01,747848,Warstadt; Melissa Fawn,34,0,35,1
1731507379884,HDS 60,A02,747849,Warstadt; Melissa Fawn,34,0,35,1
1731507380913,HDS 95,A00,747852,Staff,31,0,35,4
1731507381939,HDS 110,A00,747853,Wilder; Linnea Lorene,93,0,100,7
1731507382969,HDS 133,A00,747854,Stewart; Alexander B,86,0,100,14
1731507384007,HDS 150,A00,747856,Warstadt; Melissa Fawn,20,0,20,0
1731507385039,HDS 175,A00,747859,Bjorklund; Peter,35,0,35,0
1731507386066,HDS 181,A01,747863,Delgado; Tania,30,0,30,0
1731507387092,HDS 191,A01,747865,Reese; Clarissa Jane,20,0,20,0
1731507387092,HDS 191,B01,747867,Reese; Clarissa Jane,20,0,20,0
1731507388123,HIAF 113,A00,747574,Prestholdt; Jeremy,74,0,75,1
1731507389147,HIAF 114,A00,747576,Gyamfi; Bright,55,0,56,1
1731507390176,HIEA 140R,A00,747577,Gerth; Karl G.,23,0,30,7
1731507391203,HIEA 150,A00,747578,Henry; Todd A.,54,0,56,2
1731507392243,HIEU 103,A00,747579,Watts; Edward J.,108,0,115,7
1731507393273,HIEU 116B,A00,795104,Gallant; Thomas W.,50,0,50,0
1731507394299,HIEU 123,A00,747580,Demetriou; Denise,47,0,50,3
1731507395331,HIEU 147,A00,747616,Biess; Frank Peter,96,0,100,4
1731507396358,HIEU 149,A00,747617,Devereux; Andrew W,49,0,50,1
1731507397386,HIGR 203,A00,747836,Edington; Claire Ellen,4,0,5,1
1731507398413,HIGR 215B,A00,747837,Muscolino; Micah S,10,0,10,0
1731507399493,HIGR 217B,A00,747838,Schneewind; Sarah,15,0,15,0
1731507400521,HIGR 240,A00,747842,McKenzie; Kerry V.,4,0,5,1
1731507401551,HIGR 241,A00,747843,Lampland; Martha,5,0,5,0
1731507402577,HILA 100,A00,747621,Murillo; Dana V.,50,0,50,0
1731507403603,HILA 102,A00,747623,Cowan; Benjamin A,55,0,56,1
1731507404641,HILA 121B,A00,747633,Cowan; Benjamin A,56,0,56,0
1731507405666,HILA 167,A00,794866,Murillo; Dana V.,0,0,0,0
1731507406694,HILA 267,A00,794867,Murillo; Dana V.,12,0,15,3
1731507407731,HILD 2B,A01,746966,Plant; Rebecca Jo,27,0,32,5
1731507407731,HILD 2B,A02,746988,Plant; Rebecca Jo,30,0,32,2
1731507407731,HILD 2B,A03,747023,Plant; Rebecca Jo,32,0,32,0
1731507407731,HILD 2B,A04,747029,Plant; Rebecca Jo,32,0,32,0
1731507407731,HILD 2B,A05,747030,Plant; Rebecca Jo,31,0,32,1
1731507407731,HILD 2B,A06,747031,Plant; Rebecca Jo,32,0,32,0
1731507408764,HILD 7A,A01,747252,Graham; Jessica Lynn,30,0,32,2
1731507408764,HILD 7A,A02,747337,Graham; Jessica Lynn,30,0,32,2
1731507408764,HILD 7A,A03,747338,Graham; Jessica Lynn,32,0,32,0
1731507408764,HILD 7A,A04,747352,Graham; Jessica Lynn,30,0,32,2
1731507408764,HILD 7A,A05,747375,Graham; Jessica Lynn,30,0,32,2
1731507408764,HILD 7A,A06,747385,Graham; Jessica Lynn,29,0,32,3
1731507408764,HILD 7A,A07,747442,Graham; Jessica Lynn,32,0,32,0
1731507408764,HILD 7A,A08,747444,Graham; Jessica Lynn,32,0,32,0
1731507408764,HILD 7A,A09,747447,Graham; Jessica Lynn,32,0,32,0
1731507408764,HILD 7A,A10,747449,Graham; Jessica Lynn,32,0,32,0
1731507408764,HILD 7A,A11,747450,Graham; Jessica Lynn,32,0,32,0
1731507408764,HILD 7A,A12,747487,Graham; Jessica Lynn,32,0,32,0
1731507409796,HILD 11,A01,747512,Lu; Weijing,30,0,32,2
1731507409796,HILD 11,A02,747513,Lu; Weijing,32,0,32,0
1731507409796,HILD 11,A03,747538,Lu; Weijing,32,0,32,0
1731507409796,HILD 11,A04,747546,Lu; Weijing,32,0,32,0
1731507409796,HILD 11,A05,747558,Lu; Weijing,32,0,32,0
1731507409796,HILD 11,A06,747559,Lu; Weijing,32,0,32,0
1731507410821,HILD 41,A01,747562,Devereux; Andrew W,32,0,32,0
1731507410821,HILD 41,A02,747563,Devereux; Andrew W,32,0,32,0
1731507411848,HINE 109,A00,799584,Staff,0,0,0,0
1731507412876,HINE 118,A00,799585,Staff,0,0,0,0
1731507413902,HINE 125,A00,747822,Balberg; Mira,48,0,50,2
1731507414934,HINE 186,A00,794522,Hertz; Deborah & Kayali; Hasan,15,0,15,0
1731507415961,HISA 144,A00,794454,De; Aniket,48,0,50,2
1731507416989,HISC 109,A00,747823,Edington; Claire Ellen,44,0,50,6
1731507418019,HISC 115,A00,747824,Gere; Catherina M.,118,0,120,2
1731507419046,HISC 180,A00,747825,Golan; Tal,15,0,15,0
1731507420073,HITO 87,A00,747567,Hanna; Mark G.,15,0,15,0
1731507420073,HITO 87,B00,747569,Patterson; Patrick H.,14,0,15,1
1731507420073,HITO 87,C00,747570,Patterson; Patrick H.,15,0,15,0
1731507420073,HITO 87,D00,747571,Edington; Claire Ellen,14,0,15,1
1731507420073,HITO 87,E00,747573,Schneewind; Sarah,15,0,15,0
1731507421101,HITO 100,B00,747827,Strasser; Ulrike,20,0,22,2
1731507422130,HITO 133,A00,747828,Hansen; Jan Eric,54,0,56,2
1731507423155,HITO 178,A00,747829,Hanna; Mark G.,19,0,20,1
1731507424183,HITO 193,A00,770732,Hill; Seth J,9999,0,9999,0
1731507425210,HIUS 108B,A00,794492,Daly; Heather Marie,34,0,40,6
1731507426236,HIUS 133,A00,747831,Hanna; Mark G.,136,0,146,10
1731507427265,HIUS 146,A00,747834,Alvarez; Luis A,48,0,50,2
1731507428292,HIUS 152B,A00,794678,Daly; Heather Marie,36,0,40,4
1731507429317,HIUS 180,A00,747835,Gosin; Monika N.,20,0,20,0
1731507430358,HUM 1,A01,767622,Demetriou; Denise,15,0,15,0
1731507430358,HUM 1,A02,767623,Demetriou; Denise,14,0,15,1
1731507430358,HUM 1,A03,767624,Demetriou; Denise,12,0,15,3
1731507430358,HUM 1,A04,767625,Demetriou; Denise,11,0,15,4
1731507430358,HUM 1,A05,767626,Demetriou; Denise,12,0,15,3
1731507430358,HUM 1,A06,767627,Demetriou; Denise,15,0,15,0
1731507430358,HUM 1,A07,767628,Demetriou; Denise,15,0,15,0
1731507430358,HUM 1,A08,767629,Demetriou; Denise,15,0,15,0
1731507430358,HUM 1,A09,767687,Demetriou; Denise,14,0,15,1
1731507430358,HUM 1,A10,767695,Demetriou; Denise,14,0,15,1
1731507430358,HUM 1,A11,767696,Demetriou; Denise,15,0,15,0
1731507430358,HUM 1,A12,767698,Demetriou; Denise,15,0,15,0
1731507430358,HUM 1,B01,767771,West; Geoffrey Scott,14,0,15,1
1731507430358,HUM 1,B02,767815,West; Geoffrey Scott,14,0,15,1
1731507430358,HUM 1,B03,767837,West; Geoffrey Scott,14,0,15,1
1731507430358,HUM 1,B04,767843,West; Geoffrey Scott,13,0,15,2
1731507430358,HUM 1,B05,767853,West; Geoffrey Scott,15,0,15,0
1731507430358,HUM 1,B06,767861,West; Geoffrey Scott,15,0,15,0
1731507430358,HUM 1,B07,767884,West; Geoffrey Scott,15,0,15,0
1731507430358,HUM 1,B08,767903,West; Geoffrey Scott,15,0,15,0
1731507430358,HUM 1,B09,767945,West; Geoffrey Scott,15,0,15,0
1731507430358,HUM 1,B10,767986,West; Geoffrey Scott,15,0,15,0
1731507430358,HUM 1,B11,768004,West; Geoffrey Scott,14,0,15,1
1731507430358,HUM 1,B12,768005,West; Geoffrey Scott,12,0,15,3
1731507430358,HUM 1,B13,768015,West; Geoffrey Scott,15,0,15,0
1731507430358,HUM 1,B14,768019,West; Geoffrey Scott,15,0,15,0
1731507430358,HUM 1,C01,768080,Rodriguez; Bretton Sigfred,0,0,0,0
1731507430358,HUM 1,C02,768081,Rodriguez; Bretton Sigfred,0,0,0,0
1731507430358,HUM 1,C03,768082,Rodriguez; Bretton Sigfred,13,0,15,2
1731507430358,HUM 1,C04,768083,Rodriguez; Bretton Sigfred,13,0,15,2
1731507430358,HUM 1,C05,768084,Rodriguez; Bretton Sigfred,14,0,15,1
1731507430358,HUM 1,C06,768085,Rodriguez; Bretton Sigfred,13,0,15,2
1731507430358,HUM 1,C07,768086,Rodriguez; Bretton Sigfred,15,0,15,0
1731507430358,HUM 1,C08,768087,Rodriguez; Bretton Sigfred,15,0,15,0
1731507430358,HUM 1,C09,768088,Rodriguez; Bretton Sigfred,15,0,15,0
1731507430358,HUM 1,C10,768089,Rodriguez; Bretton Sigfred,15,0,15,0
1731507430358,HUM 1,C11,768090,Rodriguez; Bretton Sigfred,13,0,15,2
1731507430358,HUM 1,C12,768091,Rodriguez; Bretton Sigfred,15,0,15,0
1731507430358,HUM 1,C13,768157,Rodriguez; Bretton Sigfred,14,0,15,1
1731507430358,HUM 1,C14,768158,Rodriguez; Bretton Sigfred,14,0,15,1
1731507431387,HUM 2,A01,768160,Lyon; Antony J.,13,0,15,2
1731507431387,HUM 2,A02,768165,Lyon; Antony J.,13,0,15,2
1731507431387,HUM 2,A03,768166,Lyon; Antony J.,0,0,0,0
1731507431387,HUM 2,A04,768167,Lyon; Antony J.,0,0,0,0
1731507431387,HUM 2,A05,768169,Lyon; Antony J.,14,0,15,1
1731507431387,HUM 2,A06,768193,Lyon; Antony J.,15,0,15,0
1731507431387,HUM 2,A07,768200,Lyon; Antony J.,14,0,15,1
1731507431387,HUM 2,A08,768260,Lyon; Antony J.,15,0,15,0
1731507431387,HUM 2,A09,768299,Lyon; Antony J.,13,0,15,2
1731507431387,HUM 2,A10,768323,Lyon; Antony J.,12,0,15,3
1731507431387,HUM 2,A11,768330,Lyon; Antony J.,15,0,15,0
1731507431387,HUM 2,A12,768338,Lyon; Antony J.,14,0,15,1
1731507431387,HUM 2,A13,768344,Lyon; Antony J.,0,0,0,0
1731507431387,HUM 2,A14,768388,Lyon; Antony J.,0,0,0,0
1731507432424,HUM 4,A01,768408,Watkins; Eric,27,0,28,1
1731507432424,HUM 4,A02,768409,Watkins; Eric,26,0,28,2
1731507432424,HUM 4,A03,768410,Watkins; Eric,27,0,28,1
1731507432424,HUM 4,A04,768411,Watkins; Eric,28,0,28,0
1731507432424,HUM 4,A05,768412,Watkins; Eric,27,0,28,1
1731507432424,HUM 4,A06,768413,Watkins; Eric,27,0,28,1
1731507432424,HUM 4,B01,768415,Caldwell; Michael Alan,20,0,28,8
1731507432424,HUM 4,B02,768416,Caldwell; Michael Alan,27,0,28,1
1731507432424,HUM 4,B03,768417,Caldwell; Michael Alan,21,0,28,7
1731507432424,HUM 4,B04,768418,Caldwell; Michael Alan,26,0,28,2
1731507432424,HUM 4,B05,768419,Caldwell; Michael Alan,28,0,28,0
1731507432424,HUM 4,B06,768420,Caldwell; Michael Alan,27,0,28,1
1731507432424,HUM 4,B07,768421,Caldwell; Michael Alan,28,0,28,0
1731507432424,HUM 4,B08,768422,Caldwell; Michael Alan,28,0,28,0
1731507432424,HUM 4,C01,768424,Markman; Kristina,27,0,28,1
1731507432424,HUM 4,C02,768425,Markman; Kristina,23,0,28,5
1731507432424,HUM 4,C03,768426,Markman; Kristina,24,0,28,4
1731507432424,HUM 4,C04,768427,Markman; Kristina,23,0,28,5
1731507432424,HUM 4,C05,768428,Markman; Kristina,24,0,28,4
1731507432424,HUM 4,C06,768429,Markman; Kristina,26,0,28,2
1731507432424,HUM 4,C07,768430,Markman; Kristina,25,0,28,3
1731507432424,HUM 4,C08,768431,Markman; Kristina,26,0,28,2
1731507433451,HUM 100,001,768432,Zavodny; Tatiana Sophia,18,0,18,0
1731507433451,HUM 100,002,768433,Zavodny; Tatiana Sophia,17,0,18,1
1731507433451,HUM 100,003,768434,Zavodny; Tatiana Sophia,17,0,18,1
1731507433451,HUM 100,004,768435,West; Geoffrey Scott,18,0,18,0
1731507433451,HUM 100,005,768436,Crum; Matthew Stephen,18,0,18,0
1731507433451,HUM 100,006,768437,Crum; Matthew Stephen,17,0,18,1
1731507433451,HUM 100,007,768438,Crum; Matthew Stephen,18,0,18,0
1731507433451,HUM 100,008,768439,Shenoy; Niyati,17,0,18,1
1731507433451,HUM 100,009,768440,Shenoy; Niyati,18,0,18,0
1731507433451,HUM 100,010,768441,Shenoy; Niyati,18,0,18,0
1731507434485,INTL 100,A01,747870,Feuer; Anna Stagg,23,0,25,2
1731507434485,INTL 100,A02,747872,Feuer; Anna Stagg,24,0,25,1
1731507434485,INTL 100,A03,747874,Feuer; Anna Stagg,22,0,25,3
1731507434485,INTL 100,A04,747881,Feuer; Anna Stagg,24,0,25,1
1731507434485,INTL 100,A05,747891,Feuer; Anna Stagg,22,0,25,3
1731507434485,INTL 100,A06,747893,Feuer; Anna Stagg,25,0,25,0
1731507435511,INTL 101,A01,747898,McIntosh; Justin Daniel,30,0,35,5
1731507435511,INTL 101,A02,747900,McIntosh; Justin Daniel,27,0,35,8
1731507436536,INTL 102,A01,747903,Broz; James Lawrence,28,0,35,7
1731507436536,INTL 102,A02,747909,Broz; James Lawrence,33,0,35,2
1731507437564,INTL 190,A00,747910,Appel; Benjamin Jay,0,0,0,0
1731507437564,INTL 190,B00,747912,Feeley; Maureen Catherine,0,0,0,2
1731507437564,INTL 190,C00,747914,Fortier; Jana,0,0,0,2
1731507437564,INTL 190,D00,747915,Lettieri; Michael Joseph,0,0,0,0
1731507438598,JAPN 10B,A01,747919,Maruyama; Rie,20,0,20,0
1731507438598,JAPN 10B,B01,747925,Sato; Kyoko,20,0,20,0
1731507438598,JAPN 10B,C01,747929,Ross; Kayoko F,17,0,20,3
1731507438598,JAPN 10B,D01,747932,McKee; Mayumi Mochizuki,22,0,25,3
1731507438598,JAPN 10B,E01,747936,Kamioka; Sachiko,21,0,25,4
1731507438598,JAPN 10B,F01,747941,Inada; Minori,23,0,25,2
1731507438598,JAPN 10B,G01,747944,Tipton; Yuko,25,0,25,0
1731507438598,JAPN 10B,H01,747951,Homma; Kunihiko,22,0,25,3
1731507438598,JAPN 10B,I01,747955,Maruyama; Rie,23,0,25,2
1731507438598,JAPN 10B,J01,747960,Tipton; Yuko,21,0,25,4
1731507438598,JAPN 10B,K01,747965,Sato; Kyoko,24,0,25,1
1731507438598,JAPN 10B,L01,747968,Ross; Kayoko F,25,0,25,0
1731507438598,JAPN 10B,M01,747971,Homma; Kunihiko,18,0,20,2
1731507439631,JAPN 10BR,A01,747974,Inada; Minori,20,0,20,0
1731507439631,JAPN 10BR,B01,747978,McKee; Mayumi Mochizuki,19,0,20,1
1731507439631,JAPN 10BR,C01,796045,Inada; Minori,4,0,4,0
1731507439631,JAPN 10BR,D01,796047,McKee; Mayumi Mochizuki,4,0,4,0
1731507440660,JAPN 20B,A01,747981,Takeda; Izumi,20,0,20,0
1731507440660,JAPN 20B,B01,747984,Homma; Kunihiko,16,0,20,4
1731507440660,JAPN 20B,C01,747988,Iwamoto; Naoki,18,0,20,2
1731507440660,JAPN 20B,D01,747991,Simpson; Junko Tokuda,20,0,20,0
1731507440660,JAPN 20B,E01,747993,Takeda; Izumi,20,0,20,0
1731507441686,JAPN 130B,A01,747998,Maruyama; Rie,19,0,20,1
1731507441686,JAPN 130B,B01,748001,Kamioka; Sachiko,19,0,20,1
1731507442710,JAPN 135B,A00,748002,Ross; Kayoko F,18,0,20,2
1731507442710,JAPN 135B,B00,748003,Iwamoto; Naoki,18,0,20,2
1731507443737,JAPN 137B,A00,748004,Simpson; Junko Tokuda,16,0,20,4
1731507444768,JAPN 140B,A00,748005,Takeda; Izumi,14,0,15,1
1731507445794,JAPN 150A,A00,748009,Sato; Kyoko,14,0,15,1
1731507446821,JAPN 190,A00,748010,Turner; Christena L.,19,0,20,1
1731507447851,JWSP 2,A01,748014,Shuster; Alana,14,0,15,1
1731507448882,LATI 10,A01,748018,Kennemore; Amy Michelle,27,0,30,3
1731507448882,LATI 10,A02,748020,Kennemore; Amy Michelle,30,0,30,0
1731507448882,LATI 10,A03,748021,Kennemore; Amy Michelle,28,0,30,2
1731507448882,LATI 10,A04,748023,Kennemore; Amy Michelle,28,0,30,2
1731507448882,LATI 10,A05,748025,Kennemore; Amy Michelle,30,0,30,0
1731507449914,LATI 50,A01,794604,Kokinis; Troy Andreas,28,0,30,2
1731507449914,LATI 50,A02,794839,Kokinis; Troy Andreas,29,0,30,1
1731507449914,LATI 50,A03,794840,Kokinis; Troy Andreas,30,0,30,0
1731507449914,LATI 50,A04,794841,Kokinis; Troy Andreas,27,0,30,3
1731507450941,LATI 140,A01,748028,Kokinis; Troy Andreas,30,0,30,0
1731507451967,LATI 170,A00,796289,Kennemore; Amy Michelle,28,0,30,2
1731507452991,LATI 180,B00,748041,Vasquez Cortes; Mateo,29,0,30,1
1731507454016,LATI 190,A00,748043,Carvajal Regidor; Jose,30,0,30,0
1731507455045,LAWS 101,A00,748047,Golan; Tal,48,0,60,12
1731507456071,LIAB 1B,A00,748070,Saab; Dima,12,0,14,2
1731507456071,LIAB 1B,B00,748075,Saab; Dima,11,0,14,3
1731507457104,LIAB 1BX,A00,748076,El Cheddadi; Youniss,24,0,28,4
1731507458136,LIAB 1E,A00,748082,El Cheddadi; Youniss,14,0,14,0
1731507459162,LIFR 1B,A00,748098,Van Moer; Vinciane G,12,0,14,2
1731507459162,LIFR 1B,B00,748099,Van Moer; Vinciane G,12,0,14,2
1731507459162,LIFR 1B,C00,748341,Van Moer; Vinciane G,12,0,14,2
1731507460191,LIFR 1BX,A00,748356,Van Moer; Vinciane G,21,0,21,0
1731507460191,LIFR 1BX,B00,748357,Van Moer; Vinciane G,15,0,21,6
1731507461217,LIFR 1C,A00,748361,Van Moer; Vinciane G,13,0,14,1
1731507461217,LIFR 1C,B00,748362,Van Moer; Vinciane G,10,0,14,4
1731507461217,LIFR 1C,C00,748363,Van Moer; Vinciane G,13,0,14,1
1731507462242,LIFR 1CX,A00,748366,Van Moer; Vinciane G,20,0,21,1
1731507462242,LIFR 1CX,B00,748367,Van Moer; Vinciane G,19,0,21,2
1731507463270,LIFR 11,A00,748368,Goodall; Grant Todd,9999,0,9999,0
1731507464299,LIGM 1B,A00,748371,Fischer-Grunski; Eva K,12,0,14,2
1731507464299,LIGM 1B,B00,748372,Fischer-Grunski; Eva K,12,0,14,2
1731507464299,LIGM 1B,C00,748374,Fischer-Grunski; Eva K,13,0,14,1
1731507465325,LIGM 1BX,A00,748376,Fischer-Grunski; Eva K,19,0,21,2
1731507465325,LIGM 1BX,B00,748378,Fischer-Grunski; Eva K,20,0,21,1
1731507466354,LIGM 11,A00,748379,Goodall; Grant Todd,9999,0,9999,0
1731507467386,LIGN 8,A00,748997,McIntosh; Justin Daniel,245,0,250,5
1731507468416,LIGN 17,A00,749008,Kehler; Andrew Scott,247,0,250,3
1731507469448,LIGN 101,A01,749010,Staff,27,0,29,2
1731507469448,LIGN 101,A02,749011,Staff,29,0,29,0
1731507469448,LIGN 101,A03,749149,Staff,27,0,29,2
1731507469448,LIGN 101,A04,749176,Staff,29,0,29,0
1731507469448,LIGN 101,A05,749186,Staff,29,0,30,1
1731507470474,LIGN 111,A01,749192,Bakovic; Eric John,29,0,30,1
1731507470474,LIGN 111,A02,749193,Bakovic; Eric John,27,0,30,3
1731507470474,LIGN 111,A03,749194,Bakovic; Eric John,24,0,30,6
1731507471502,LIGN 112,A00,749205,Garellek; Marc,69,0,70,1
1731507472537,LIGN 121,A01,749209,Rodriguez Aispuro; Alejandro,20,0,25,5
1731507472537,LIGN 121,A02,749211,Rodriguez Aispuro; Alejandro,24,0,25,1
1731507472537,LIGN 121,A03,749214,Rodriguez Aispuro; Alejandro,24,0,25,1
1731507473565,LIGN 148,A00,749215,Mayberry; Rachel,72,0,75,3
1731507474596,LIGN 150,A00,749218,Garellek; Marc,42,0,50,8
1731507475623,LIGN 172,A01,794611,Dudley; Rachel,30,0,30,0
1731507476649,LIGN 178,A00,749223,Munoz Sanchez; Alicia,69,0,70,1
1731507477681,LIGN 187,A00,749226,Staff,30,0,30,0
1731507477681,LIGN 187,B00,749227,Warstadt; Alexander Scott,30,0,30,0
1731507478708,LIGN 188R,A00,749228,Clem; Emily,40,0,40,0
1731507479738,LIGN 214,A00,749229,Styler; William Francis,29,0,30,1
1731507480767,LIGN 225,A00,749230,Clem; Emily,30,0,30,0
1731507481793,LIGN 251,A00,749287,Bergen; Leon,28,0,30,2
1731507482837,LIGN 296,001,774625,Ackerman; Farrell,10,0,10,0
1731507482837,LIGN 296,002,774626,Bakovic; Eric John,10,0,10,0
1731507482837,LIGN 296,003,774627,Bergen; Leon,10,0,10,0
1731507482837,LIGN 296,004,774638,Caballero; Gabriela Hernandez,10,0,10,0
1731507482837,LIGN 296,005,774639,Caponigro; Ivano,10,0,10,0
1731507482837,LIGN 296,006,774683,Clem; Emily,10,0,10,0
1731507482837,LIGN 296,007,774684,Dudley; Rachel,10,0,10,0
1731507482837,LIGN 296,008,774685,Garellek; Marc,10,0,10,0
1731507482837,LIGN 296,009,774691,Goodall; Grant Todd,10,0,10,0
1731507482837,LIGN 296,010,774692,Kehler; Andrew Scott,10,0,10,0
1731507482837,LIGN 296,011,774694,Kluender; Robert,10,0,10,0
1731507482837,LIGN 296,012,774697,Rose; Sharon,10,0,10,0
1731507482837,LIGN 296,013,774700,Styler; William Francis,10,0,10,0
1731507482837,LIGN 296,014,774820,Caponigro; Ivano,10,0,10,0
1731507483867,LIHL 112W,A00,748052,Pagkalinawan; Leticia Cant,27,0,28,1
1731507484896,LIHL 114W,A00,748054,Nguyen; Hoan Thi,25,0,28,3
1731507485923,LIHL 117W,A00,748057,Sadegholvad; Elham,28,0,28,0
1731507486953,LIHL 118,A00,748059,Chen; Areana Yen,28,0,28,0
1731507487979,LIHL 124W,A00,748061,Nguyen; Hoan Thi,26,0,28,2
1731507489007,LIHL 132W,A00,748062,Pagkalinawan; Leticia Cant,28,0,28,0
1731507490036,LIHL 134W,A00,748064,Nguyen; Hoan Thi,28,0,28,0
1731507491060,LIHL 138,A00,748068,Chen; Areana Yen,28,0,28,0
1731507492101,LIIT 1B,A00,748409,Carnelos; Chiara,13,0,14,1
1731507492101,LIIT 1B,B00,748418,Carnelos; Chiara,12,0,14,2
1731507492101,LIIT 1B,C00,748424,Carnelos; Chiara,12,0,14,2
1731507493127,LIIT 1BX,A00,748428,Carnelos; Chiara,21,0,21,0
1731507493127,LIIT 1BX,B00,748430,Carnelos; Chiara,17,0,21,4
1731507494156,LIPO 1B,A00,748436,Paladini; Denise,12,0,14,2
1731507494156,LIPO 1B,B00,748437,Paladini; Denise,0,0,0,0
1731507495183,LIPO 1BX,A00,748438,De Abreu; Cassia,27,0,28,1
1731507496209,LIPO 17,A00,798404,Paladini; Denise,0,0,0,0
1731507497238,LISL 1B,A00,748478,Lott; Margaret S.,14,0,14,0
1731507497238,LISL 1B,B00,748482,Lott; Margaret S.,14,0,14,0
1731507497238,LISL 1B,C00,748484,Lott; Margaret S.,13,0,14,1
1731507497238,LISL 1B,D00,748485,Lott; Margaret S.,12,0,14,2
1731507497238,LISL 1B,E00,748487,Lott; Margaret S.,14,0,14,0
1731507497238,LISL 1B,F00,748490,Lott; Margaret S.,12,0,14,2
1731507497238,LISL 1B,G00,748491,Lott; Margaret S.,13,0,14,1
1731507497238,LISL 1B,H00,748492,Lott; Margaret S.,14,0,14,0
1731507498267,LISL 1BX,A00,748594,Lott; Margaret S.,28,0,28,0
1731507498267,LISL 1BX,B00,748595,Lott; Margaret S.,27,0,28,1
1731507498267,LISL 1BX,C00,748596,Lott; Margaret S.,25,0,28,3
1731507498267,LISL 1BX,D00,748597,Lott; Margaret S.,27,0,28,1
1731507499293,LISL 1C,A00,748614,Lott; Margaret S.,11,0,14,3
1731507499293,LISL 1C,B00,748616,Lott; Margaret S.,13,0,14,1
1731507499293,LISL 1C,C00,748678,Lott; Margaret S.,11,0,14,3
1731507499293,LISL 1C,D00,748686,Lott; Margaret S.,14,0,14,0
1731507500318,LISL 1CX,A00,748698,Lott; Margaret S.,21,0,28,7
1731507500318,LISL 1CX,B00,748699,Lott; Margaret S.,25,0,28,3
1731507501343,LISL 1E,A00,748700,Lott; Margaret S.,11,0,14,3
1731507502372,LISP 1B,A00,748737,Munoz Sanchez; Alicia,12,0,14,2
1731507502372,LISP 1B,B00,748755,Munoz Sanchez; Alicia,14,0,14,0
1731507502372,LISP 1B,C00,748761,Munoz Sanchez; Alicia,14,0,14,0
1731507502372,LISP 1B,D00,748763,Munoz Sanchez; Alicia,12,0,14,2
1731507502372,LISP 1B,E00,748764,Munoz Sanchez; Alicia,14,0,14,0
1731507502372,LISP 1B,F00,748790,Munoz Sanchez; Alicia,11,0,14,3
1731507502372,LISP 1B,G00,748791,Munoz Sanchez; Alicia,14,0,14,0
1731507502372,LISP 1B,H00,748792,Munoz Sanchez; Alicia,9,0,14,5
1731507502372,LISP 1B,I00,748793,Munoz Sanchez; Alicia,12,0,14,2
1731507502372,LISP 1B,J00,748794,Munoz Sanchez; Alicia,11,0,14,3
1731507503406,LISP 1BX,A00,748795,Munoz Sanchez; Alicia,26,0,28,2
1731507503406,LISP 1BX,B00,748796,Munoz Sanchez; Alicia,25,0,28,3
1731507503406,LISP 1BX,C00,748797,Munoz Sanchez; Alicia,26,0,28,2
1731507503406,LISP 1BX,D00,748798,Munoz Sanchez; Alicia,25,0,28,3
1731507503406,LISP 1BX,E00,748799,Munoz Sanchez; Alicia,24,0,28,4
1731507504434,LISP 1C,001,748834,Munoz Sanchez; Alicia,13,0,14,1
1731507504434,LISP 1C,002,748835,Munoz Sanchez; Alicia,14,0,14,0
1731507504434,LISP 1C,003,748847,Munoz Sanchez; Alicia,13,0,14,1
1731507504434,LISP 1C,004,748848,Munoz Sanchez; Alicia,13,0,14,1
1731507504434,LISP 1C,005,748863,Munoz Sanchez; Alicia,13,0,14,1
1731507504434,LISP 1C,006,748866,Munoz Sanchez; Alicia,13,0,14,1
1731507504434,LISP 1C,007,748867,Munoz Sanchez; Alicia,12,0,14,2
1731507504434,LISP 1C,008,748868,Munoz Sanchez; Alicia,14,0,14,0
1731507504434,LISP 1C,009,748869,Munoz Sanchez; Alicia,14,0,14,0
1731507504434,LISP 1C,010,748870,Munoz Sanchez; Alicia,13,0,14,1
1731507504434,LISP 1C,011,748871,Munoz Sanchez; Alicia,12,0,14,2
1731507504434,LISP 1C,012,748872,Munoz Sanchez; Alicia,12,0,14,2
1731507504434,LISP 1C,013,748873,Munoz Sanchez; Alicia,12,0,14,2
1731507504434,LISP 1C,014,748879,Munoz Sanchez; Alicia,13,0,14,1
1731507504434,LISP 1C,015,748895,Munoz Sanchez; Alicia,12,0,14,2
1731507504434,LISP 1C,016,748896,Munoz Sanchez; Alicia,14,0,14,0
1731507504434,LISP 1C,017,748901,Munoz Sanchez; Alicia,14,0,14,0
1731507504434,LISP 1C,018,748902,Munoz Sanchez; Alicia,13,0,14,1
1731507504434,LISP 1C,020,748904,Munoz Sanchez; Alicia,14,0,14,0
1731507505460,LISP 1CX,B00,748913,Munoz Sanchez; Alicia,27,0,30,3
1731507505460,LISP 1CX,C00,748914,Munoz Sanchez; Alicia,26,0,30,4
1731507505460,LISP 1CX,D00,748926,Munoz Sanchez; Alicia,27,0,30,3
1731507505460,LISP 1CX,E00,748937,Munoz Sanchez; Alicia,30,0,30,0
1731507505460,LISP 1CX,F00,748938,Munoz Sanchez; Alicia,27,0,30,3
1731507505460,LISP 1CX,G00,748950,Munoz Sanchez; Alicia,28,0,30,2
1731507505460,LISP 1CX,H00,748951,Munoz Sanchez; Alicia,28,0,30,2
1731507505460,LISP 1CX,I00,748956,Munoz Sanchez; Alicia,30,0,30,0
1731507505460,LISP 1CX,J00,748957,Munoz Sanchez; Alicia,29,0,30,1
1731507506485,LISP 16,A00,748994,Munoz Sanchez; Alicia,20,0,22,2
1731507506485,LISP 16,B00,748995,Munoz Sanchez; Alicia,21,0,22,1
1731507507513,LISP 18,A00,748996,Munoz Sanchez; Alicia,21,0,22,1
1731507508541,LTAM 105,A00,749877,Ruiz; Ariana,35,0,40,5
1731507509569,LTAM 110,A00,749882,Chacon; Gloria Elizabeth,40,0,40,0
1731507510596,LTAM 120,A00,749915,Martin-Cabrera; Luis,39,0,40,1
1731507511623,LTCO 281,A00,750740,Mukherjee; Silpa,15,0,15,0
1731507512651,LTCO 282,A00,750741,Cohen; Alain J. J.,12,0,15,3
1731507513680,LTCS 11,A00,749294,Lampert-Weissig; Lisa,39,0,40,1
1731507514708,LTCS 87,A00,795238,Nguyen; Hoang Tan,19,0,20,1
1731507514708,LTCS 87,B00,795239,Nguyen; Hoang Tan,20,0,20,0
1731507515732,LTCS 108,A00,749916,Lu; Lillian,19,0,20,1
1731507516759,LTCS 111,A00,749940,Vitkus; Daniel J.,25,0,25,0
1731507517783,LTCS 131,A00,749942,Sanchez Cruz; Jorge,39,0,40,1
1731507518808,LTEA 100A,A00,749944,Liao; Ping H,39,0,40,1
1731507519837,LTEA 132,A00,749945,Mendoza; Andrea,55,0,60,5
1731507520861,LTEA 138,A00,749946,Miyao; Daisuke,347,0,360,13
1731507521888,LTEN 23,A01,749297,Vijay; Ameeth Varma,28,0,28,0
1731507521888,LTEN 23,A02,749321,Vijay; Ameeth Varma,27,0,28,1
1731507521888,LTEN 23,A03,749322,Vijay; Ameeth Varma,28,0,28,0
1731507521888,LTEN 23,A04,749324,Vijay; Ameeth Varma,27,0,28,1
1731507522921,LTEN 26,A01,749326,Wesling; Megan E.,27,0,28,1
1731507522921,LTEN 26,A02,749327,Wesling; Megan E.,26,0,28,2
1731507522921,LTEN 26,A03,749328,Wesling; Megan E.,25,0,28,3
1731507522921,LTEN 26,A04,749329,Wesling; Megan E.,25,0,28,3
1731507523949,LTEN 27,A01,749339,Childs; Dennis R.,27,0,28,1
1731507523949,LTEN 27,A02,749348,Childs; Dennis R.,27,0,28,1
1731507523949,LTEN 27,A03,749360,Childs; Dennis R.,26,0,28,2
1731507523949,LTEN 27,A04,749362,Childs; Dennis R.,27,0,28,1
1731507524978,LTEN 112,A00,749947,Vitkus; Daniel J.,38,0,40,2
1731507526008,LTEN 140,A00,749948,Lu; Lillian,23,0,25,2
1731507527034,LTEN 142,A00,749949,Garofalo; Devin,38,0,40,2
1731507528064,LTEN 180,A00,749950,Ruiz; Ariana,17,0,20,3
1731507529094,LTEN 181,A00,749951,Kim; Joo Ok,36,0,40,4
1731507530120,LTEN 185,A00,749961,Childs; Dennis R.,17,0,20,3
1731507531149,LTEN 189,A00,749962,Vijay; Ameeth Varma,24,0,25,1
1731507532175,LTEN 252,A00,750742,Wesling; Megan E.,12,0,15,3
1731507533203,LTEN 272,A00,750744,Lampert-Weissig; Lisa,11,0,15,4
1731507534228,LTEU 105,A00,749963,De Marchi Gherini; Adriana,28,0,35,7
1731507535253,LTEU 141,A00,749977,Cohen; Alain J. J.,40,0,40,0
1731507536279,LTEU 150C,B00,750299,Morse; Ainsley,30,0,30,0
1731507537308,LTFR 2B,A01,749381,Ploye; Catherine,28,0,28,0
1731507538335,LTFR 2C,A00,749383,Ploye; Catherine,25,0,25,0
1731507539361,LTFR 104,A00,750301,Zhiri; Oumelbanine,25,0,25,0
1731507540389,LTFR 115,A00,750302,Zhiri; Oumelbanine,25,0,25,0
1731507541419,LTGK 2,A00,749384,Murray; Kourtney Kristine,30,0,31,1
1731507542449,LTGK 104,A00,795231,Murray; Kourtney Kristine,25,0,25,0
1731507543476,LTGM 2B,A01,749413,Fischer-Grunski; Eva K,25,0,25,0
1731507544503,LTIT 2B,A01,749459,De Marchi Gherini; Adriana,24,0,25,1
1731507545529,LTIT 115,A00,750314,De Marchi Gherini; Adriana,5,0,5,0
1731507546559,LTKO 1B,A01,749486,Cho; Hye Jin,26,0,28,2
1731507546559,LTKO 1B,B01,749543,Cho; Hye Jin,26,0,28,2
1731507546559,LTKO 1B,C01,749573,Tark; Eun Sun,26,0,28,2
1731507546559,LTKO 1B,D01,749575,Tark; Eun Sun,27,0,28,1
1731507546559,LTKO 1B,E01,749590,Yim; Nancy,28,0,28,0
1731507546559,LTKO 1B,F01,749632,Yim; Nancy,28,0,28,0
1731507547587,LTKO 2B,A01,749700,Lee; Jeyseon,23,0,28,5
1731507548613,LTKO 130W,A00,750479,Lee; Jeyseon,25,0,25,0
1731507549639,LTLA 2,A00,749738,Murray; Kourtney Kristine,44,0,45,1
1731507550668,LTLA 105,A00,750480,Kelting; Edward William,24,0,25,1
1731507551697,LTRU 1B,A01,749758,Wells; Patricia Rebecca,26,0,28,2
1731507552727,LTRU 2B,A01,749788,Wells; Patricia Rebecca,25,0,25,0
1731507553752,LTRU 104C,A01,750482,Wells; Patricia Rebecca,20,0,20,0
1731507554778,LTRU 110C,B00,750484,Morse; Ainsley,10,0,10,0
1731507555808,LTSP 2A,A01,749790,Lampell; Toni,23,0,28,5
1731507556837,LTSP 2B,A01,749855,Mastromartino; Alexandra L,26,0,28,2
1731507556837,LTSP 2B,B01,749857,Mastromartino; Alexandra L,26,0,28,2
1731507557865,LTSP 2C,A01,749859,Lampell; Toni,25,0,28,3
1731507558891,LTSP 2F,A00,749860,Mastromartino; Alexandra L,25,0,25,0
1731507559918,LTSP 3F,A00,749861,Dominguez; Noelia,25,0,25,0
1731507559918,LTSP 3F,B00,749862,Dominguez; Noelia,23,0,25,2
1731507560946,LTSP 100F,A00,750494,Arcos Herrera; Carol,25,0,25,0
1731507560946,LTSP 100F,B00,750495,Dominguez; Noelia,24,0,25,1
1731507560946,LTSP 100F,C00,750547,Villafuerte Vazquez; Nadia,25,0,25,0
1731507561976,LTSP 116,A00,750557,Arcos Herrera; Carol,40,0,40,0
1731507563008,LTSP 135B,A00,750560,Sanchez Cruz; Jorge,39,0,40,1
1731507564032,LTSP 145,A00,750561,Martin-Cabrera; Luis,24,0,25,1
1731507565065,LTSP 155,A00,798249,Blanco; John D,40,0,40,0
1731507566092,LTSP 166,A00,750562,Carvajal Regidor; Jose,39,0,40,1
1731507567117,LTSP 172,A00,750563,Chacon; Gloria Elizabeth,40,0,40,0
1731507568143,LTTH 210B,A00,750769,Blanco; John D,15,0,15,0
1731507569173,LTWL 11,A00,749863,Dhar; Amrita,40,0,40,0
1731507570199,LTWL 19B,A00,749864,Myerston Santana; Jacobo,38,0,40,2
1731507571229,LTWL 102,A00,750565,Myerston Santana; Jacobo,23,0,25,2
1731507572263,LTWL 120,A00,750578,Mendoza; Andrea,38,0,40,2
1731507573290,LTWL 124,A00,750579,Garofalo; Devin,39,0,40,1
1731507574316,LTWL 165,A00,750587,Kim; Joo Ok,40,0,40,0
1731507575343,LTWL 180,A00,750613,Nguyen; Hoang Tan,39,0,40,1
1731507576370,LTWL 184,A00,750625,Mukherjee; Silpa,38,0,40,2
1731507577421,LTWR 8A,A01,749866,Hoang; Lily Kim,25,0,28,3
1731507577421,LTWR 8A,A02,749867,Hoang; Lily Kim,28,0,28,0
1731507577421,LTWR 8A,A03,749868,Hoang; Lily Kim,25,0,28,3
1731507577421,LTWR 8A,A04,749869,Hoang; Lily Kim,24,0,28,4
1731507578448,LTWR 8B,A01,749872,Som; Brandon D,27,0,28,1
1731507578448,LTWR 8B,A02,749873,Som; Brandon D,27,0,28,1
1731507578448,LTWR 8B,A03,749874,Som; Brandon D,27,0,28,1
1731507578448,LTWR 8B,A04,749875,Som; Brandon D,28,0,28,0
1731507579474,LTWR 101C,A00,750638,Villafuerte Vazquez; Nadia,30,0,30,0
1731507580505,LTWR 109C,A00,795232,Terry; Christopher,24,0,30,6
1731507581533,LTWR 110C,A00,795236,Terry; Christopher,25,0,30,5
1731507582558,LTWR 113C,A00,750640,Carroll; Amy Sara,29,0,30,1
1731507583584,LTWR 114W,A00,750675,Springer; Anna Joy,14,0,15,1
1731507584609,LTWR 115C,A00,750677,Lopez; Casandra,28,0,30,2
1731507585641,LTWR 120C,A00,750678,Wilkinson; Marco,29,0,30,1
1731507586670,LTWR 121C,A00,795237,Terry; Christopher,26,0,30,4
1731507587696,LTWR 126W,A00,750739,Lopez; Casandra,13,0,15,2
1731507588725,LTWR 144,A00,795207,Hoang; Lily Kim,23,0,25,2
1731507589754,LTWR 215,A00,750771,Wilkinson; Marco,14,0,20,6
1731507591018,LTWR 220,A00,750778,Som; Brandon D,9,0,15,6
1731507592047,MAE 8,A01,754809,Arefiev; Alexey,136,0,140,4
1731507593075,MAE 20,A00,754810,Evdokimenko; Ekaterina,57,0,60,3
1731507594101,MAE 30A,A00,754811,Qi; Huihui,100,0,100,0
1731507594101,MAE 30A,B00,754812,Qi; Huihui,78,0,100,22
1731507595132,MAE 30B,A00,754813,Delson; Nathan Joseph,63,0,65,2
1731507596158,MAE 40,A00,754814,Cortes; Jorge,90,0,104,14
1731507597184,MAE 101A,A00,754815,Nomura; Keiko K.,140,0,150,10
1731507598210,MAE 101B,A00,754816,Pham; Hieu Tan,110,0,120,10
1731507599239,MAE 114,A00,754817,Krasheninnikov; Sergei,49,0,50,1
1731507600269,MAE 118,A00,754818,Marinoni; Alessandro,40,0,45,5
1731507601307,MAE 120,A00,754819,Krasheninnikov; Sergei,53,0,60,7
1731507602335,MAE 125,A00,754820,Kleissl; Jan,56,0,75,19
1731507603369,MAE 130,A00,754821,Frazier; Michael,59,0,60,1
1731507604396,MAE 131B,A00,754822,Scholtes Acevedo; Claire,99,0,100,1
1731507605425,MAE 142,A00,754823,Anderson; Mark Ronald,31,0,60,29
1731507606459,MAE 143A,A00,754824,Diagne; Mamadou Lamine,58,0,75,17
1731507606459,MAE 143A,B00,754825,Kramer; Boris,66,0,75,9
1731507607487,MAE 143B,A00,754826,Morimoto; Tania,83,0,100,17
1731507608513,MAE 148,A01,754828,Silberman; Jack,21,0,24,3
1731507609540,MAE 155A,A01,754830,Anderson; Mark Ronald,14,0,50,36
1731507609540,MAE 155A,B01,754832,Hwang; John T,35,0,50,15
1731507610578,MAE 156A,A01,754834,Gravish; Nicholas G & Tustaniwskyj; Jerry I & Mullin; Jennifer S & Lubarda; Marko & Delson; Nathan Joseph,0,0,12,12
1731507610578,MAE 156A,A02,754835,Gravish; Nicholas G & Tustaniwskyj; Jerry I & Delson; Nathan Joseph & Mullin; Jennifer S & Lubarda; Marko,7,0,12,5
1731507610578,MAE 156A,A03,754874,Gravish; Nicholas G & Tustaniwskyj; Jerry I & Mullin; Jennifer S & Lubarda; Marko & Delson; Nathan Joseph,0,0,12,12
1731507610578,MAE 156A,A04,754891,Gravish; Nicholas G & Tustaniwskyj; Jerry I & Mullin; Jennifer S & Lubarda; Marko & Delson; Nathan Joseph,12,0,12,0
1731507610578,MAE 156A,A05,754898,Gravish; Nicholas G & Tustaniwskyj; Jerry I & Mullin; Jennifer S & Lubarda; Marko & Delson; Nathan Joseph,0,0,12,12
1731507610578,MAE 156A,A06,754899,Gravish; Nicholas G & Tustaniwskyj; Jerry I & Delson; Nathan Joseph & Mullin; Jennifer S & Lubarda; Marko,10,0,12,2
1731507610578,MAE 156A,A07,754900,Gravish; Nicholas G & Tustaniwskyj; Jerry I & Mullin; Jennifer S & Lubarda; Marko & Delson; Nathan Joseph,8,0,12,4
1731507610578,MAE 156A,A08,754933,Gravish; Nicholas G & Tustaniwskyj; Jerry I & Mullin; Jennifer S & Lubarda; Marko & Delson; Nathan Joseph,10,0,12,2
1731507610578,MAE 156A,A09,754937,Gravish; Nicholas G & Tustaniwskyj; Jerry I & Mullin; Jennifer S & Lubarda; Marko & Delson; Nathan Joseph,8,0,14,6
1731507610578,MAE 156A,A10,754970,Gravish; Nicholas G & Tustaniwskyj; Jerry I & Delson; Nathan Joseph & Mullin; Jennifer S & Lubarda; Marko,1,0,8,7
1731507610578,MAE 156A,A11,754971,Gravish; Nicholas G & Tustaniwskyj; Jerry I & Mullin; Jennifer S & Lubarda; Marko & Delson; Nathan Joseph,3,0,8,5
1731507610578,MAE 156A,A12,754972,Gravish; Nicholas G & Tustaniwskyj; Jerry I & Mullin; Jennifer S & Lubarda; Marko & Delson; Nathan Joseph,4,0,8,4
1731507610578,MAE 156A,A13,754973,Gravish; Nicholas G & Tustaniwskyj; Jerry I & Mullin; Jennifer S & Lubarda; Marko & Delson; Nathan Joseph,5,0,8,3
1731507610578,MAE 156A,A14,754974,Gravish; Nicholas G & Tustaniwskyj; Jerry I & Delson; Nathan Joseph & Mullin; Jennifer S & Lubarda; Marko,6,0,8,2
1731507610578,MAE 156A,A15,754975,Gravish; Nicholas G & Tustaniwskyj; Jerry I & Mullin; Jennifer S & Lubarda; Marko & Delson; Nathan Joseph,4,0,8,4
1731507610578,MAE 156A,A16,754976,Gravish; Nicholas G & Tustaniwskyj; Jerry I & Mullin; Jennifer S & Lubarda; Marko & Delson; Nathan Joseph,6,0,8,2
1731507610578,MAE 156A,A17,754977,Gravish; Nicholas G & Tustaniwskyj; Jerry I & Mullin; Jennifer S & Lubarda; Marko & Delson; Nathan Joseph,7,0,8,1
1731507610578,MAE 156A,A18,754978,Gravish; Nicholas G & Tustaniwskyj; Jerry I & Delson; Nathan Joseph & Mullin; Jennifer S & Lubarda; Marko,6,0,6,0
1731507611608,MAE 156B,A01,754980,Staff,30,0,36,6
1731507611608,MAE 156B,B01,754982,Tustaniwskyj; Jerry I,25,0,36,11
1731507612637,MAE 160,A00,754983,Evdokimenko; Ekaterina,151,0,165,14
1731507613663,MAE 171A,A01,754985,Kleissl; Jan,24,0,32,8
1731507613663,MAE 171A,A02,754986,Kleissl; Jan,23,0,32,9
1731507613663,MAE 171A,A03,754987,Kleissl; Jan,2,0,32,30
1731507613663,MAE 171A,A04,754988,Kleissl; Jan,0,0,32,32
1731507613663,MAE 171A,A05,754989,Kleissl; Jan,30,0,32,2
1731507613663,MAE 171A,A06,754990,Kleissl; Jan,20,0,32,12
1731507613663,MAE 171A,A07,754991,Kleissl; Jan,25,0,32,7
1731507613663,MAE 171A,A08,754992,Kleissl; Jan,15,0,32,17
1731507613663,MAE 171A,A09,754993,Kleissl; Jan,20,0,24,4
1731507614690,MAE 175A,A01,754995,de Callafon; Raymond A,13,0,16,3
1731507614690,MAE 175A,A02,754996,de Callafon; Raymond A,5,0,16,11
1731507614690,MAE 175A,A03,754997,de Callafon; Raymond A,16,0,16,0
1731507614690,MAE 175A,A04,754998,de Callafon; Raymond A,13,0,16,3
1731507614690,MAE 175A,A05,754999,de Callafon; Raymond A,7,0,16,9
1731507614690,MAE 175A,A06,755052,de Callafon; Raymond A,14,0,15,1
1731507615717,MAE 180,A00,755116,Rosengren; Aaron,53,0,60,7
1731507616744,MAE 200,A00,755117,Diagne; Mamadou Lamine,0,0,50,50
1731507617778,MAE 204,A00,755186,Tolley; Michael Thomas,21,0,100,79
1731507618806,MAE 205,A00,755187,Diagne; Mamadou Lamine & Tynan; George Robert & Scholtes Acevedo; Claire & Qi; Huihui & Hao; Xuanting & Garay; Javier,9990,0,9999,9
1731507619835,MAE 206,A00,755188,Tynan; George Robert,23,0,80,57
1731507620861,MAE 207,A00,755193,Poulikakos; Lisa Voula,17,0,30,13
1731507620861,MAE 207,B00,755199,Staff,51,0,60,9
1731507621888,MAE 208,A00,755212,Saintillan; David,6,0,30,24
1731507622915,MAE 210B,A00,755213,Sanchez; Antonio Luis,13,0,30,17
1731507623945,MAE 210C,A00,755214,Becker; Janet Maria,11,0,15,4
1731507624970,MAE 212,A00,755215,Sanchez; Antonio Luis,18,0,40,22
1731507625996,MAE 217B,A00,755216,Arefiev; Alexey,6,0,10,4
1731507627026,MAE 221B,A00,755217,Coimbra; Carlos F.,7,0,15,8
1731507628054,MAE 221C,A00,755218,Saha; Abhishek,3,0,10,7
1731507629085,MAE 231C,A00,755220,Jandaghi Semnani; Shabnam,4,0,5,1
1731507630113,MAE 232B,A00,755221,Chen; Jiun-Shyan,0,0,10,10
1731507631140,MAE 248,A00,755222,Herbert; Sylvia Lee,15,0,15,0
1731507632165,MAE 261,A00,755223,Lindsey; Stephanie,10,0,10,0
1731507633194,MAE 270,A00,755224,Hwang; John T,0,0,15,15
1731507634227,MAE 271A,A00,755226,Luo; Jian,2,0,5,3
1731507635257,MAE 274,A00,755299,Kramer; Boris,0,0,0,0
1731507636282,MAE 276,A00,755300,Cai; Shengqiang,0,0,20,20
1731507637309,MAE 281A,A00,755301,Krstic; Miroslav,19,0,42,23
1731507638339,MAE 289B,A00,755302,Martinez; Sonia,10,0,10,0
1731507639370,MAE 290B,A00,755303,Sarkar; Sutanu,20,0,40,20
1731507640397,MAE 294B,A00,755304,Llewellyn Smith; Stefan G.,7,0,10,3
1731507641431,MATH 2,A01,751732,Cheng; Hsiao-Bing,193,0,200,7
1731507641431,MATH 2,B01,751734,Cheng; Hsiao-Bing,196,0,200,4
1731507642458,MATH 3B,A01,751736,Hammock; Frances H,33,0,33,0
1731507642458,MATH 3B,A02,751737,Hammock; Frances H,24,0,33,9
1731507642458,MATH 3B,A03,751738,Hammock; Frances H,33,0,33,0
1731507642458,MATH 3B,A04,751739,Hammock; Frances H,30,0,33,3
1731507642458,MATH 3B,A05,751740,Hammock; Frances H,30,0,31,1
1731507642458,MATH 3B,A06,751741,Hammock; Frances H,31,0,33,2
1731507642458,MATH 3B,B01,751743,Staff,27,0,32,5
1731507642458,MATH 3B,B02,751744,Staff,32,0,32,0
1731507642458,MATH 3B,B03,751745,Staff,29,0,32,3
1731507642458,MATH 3B,B04,751746,Staff,31,0,32,1
1731507642458,MATH 3B,B05,751765,Staff,32,0,32,0
1731507642458,MATH 3B,B06,751766,Staff,32,0,32,0
1731507643497,MATH 3C,A01,751774,Hammock; Frances H,29,0,30,1
1731507643497,MATH 3C,A02,751775,Hammock; Frances H,26,0,30,4
1731507643497,MATH 3C,A03,751776,Hammock; Frances H,30,0,30,0
1731507643497,MATH 3C,A04,751781,Hammock; Frances H,25,0,30,5
1731507643497,MATH 3C,A05,751782,Hammock; Frances H,20,0,30,10
1731507643497,MATH 3C,A06,751952,Hammock; Frances H,30,0,30,0
1731507643497,MATH 3C,B01,752043,Staff,32,0,35,3
1731507643497,MATH 3C,B02,752094,Staff,35,0,35,0
1731507643497,MATH 3C,B03,752188,Staff,35,0,35,0
1731507643497,MATH 3C,B04,752210,Staff,33,0,35,2
1731507643497,MATH 3C,C01,752281,Yin; Wei,31,0,32,1
1731507643497,MATH 3C,C02,752282,Yin; Wei,31,0,32,1
1731507643497,MATH 3C,C03,752283,Yin; Wei,32,0,32,0
1731507643497,MATH 3C,C04,752284,Yin; Wei,32,0,32,0
1731507644525,MATH 4C,A01,752286,Aliabadi Sr.; Mohsen,31,0,35,4
1731507644525,MATH 4C,A02,752287,Aliabadi Sr.; Mohsen,35,0,35,0
1731507644525,MATH 4C,A03,752290,Aliabadi Sr.; Mohsen,35,0,35,0
1731507644525,MATH 4C,A04,752291,Aliabadi Sr.; Mohsen,35,0,35,0
1731507645554,MATH 10A,A01,752293,Hiatt; Patrick John,20,0,32,12
1731507645554,MATH 10A,A02,752294,Hiatt; Patrick John,28,0,32,4
1731507645554,MATH 10A,A03,752296,Hiatt; Patrick John,31,0,32,1
1731507645554,MATH 10A,A04,752297,Hiatt; Patrick John,30,0,32,2
1731507645554,MATH 10A,B01,752306,Hiatt; Patrick John,23,0,32,9
1731507645554,MATH 10A,B02,752362,Hiatt; Patrick John,31,0,32,1
1731507645554,MATH 10A,B03,752366,Hiatt; Patrick John,32,0,32,0
1731507645554,MATH 10A,B04,752372,Hiatt; Patrick John,30,0,32,2
1731507645554,MATH 10A,B05,752415,Hiatt; Patrick John,32,0,32,0
1731507645554,MATH 10A,B06,752463,Hiatt; Patrick John,32,0,32,0
1731507645554,MATH 10A,C01,752582,Hardiman; Liam,53,0,58,5
1731507645554,MATH 10A,C02,752589,Hardiman; Liam,57,0,60,3
1731507645554,MATH 10A,C03,752591,Hardiman; Liam,31,0,32,1
1731507645554,MATH 10A,C04,752592,Hardiman; Liam,32,0,32,0
1731507645554,MATH 10A,C05,796290,Hardiman; Liam,59,0,60,1
1731507645554,MATH 10A,C06,796293,Hardiman; Liam,60,0,60,0
1731507645554,MATH 10A,D01,752596,Briones; Jor-el Thomas Caparas,84,0,100,16
1731507645554,MATH 10A,D02,752597,Briones; Jor-el Thomas Caparas,99,0,100,1
1731507646588,MATH 10B,A01,752608,Zhao; Yizhen,0,0,0,0
1731507646588,MATH 10B,A02,752609,Zhao; Yizhen,0,0,0,0
1731507646588,MATH 10B,A03,752620,Zhao; Yizhen,0,0,0,0
1731507646588,MATH 10B,A04,752621,Zhao; Yizhen,0,0,0,0
1731507646588,MATH 10B,A05,752622,Zhao; Yizhen,0,0,0,0
1731507646588,MATH 10B,A06,752626,Zhao; Yizhen,0,0,0,0
1731507646588,MATH 10B,B01,752730,Zhao; Yizhen,0,0,0,0
1731507646588,MATH 10B,B02,752731,Zhao; Yizhen,0,0,0,0
1731507646588,MATH 10B,B03,752733,Zhao; Yizhen,0,0,0,0
1731507646588,MATH 10B,B04,752736,Zhao; Yizhen,0,0,0,0
1731507646588,MATH 10B,B05,796263,Zhao; Yizhen,0,0,0,0
1731507646588,MATH 10B,B06,796264,Zhao; Yizhen,0,0,0,0
1731507646588,MATH 10B,C01,752739,Goffer; Gil,0,0,0,0
1731507646588,MATH 10B,C02,752740,Goffer; Gil,0,0,0,0
1731507646588,MATH 10B,C03,752771,Goffer; Gil,0,0,0,0
1731507646588,MATH 10B,C04,752779,Goffer; Gil,0,0,0,0
1731507646588,MATH 10B,D01,752787,Buzaglo; Lucas,0,0,0,0
1731507646588,MATH 10B,D02,752793,Buzaglo; Lucas,0,0,0,0
1731507646588,MATH 10B,D03,752794,Buzaglo; Lucas,0,0,0,0
1731507646588,MATH 10B,D04,752800,Buzaglo; Lucas,0,0,0,0
1731507646588,MATH 10B,E01,752805,Bach; Quang Tran,0,0,0,0
1731507646588,MATH 10B,E02,752810,Bach; Quang Tran,0,0,0,0
1731507647618,MATH 10C,A01,752869,Nag; Panchali,32,0,32,0
1731507647618,MATH 10C,A02,752899,Nag; Panchali,29,0,32,3
1731507647618,MATH 10C,A03,752901,Nag; Panchali,32,0,32,0
1731507647618,MATH 10C,A04,752902,Nag; Panchali,32,0,32,0
1731507647618,MATH 10C,A05,752903,Nag; Panchali,32,0,32,0
1731507647618,MATH 10C,A06,752904,Nag; Panchali,31,0,32,1
1731507647618,MATH 10C,B01,752908,Nag; Panchali,11,0,27,16
1731507647618,MATH 10C,B02,752913,Nag; Panchali,28,0,30,2
1731507647618,MATH 10C,B03,752914,Nag; Panchali,28,0,30,2
1731507647618,MATH 10C,B04,752916,Nag; Panchali,28,0,30,2
1731507648653,MATH 11,A01,752921,Rava; Denise,35,0,36,1
1731507648653,MATH 11,A02,752922,Rava; Denise,29,0,36,7
1731507648653,MATH 11,A03,752924,Rava; Denise,34,0,36,2
1731507648653,MATH 11,A04,752932,Rava; Denise,36,0,36,0
1731507648653,MATH 11,A05,752936,Rava; Denise,35,0,36,1
1731507648653,MATH 11,A06,752984,Rava; Denise,35,0,36,1
1731507648653,MATH 11,B01,752988,Staff,29,0,35,6
1731507648653,MATH 11,B02,752991,Staff,33,0,35,2
1731507648653,MATH 11,B03,752994,Staff,54,0,56,2
1731507648653,MATH 11,B04,752998,Staff,60,0,60,0
1731507649694,MATH 18,A01,753003,Anzaldo; Leesa B,27,0,60,33
1731507649694,MATH 18,A02,753004,Anzaldo; Leesa B,53,0,60,7
1731507649694,MATH 18,A03,753005,Anzaldo; Leesa B,58,0,60,2
1731507649694,MATH 18,A04,753006,Anzaldo; Leesa B,59,0,60,1
1731507649694,MATH 18,A05,753009,Anzaldo; Leesa B,59,0,60,1
1731507649694,MATH 18,A06,753010,Anzaldo; Leesa B,60,0,60,0
1731507649694,MATH 18,A07,753011,Anzaldo; Leesa B,28,0,32,4
1731507649694,MATH 18,A08,753013,Anzaldo; Leesa B,20,0,22,2
1731507649694,MATH 18,A09,753014,Anzaldo; Leesa B,30,0,32,2
1731507649694,MATH 18,A10,753041,Anzaldo; Leesa B,32,0,32,0
1731507649694,MATH 18,A11,753066,Anzaldo; Leesa B,32,0,32,0
1731507649694,MATH 18,A12,753067,Anzaldo; Leesa B,30,0,32,2
1731507649694,MATH 18,B01,753070,Ganesan; Priyanga,96,0,100,4
1731507649694,MATH 18,B02,753071,Ganesan; Priyanga,99,0,100,1
1731507649694,MATH 18,C01,753074,Ganesan; Priyanga,39,0,45,6
1731507649694,MATH 18,C02,753075,Ganesan; Priyanga,44,0,45,1
1731507649694,MATH 18,C03,753076,Ganesan; Priyanga,44,0,45,1
1731507649694,MATH 18,C04,753077,Ganesan; Priyanga,45,0,45,0
1731507650723,MATH 20A,A01,753159,Ho; Ching Wei,29,0,30,1
1731507650723,MATH 20A,A02,753160,Ho; Ching Wei,10,0,26,16
1731507650723,MATH 20A,A03,753161,Ho; Ching Wei,27,0,30,3
1731507650723,MATH 20A,A04,753162,Ho; Ching Wei,29,0,30,1
1731507650723,MATH 20A,B01,753169,Ho; Ching Wei,55,0,60,5
1731507650723,MATH 20A,B02,753170,Ho; Ching Wei,56,0,60,4
1731507650723,MATH 20A,B03,753171,Ho; Ching Wei,34,0,35,1
1731507650723,MATH 20A,B04,753172,Ho; Ching Wei,35,0,35,0
1731507651767,MATH 20B,A01,753174,Habib; Yousaf,34,0,34,0
1731507651767,MATH 20B,A02,753175,Habib; Yousaf,33,0,34,1
1731507651767,MATH 20B,A03,753176,Habib; Yousaf,34,0,34,0
1731507651767,MATH 20B,A04,753177,Habib; Yousaf,34,0,34,0
1731507651767,MATH 20B,B01,753179,Habib; Yousaf,31,0,33,2
1731507651767,MATH 20B,B02,753180,Habib; Yousaf,33,0,33,0
1731507651767,MATH 20B,B03,753181,Habib; Yousaf,33,0,33,0
1731507651767,MATH 20B,B04,753188,Habib; Yousaf,33,0,33,0
1731507651767,MATH 20B,B05,753194,Habib; Yousaf,33,0,33,0
1731507651767,MATH 20B,B06,753195,Habib; Yousaf,33,0,33,0
1731507651767,MATH 20B,C01,753260,Upadrashta; Pranav Kumar,69,0,75,6
1731507651767,MATH 20B,C02,753261,Upadrashta; Pranav Kumar,75,0,75,0
1731507651767,MATH 20B,D01,753352,Upadrashta; Pranav Kumar,65,0,65,0
1731507651767,MATH 20B,D02,753356,Upadrashta; Pranav Kumar,65,0,65,0
1731507651767,MATH 20B,D03,753357,Upadrashta; Pranav Kumar,25,0,32,7
1731507651767,MATH 20B,D04,753361,Upadrashta; Pranav Kumar,31,0,32,1
1731507651767,MATH 20B,E01,753380,Xu; Fengmin,20,0,26,6
1731507651767,MATH 20B,E02,753384,Xu; Fengmin,30,0,32,2
1731507651767,MATH 20B,E03,753385,Xu; Fengmin,32,0,32,0
1731507651767,MATH 20B,E04,753388,Xu; Fengmin,31,0,32,1
1731507651767,MATH 20B,E05,753392,Xu; Fengmin,32,0,32,0
1731507651767,MATH 20B,E06,753393,Xu; Fengmin,32,0,32,0
1731507652803,MATH 20C,A01,753398,Ohm; Ko Woon,77,0,94,17
1731507652803,MATH 20C,A02,753402,Ohm; Ko Woon,98,0,100,2
1731507652803,MATH 20C,A03,753409,Ohm; Ko Woon,98,0,100,2
1731507652803,MATH 20C,A04,753412,Ohm; Ko Woon,100,0,100,0
1731507652803,MATH 20C,A05,753503,Ohm; Ko Woon,25,0,40,15
1731507652803,MATH 20C,A06,753504,Ohm; Ko Woon,35,0,40,5
1731507652803,MATH 20C,A07,753509,Ohm; Ko Woon,39,0,40,1
1731507652803,MATH 20C,A08,753510,Ohm; Ko Woon,40,0,40,0
1731507652803,MATH 20C,B01,753513,Staff,58,0,60,2
1731507652803,MATH 20C,B02,753514,Staff,60,0,60,0
1731507652803,MATH 20C,B03,753516,Staff,60,0,60,0
1731507652803,MATH 20C,C01,753518,Yin; Wei,59,0,60,1
1731507652803,MATH 20C,C02,753519,Yin; Wei,32,0,32,0
1731507652803,MATH 20C,C03,753520,Yin; Wei,24,0,32,8
1731507652803,MATH 20C,C04,753521,Yin; Wei,32,0,32,0
1731507652803,MATH 20C,C05,753524,Yin; Wei,32,0,32,0
1731507653839,MATH 20D,A01,753531,Staff,28,0,35,7
1731507653839,MATH 20D,A02,753532,Staff,28,0,29,1
1731507653839,MATH 20D,A03,753533,Staff,35,0,35,0
1731507653839,MATH 20D,A04,753535,Staff,35,0,35,0
1731507653839,MATH 20D,B01,753549,Hardiman; Liam,31,0,35,4
1731507653839,MATH 20D,B02,753592,Hardiman; Liam,35,0,35,0
1731507653839,MATH 20D,B03,753594,Hardiman; Liam,35,0,35,0
1731507653839,MATH 20D,B04,753595,Hardiman; Liam,34,0,35,1
1731507653839,MATH 20D,C01,753600,Gartland; Christopher John,96,0,100,4
1731507653839,MATH 20D,C02,753622,Gartland; Christopher John,98,0,100,2
1731507653839,MATH 20D,D01,753628,Gartland; Christopher John,35,0,35,0
1731507653839,MATH 20D,D02,753635,Gartland; Christopher John,35,0,35,0
1731507653839,MATH 20D,D03,753636,Gartland; Christopher John,60,0,60,0
1731507653839,MATH 20D,D04,753643,Gartland; Christopher John,60,0,60,0
1731507654866,MATH 20E,A01,753646,Bach; Quang Tran,24,0,32,8
1731507654866,MATH 20E,A02,753668,Bach; Quang Tran,33,0,35,2
1731507654866,MATH 20E,A03,753669,Bach; Quang Tran,35,0,35,0
1731507654866,MATH 20E,A04,753670,Bach; Quang Tran,35,0,35,0
1731507654866,MATH 20E,A05,753671,Bach; Quang Tran,30,0,30,0
1731507654866,MATH 20E,A06,753672,Bach; Quang Tran,30,0,30,0
1731507654866,MATH 20E,A07,796295,Bach; Quang Tran,60,0,60,0
1731507654866,MATH 20E,A08,796317,Bach; Quang Tran,60,0,60,0
1731507654866,MATH 20E,B01,753699,Sanchez; Anthony,30,0,35,5
1731507654866,MATH 20E,B02,753700,Sanchez; Anthony,35,0,35,0
1731507654866,MATH 20E,B03,753701,Sanchez; Anthony,64,0,65,1
1731507654866,MATH 20E,B04,753702,Sanchez; Anthony,65,0,65,0
1731507655894,MATH 31BH,A01,753704,De Vleming; Kristin Elizab,35,0,35,0
1731507655894,MATH 31BH,A02,753705,De Vleming; Kristin Elizab,35,0,35,0
1731507656924,MATH 87,A00,795962,Rabin; Jeffrey Mark,18,0,20,2
1731507657955,MATH 95,A00,753706,Stevens; Laura Jeanne,31,0,35,4
1731507659040,MATH 100A,A01,753708,Aycock; Jon Merrill,31,0,35,4
1731507659040,MATH 100A,A02,753709,Aycock; Jon Merrill,35,0,35,0
1731507660069,MATH 100B,A01,753711,Rogalski; Daniel,23,0,35,12
1731507660069,MATH 100B,A02,753712,Rogalski; Daniel,32,0,35,3
1731507661097,MATH 102,A01,753714,Harel; Guershon,34,0,35,1
1731507661097,MATH 102,A02,753740,Harel; Guershon,35,0,35,0
1731507661097,MATH 102,B01,753742,Ophir; Amit,32,0,35,3
1731507661097,MATH 102,B02,753743,Ophir; Amit,35,0,35,0
1731507662130,MATH 103A,A01,753745,Buzaglo; Lucas,26,0,30,4
1731507662130,MATH 103A,A02,753746,Buzaglo; Lucas,29,0,30,1
1731507662130,MATH 103A,B01,753748,Goffer; Gil,35,0,35,0
1731507662130,MATH 103A,B02,753749,Goffer; Gil,35,0,35,0
1731507662130,MATH 103A,C01,753751,Wenzl; Hans G,35,0,35,0
1731507662130,MATH 103A,C02,753798,Wenzl; Hans G,34,0,35,1
1731507663163,MATH 103B,A01,753805,Klevdal; Christian Sleek,29,0,30,1
1731507663163,MATH 103B,A02,753806,Klevdal; Christian Sleek,29,0,30,1
1731507663163,MATH 103B,A03,796050,Klevdal; Christian Sleek,26,0,30,4
1731507663163,MATH 103B,B01,753841,Wesley; William J,27,0,35,8
1731507663163,MATH 103B,B02,753842,Wesley; William J,34,0,35,1
1731507663163,MATH 103B,C01,753872,Chou; Raymond Oliver,20,0,35,15
1731507663163,MATH 103B,C02,753873,Chou; Raymond Oliver,31,0,35,4
1731507664193,MATH 104B,A01,753875,Kane; Daniel Mertz,35,0,35,0
1731507665227,MATH 109,A01,753883,Ganapathy; Karthik,7,0,10,3
1731507665227,MATH 109,A02,753884,Ganapathy; Karthik,9,0,10,1
1731507665227,MATH 109,B01,753886,Ganapathy; Karthik,9,0,10,1
1731507665227,MATH 109,B02,753887,Ganapathy; Karthik,10,0,10,0
1731507665227,MATH 109,C01,753901,Lu; Yunze,4,0,10,6
1731507665227,MATH 109,C02,753902,Lu; Yunze,10,0,10,0
1731507665227,MATH 109,D01,753912,Nandi; Achinta Kumar,10,0,10,0
1731507665227,MATH 109,D02,753928,Nandi; Achinta Kumar,9,0,10,1
1731507665227,MATH 109,E01,753935,Xiao; Ming,7,0,10,3
1731507665227,MATH 109,E02,753958,Xiao; Ming,0,0,10,10
1731507666254,MATH 111B,A01,753960,Meyer; David A.,28,0,35,7
1731507667282,MATH 112A,A01,754063,Komarova; Natalia,24,0,27,3
1731507668310,MATH 120A,A01,754070,Treuer; John N,30,0,35,5
1731507668310,MATH 120A,A02,754116,Treuer; John N,35,0,35,0
1731507669339,MATH 121A,A01,754119,Stevens; Laura Jeanne,32,0,35,3
1731507670370,MATH 140A,A01,754121,Sanchez; Anthony,30,0,35,5
1731507670370,MATH 140A,A02,754122,Sanchez; Anthony,32,0,35,3
1731507671398,MATH 140B,A01,754126,Zlatos; Andrej,34,0,35,1
1731507671398,MATH 140B,A02,754127,Zlatos; Andrej,35,0,35,0
1731507671398,MATH 140B,B01,754130,Lu; Yunze,33,0,35,2
1731507671398,MATH 140B,B02,754132,Lu; Yunze,33,0,35,2
1731507672428,MATH 142A,A01,754205,Parise; Davide,31,0,35,4
1731507672428,MATH 142A,A02,754206,Parise; Davide,33,0,35,2
1731507672428,MATH 142A,B01,754232,Kunnawalkam Elayavalli; Sr,33,0,35,2
1731507672428,MATH 142A,B02,754233,Kunnawalkam Elayavalli; Sr,35,0,35,0
1731507672428,MATH 142A,C01,754236,Nandi; Achinta Kumar,32,0,35,3
1731507672428,MATH 142A,C02,754238,Nandi; Achinta Kumar,33,0,35,2
1731507673461,MATH 142B,A01,754240,Bejenaru; Ioan,20,0,35,15
1731507673461,MATH 142B,A02,754241,Bejenaru; Ioan,30,0,35,5
1731507673461,MATH 142B,B01,754243,Sarkar; Pratyush,33,0,35,2
1731507673461,MATH 142B,B02,754244,Sarkar; Pratyush,34,0,35,1
1731507673461,MATH 142B,C01,754246,Sarkar; Pratyush,34,0,35,1
1731507673461,MATH 142B,C02,754247,Sarkar; Pratyush,35,0,35,0
1731507674492,MATH 150A,A01,754249,Rabin; Jeffrey Mark,27,0,35,8
1731507675519,MATH 154,A01,754252,Grier; Daniel T,32,0,35,3
1731507675519,MATH 154,A02,754254,Grier; Daniel T,34,0,35,1
1731507675519,MATH 154,A03,754255,Grier; Daniel T,35,0,35,0
1731507675519,MATH 154,A04,754256,Grier; Daniel T,35,0,35,0
1731507675519,MATH 154,B01,754258,Tesler; Glenn,30,0,35,5
1731507675519,MATH 154,B02,754259,Tesler; Glenn,35,0,35,0
1731507675519,MATH 154,B03,754261,Tesler; Glenn,33,0,35,2
1731507675519,MATH 154,B04,754262,Tesler; Glenn,35,0,35,0
1731507676551,MATH 170A,A01,754266,Dumitriu; Ioana,26,0,35,9
1731507676551,MATH 170A,A02,754267,Dumitriu; Ioana,33,0,35,2
1731507676551,MATH 170A,A03,754268,Dumitriu; Ioana,34,0,35,1
1731507676551,MATH 170A,A04,754269,Dumitriu; Ioana,35,0,35,0
1731507676551,MATH 170A,B01,754271,Dumitriu; Ioana,35,0,35,0
1731507676551,MATH 170A,B02,754273,Dumitriu; Ioana,34,0,35,1
1731507676551,MATH 170A,B03,754275,Dumitriu; Ioana,32,0,35,3
1731507676551,MATH 170A,B04,754276,Dumitriu; Ioana,34,0,35,1
1731507677578,MATH 170B,A01,754278,Dixit; Rishabh,25,0,35,10
1731507677578,MATH 170B,A02,754336,Dixit; Rishabh,34,0,35,1
1731507677578,MATH 170B,A03,754337,Dixit; Rishabh,34,0,35,1
1731507677578,MATH 170B,A04,754339,Dixit; Rishabh,35,0,35,0
1731507678611,MATH 171A,A01,754341,Huang; Lei,21,0,35,14
1731507678611,MATH 171A,A02,754342,Huang; Lei,27,0,35,8
1731507678611,MATH 171A,A03,754343,Huang; Lei,33,0,35,2
1731507678611,MATH 171A,A04,754345,Huang; Lei,32,0,35,3
1731507679638,MATH 173B,A01,754350,Saab; Rayan,24,0,35,11
1731507679638,MATH 173B,A02,754351,Saab; Rayan,22,0,35,13
1731507679638,MATH 173B,A03,754352,Saab; Rayan,34,0,35,1
1731507679638,MATH 173B,A04,754354,Saab; Rayan,34,0,35,1
1731507680663,MATH 175,A01,754357,Briones; Jor-el Thomas Caparas,23,0,25,2
1731507681691,MATH 180A,A01,754360,Peca-Medlin; John Michael,27,0,30,3
1731507681691,MATH 180A,A02,754362,Peca-Medlin; John Michael,30,0,30,0
1731507681691,MATH 180A,A03,754363,Peca-Medlin; John Michael,35,0,35,0
1731507681691,MATH 180A,A04,754367,Peca-Medlin; John Michael,35,0,35,0
1731507681691,MATH 180A,B01,754372,Schweinsberg; Jason,29,0,30,1
1731507681691,MATH 180A,B02,754374,Schweinsberg; Jason,30,0,30,0
1731507681691,MATH 180A,B03,754376,Schweinsberg; Jason,28,0,30,2
1731507681691,MATH 180A,B04,754377,Schweinsberg; Jason,28,0,30,2
1731507681691,MATH 180A,B05,754380,Schweinsberg; Jason,29,0,30,1
1731507681691,MATH 180A,B06,754421,Schweinsberg; Jason,30,0,30,0
1731507682722,MATH 180B,A01,754423,Zheng; Tianyi,27,0,30,3
1731507682722,MATH 180B,A02,754424,Zheng; Tianyi,29,0,30,1
1731507682722,MATH 180B,A03,754425,Zheng; Tianyi,29,0,30,1
1731507682722,MATH 180B,A04,754426,Zheng; Tianyi,30,0,30,0
1731507682722,MATH 180B,B01,754428,Zheng; Tianyi,32,0,35,3
1731507682722,MATH 180B,B02,754429,Zheng; Tianyi,35,0,35,0
1731507682722,MATH 180B,B03,754438,Zheng; Tianyi,35,0,35,0
1731507682722,MATH 180B,B04,754452,Zheng; Tianyi,34,0,35,1
1731507683756,MATH 181A,A01,754454,Quarfoot; David James,27,0,30,3
1731507683756,MATH 181A,A02,754455,Quarfoot; David James,30,0,30,0
1731507683756,MATH 181A,A03,754456,Quarfoot; David James,28,0,30,2
1731507683756,MATH 181A,A04,754457,Quarfoot; David James,29,0,30,1
1731507683756,MATH 181A,B01,754459,Quarfoot; David James,23,0,30,7
1731507683756,MATH 181A,B02,754460,Quarfoot; David James,29,0,30,1
1731507683756,MATH 181A,B03,754461,Quarfoot; David James,26,0,30,4
1731507683756,MATH 181A,B04,754462,Quarfoot; David James,30,0,30,0
1731507684783,MATH 181E,A01,754465,Politis; Dimitris,23,0,35,12
1731507684783,MATH 181E,A02,754466,Politis; Dimitris,32,0,35,3
1731507685816,MATH 183,A01,754468,Vishwanath; Siddharth,9,0,10,1
1731507685816,MATH 183,A02,754469,Vishwanath; Siddharth,3,0,10,7
1731507685816,MATH 183,A03,754470,Vishwanath; Siddharth,0,0,10,10
1731507685816,MATH 183,A04,754473,Vishwanath; Siddharth,8,0,10,2
1731507686843,MATH 184,A01,754527,Chou; Raymond Oliver,28,0,35,7
1731507686843,MATH 184,A02,754529,Chou; Raymond Oliver,33,0,35,2
1731507686843,MATH 184,A03,754532,Chou; Raymond Oliver,35,0,35,0
1731507686843,MATH 184,A04,754534,Chou; Raymond Oliver,35,0,35,0
1731507687871,MATH 185,A01,754537,Rava; Denise,29,0,35,6
1731507687871,MATH 185,A02,754559,Rava; Denise,29,0,35,6
1731507688897,MATH 186,A01,754624,Tesler; Glenn,21,0,33,12
1731507688897,MATH 186,A02,754625,Tesler; Glenn,26,0,33,7
1731507688897,MATH 186,A03,754626,Tesler; Glenn,18,0,33,15
1731507689923,MATH 187A,A01,754628,Bucur; Alina Ioana,11,0,30,19
1731507689923,MATH 187A,A02,754641,Bucur; Alina Ioana,29,0,30,1
1731507689923,MATH 187A,A03,754650,Bucur; Alina Ioana,25,0,30,5
1731507689923,MATH 187A,A04,754654,Bucur; Alina Ioana,28,0,30,2
1731507689923,MATH 187A,A05,754658,Bucur; Alina Ioana,26,0,30,4
1731507689923,MATH 187A,A06,754664,Bucur; Alina Ioana,29,0,30,1
1731507690951,MATH 189,A01,754672,Vishwanath; Siddharth,0,0,10,10
1731507690951,MATH 189,A02,754679,Vishwanath; Siddharth,0,0,10,10
1731507690951,MATH 189,A03,754681,Vishwanath; Siddharth,0,0,10,10
1731507690951,MATH 189,A04,754690,Vishwanath; Siddharth,0,0,10,10
1731507690951,MATH 189,A05,754694,Vishwanath; Siddharth,0,0,10,10
1731507690951,MATH 189,A06,754696,Vishwanath; Siddharth,0,0,10,10
1731507691982,MATH 190A,A01,754709,McKernan; James,25,0,35,10
1731507693007,MATH 196,A00,795968,Sorensen; Claus M,34,0,40,6
1731507694033,MATH 200B,A00,754711,Salehi Golsefidy; Alireza,18,0,20,2
1731507695063,MATH 202B,A00,754712,Novak; Jonathan I,16,0,20,4
1731507696089,MATH 203B,A00,754713,Oprea; Dragos N.,20,0,20,0
1731507697118,MATH 204B,A00,754715,Kedlaya; Kiran S.,20,0,20,0
1731507698145,MATH 207A,A00,754716,Mohammadi; Amir,17,0,20,3
1731507699174,MATH 208,A00,754718,Oprea; Dragos N.,10,0,10,0
1731507700201,MATH 209,A00,754719,Bucur; Alina Ioana,10,0,10,0
1731507701230,MATH 211A,A00,754720,Salehi Golsefidy; Alireza,9,0,10,1
1731507702254,MATH 211B,A00,754722,Sanchez; Anthony,10,0,10,0
1731507703278,MATH 212A,A01,754725,Komarova; Natalia,0,0,5,5
1731507704305,MATH 216B,A00,754727,Saab; Rayan,14,0,20,6
1731507705333,MATH 218,A00,754729,Komarova; Natalia,10,0,10,0
1731507706358,MATH 220B,A00,754730,Xiao; Ming,16,0,20,4
1731507707387,MATH 231B,A00,754731,Zlatos; Andrej,20,0,20,0
1731507708418,MATH 240B,A00,754733,Spolaor; Luca,18,0,20,2
1731507709447,MATH 243,A00,754734,Kunnawalkam Elayavalli; Sr,10,0,10,0
1731507710479,MATH 247A,A00,754736,Frisch; Joshua R,25,0,25,0
1731507711508,MATH 248,A00,754738,Bejenaru; Ioan,10,0,10,0
1731507712541,MATH 250B,A00,754740,Ni; Lei,17,0,20,3
1731507713570,MATH 257A,A00,754741,Spolaor; Luca,18,0,20,2
1731507713570,MATH 257A,B00,754742,Roberts; Justin Deritter,18,0,20,2
1731507714599,MATH 258,A00,754743,Ni; Lei,10,0,10,0
1731507715624,MATH 264B,A00,754745,Rhoades; Brendon Patrick,19,0,20,1
1731507716650,MATH 269,A00,754749,Warnke; Lutz Peter,10,0,10,0
1731507717677,MATH 270B,A00,754750,Leok; Melvin,13,0,20,7
1731507718704,MATH 271B,A00,754752,Nie; Jiawang,15,0,20,5
1731507719734,MATH 272B,A00,754754,Miller; Pearson,19,0,20,1
1731507720762,MATH 275,A01,754757,Briones; Jor-el Thomas Caparas,8,0,10,2
1731507721789,MATH 277A,A00,754763,Ding; Lijun,24,0,25,1
1731507721789,MATH 277A,B00,795972,Patil; Vishal Prakash,16,0,20,4
1731507722820,MATH 278A,A00,754765,Cheng; Li-Tien,10,0,10,0
1731507723847,MATH 278B,A00,754768,Cloninger; Alexander,9,0,10,1
1731507724877,MATH 278C,A00,754770,Nie; Jiawang,10,0,10,0
1731507725913,MATH 280B,A00,754780,Kemp; Todd Aahron,15,0,20,5
1731507726940,MATH 281B,A00,754788,Bradic; Jelena,1,0,20,19
1731507727967,MATH 282B,A00,754796,Arias-Castro; Ery,6,0,20,14
1731507728998,MATH 288,A00,754800,Ang; Jie Jun,10,0,10,0
1731507730024,MATH 290B,A00,754801,Sorensen; Claus M,19,0,20,1
1731507731050,MATH 292,A00,754802,Lu; Yunze,9,0,10,1
1731507732076,MATH 295,A00,754804,Bejenaru; Ioan,15,0,15,0
1731507733105,MATH 297,001,754807,Gamst; Anthony Collins,0,0,0,0
1731507734133,MATS 200,A00,751610,Graeve; Olivia A,9976,0,9999,23
1731507735158,MATS 201A,A00,751611,Luo; Jian,19,0,55,36
1731507736185,MATS 231,A00,751612,Cai; Shengqiang,14,0,25,11
1731507737210,MATS 255,A00,751613,Meyers; Marc,3,0,20,17
1731507738234,MATS 261A,A00,751614,Qiao; Yu,17,0,25,8
1731507739259,MATS 295,A00,751660,Graeve; Olivia A,9999,0,9999,0
1731507740289,MATS 296,A00,751661,Kim; Hyonny,9999,0,9999,0
1731507740289,MATS 296,B00,751665,Bandaru; Prabhakar,9999,0,9999,0
1731507741315,MBC 259,A00,799573,Murray; Samantha J.,2,0,26,24
1731507742345,MCWP 40,001,755308,Wastal; Carrie King,15,0,15,0
1731507742345,MCWP 40,002,755309,Wastal; Carrie King,15,0,15,0
1731507742345,MCWP 40,003,755310,Montejo; Carolina,20,0,20,0
1731507742345,MCWP 40,006,755313,Duru; Nur,15,0,20,5
1731507742345,MCWP 40,007,755316,Duru; Nur,19,0,20,1
1731507742345,MCWP 40,008,755317,Duru; Nur,20,0,20,0
1731507742345,MCWP 40,012,755322,Wastal; Carrie King,15,0,15,0
1731507742345,MCWP 40,013,755323,Wastal; Carrie King,14,0,15,1
1731507742345,MCWP 40,017,755327,Bartulis; Jason Michael,11,0,20,9
1731507742345,MCWP 40,018,755328,Bartulis; Jason Michael,15,0,20,5
1731507742345,MCWP 40,019,755329,Bartulis; Jason Michael,15,0,20,5
1731507743379,MCWP 50,001,755330,Wastal; Carrie King,10,0,15,5
1731507743379,MCWP 50,002,755331,Redela; Pamela Morgan,20,0,20,0
1731507743379,MCWP 50,003,755332,Redela; Pamela Morgan,18,0,20,2
1731507743379,MCWP 50,004,755333,Redela; Pamela Morgan,18,0,20,2
1731507743379,MCWP 50,005,755334,Compas; Sean Matthew,14,0,20,6
1731507743379,MCWP 50,006,755335,Compas; Sean Matthew,17,0,20,3
1731507743379,MCWP 50,007,755336,Compas; Sean Matthew,17,0,20,3
1731507743379,MCWP 50,008,755337,Carter; Andrea L,19,0,20,1
1731507743379,MCWP 50,009,755338,Carter; Andrea L,20,0,20,0
1731507743379,MCWP 50,010,755339,Carter; Andrea L,20,0,20,0
1731507743379,MCWP 50,011,755340,Smith; Haydee Marie,16,0,20,4
1731507743379,MCWP 50,012,755341,Smith; Haydee Marie,17,0,20,3
1731507743379,MCWP 50,013,755342,Smith; Haydee Marie,20,0,20,0
1731507743379,MCWP 50,014,755344,Pham; Vincent Minhduc,20,0,20,0
1731507743379,MCWP 50,015,755345,Pham; Vincent Minhduc,20,0,20,0
1731507743379,MCWP 50,016,755346,Pham; Vincent Minhduc,20,0,20,0
1731507743379,MCWP 50,017,755347,Morshed; Michael James,13,0,20,7
1731507743379,MCWP 50,018,755382,Silva; Kelly B,20,0,20,0
1731507743379,MCWP 50,019,755685,Silva; Kelly B,20,0,20,0
1731507743379,MCWP 50,020,755686,Carter; Jennifer A,19,0,20,1
1731507743379,MCWP 50,021,755687,Carter; Jennifer A,20,0,20,0
1731507743379,MCWP 50,022,755688,Carter; Jennifer A,18,0,20,2
1731507743379,MCWP 50,024,755694,Nies; Laurie Elizabeth,16,0,20,4
1731507743379,MCWP 50,025,755695,Nies; Laurie Elizabeth,15,0,20,5
1731507743379,MCWP 50,026,755704,Krone; Jarret,17,0,20,3
1731507743379,MCWP 50,027,755711,Krone; Jarret,19,0,20,1
1731507743379,MCWP 50,028,755739,Krone; Jarret,18,0,20,2
1731507743379,MCWP 50,031,755747,Morshed; Michael James,17,0,20,3
1731507743379,MCWP 50,032,755748,Morshed; Michael James,8,0,20,12
1731507744406,MCWP 125,A00,755868,Guillen; Melinda,15,0,20,5
1731507744406,MCWP 125,B00,755870,Guillen; Melinda,8,0,20,12
1731507745437,MCWP 125R,A00,755873,Miller; Elizabeth Deen,13,0,20,7
1731507745437,MCWP 125R,B00,755874,Miller; Elizabeth Deen,18,0,20,2
1731507745437,MCWP 125R,C00,795037,Miller; Elizabeth Deen,19,0,20,1
1731507746469,MED 238,A00,755306,Chen; Ju & Sun; Wei & Shyy; Yeun-Jund & Sheikh; Farah & Ross; Robert Scott & King; Kevin R & Evans; Sylvia M & Cho; Yoshitake,5,0,10,5
1731507747501,MED 246,A00,796576,Gordts; Philip & Lewis; Amanda Lark & Godula; Kamil & Gagneux; Pascal & Esko; Jeffrey D. & Bode; Lars,10,0,10,0
1731507748531,MED 262,A00,796570,Koola; Jejo David,24,0,30,6
1731507749563,MED 263,A00,796550,Curtius; Kathleen Mary & D'Antonio; Matteo,1,0,18,17
1731507750589,MED 278,A00,796573,Carter; Hannah Kathryn,10,0,15,5
1731507751614,MED 283,A00,755307,Ideker; Trey,0,0,0,0
1731507752648,MED 296,001,791666,Malinak; David James,9,0,10,1
1731507752648,MED 296,002,791667,Von Drygalski; Annette,9,0,10,1
1731507752648,MED 296,003,791668,Chi; Neil C.,8,0,10,2
1731507752648,MED 296,004,791670,Castellanos; Luis R.,9,0,10,1
1731507753675,MGT 3,A00,766229,Wagner; Timothy Ryan,95,0,98,3
1731507754702,MGT 4,A01,766234,Levkoff; Steven B.,4,0,8,4
1731507754702,MGT 4,A02,766235,Levkoff; Steven B.,6,0,8,2
1731507754702,MGT 4,A03,766273,Levkoff; Steven B.,8,0,9,1
1731507754702,MGT 4,B01,798342,Brooks; Marcus Raymond,31,0,32,1
1731507755728,MGT 5,A00,766275,Molloie Jr.; William H,181,0,186,5
1731507756753,MGT 12,A00,766277,Pecore; Joseph P.,72,0,100,28
1731507757784,MGT 16,A00,766279,Buchanan; Harold G,97,0,100,3
1731507757784,MGT 16,B00,766282,Buchanan; Harold G,96,0,100,4
1731507757784,MGT 16,C00,766285,Campbell; Robert Harold,117,0,120,3
1731507757784,MGT 16,D00,766288,Campbell; Robert Harold,119,0,120,1
1731507757784,MGT 16,E00,766290,Demill; Burritt,98,0,98,0
1731507757784,MGT 16,F00,766291,Lindenberger; Wade Douglas,85,0,100,15
1731507758814,MGT 18,A00,766299,McKay; Michael J,97,0,98,1
1731507758814,MGT 18,B00,766308,McKay; Michael J,93,0,98,5
1731507758814,MGT 18,C00,766310,McKay; Michael J,96,0,98,2
1731507758814,MGT 18,D00,766311,Chamberlain; Travis Dean,97,0,98,1
1731507759840,MGT 45,A00,766315,Pecore; Joseph P.,141,0,150,9
1731507759840,MGT 45,B00,766322,Pecore; Joseph P.,148,0,150,2
1731507760870,MGT 52,A00,766324,Deal; Jennifer Jean,89,0,98,9
1731507761896,MGT 71R,A00,766325,Phiroz; Zal Navroze,66,0,98,32
1731507762982,MGT 100,A00,766328,Yavorsky; Daniel Ryan,107,0,120,13
1731507762982,MGT 100,B00,796601,Yavorsky; Daniel Ryan,111,0,120,9
1731507764012,MGT 103,A00,766334,Bates; Kenneth Walter,91,0,98,7
1731507764012,MGT 103,C00,766338,Eberhard; Craig A,98,0,98,0
1731507764012,MGT 103,D00,766341,Eberhard; Craig A,96,0,98,2
1731507764012,MGT 103,E00,766343,Ehrich; Kristine R,92,0,98,6
1731507764012,MGT 103,F00,766344,Ehrich; Kristine R,93,0,98,5
1731507764012,MGT 103,G00,766604,Ehrich; Kristine R,97,0,98,1
1731507765037,MGT 105,A00,796605,Bates; Kenneth Walter,91,0,98,7
1731507766063,MGT 106,A00,766605,Eberhard; Craig A,96,0,98,2
1731507767094,MGT 107,A00,766688,Jaroszewicz; Ania,97,0,98,1
1731507767094,MGT 107,B00,766721,Jaroszewicz; Ania,80,0,98,18
1731507767094,MGT 107,C00,796609,Jaroszewicz; Ania,93,0,98,5
1731507768124,MGT 109,A00,766779,Staff,88,0,98,10
1731507769155,MGT 112,A00,766780,Somasundaram; Tyagarajan,52,0,60,8
1731507769155,MGT 112,B00,766781,Somasundaram; Tyagarajan,54,0,70,16
1731507770187,MGT 119,A00,766782,Etingue Kum; Menes,96,0,98,2
1731507771213,MGT 121A,A00,766783,Klaas; Jeffrey David,92,0,98,6
1731507772241,MGT 123,A00,796610,Felke; Magnus Roland,97,0,98,1
1731507773267,MGT 127R,A00,766784,Zhu; Kevin Xiaoguo,68,0,80,12
1731507774294,MGT 131A,A00,766802,Houskeeper; Robert,148,0,150,2
1731507775322,MGT 131B,A00,766833,Houskeeper; Robert,96,0,98,2
1731507776348,MGT 135,A00,766882,Anderson; John Charles,74,0,75,1
1731507777375,MGT 136,A00,766883,Lindenberger; Wade Douglas,90,0,98,8
1731507778404,MGT 137,A00,766893,Perez Cavazos; Gerardo,81,0,98,17
1731507779430,MGT 151R,A00,766954,Phiroz; Zal Navroze,92,0,98,6
1731507779430,MGT 151R,B00,766998,Phiroz; Zal Navroze,97,0,98,1
1731507780456,MGT 153,A00,766999,Perols; Johan Lars,57,0,90,33
1731507781487,MGT 160,A00,767000,Samek; Anya,87,0,90,3
1731507781487,MGT 160,B00,767001,Samek; Anya,74,0,90,16
1731507781487,MGT 160,C00,767038,Samek; Anya,86,0,90,4
1731507782516,MGT 162,A00,767085,Demill; Burritt,96,0,98,2
1731507782516,MGT 162,B00,767086,Demill; Burritt,92,0,98,6
1731507783543,MGT 162R,A00,767087,Gneezy; Uri,180,0,199,19
1731507784571,MGT 164,A00,767088,McKay; Mary A,97,0,98,1
1731507784571,MGT 164,B00,767089,McKay; Mary A,98,0,98,0
1731507784571,MGT 164,C00,767095,McKay; Mary A,96,0,98,2
1731507784571,MGT 164,D00,767097,Meyer; Alison Bloomfield,95,0,98,3
1731507784571,MGT 164,E00,767104,Smith; Pamela Karen,84,0,98,14
1731507785603,MGT 166,A00,767106,Moran; Cathleen L.,57,0,60,3
1731507785603,MGT 166,B00,767107,Moran; Cathleen L.,96,0,98,2
1731507785603,MGT 166,C00,767110,Moran; Cathleen L.,97,0,98,1
1731507786637,MGT 167,A00,767114,Jacob; Jo Dee C,97,0,98,1
1731507787671,MGT 172,A00,767115,Hedges; Kathleen & Royal; Rebecca,118,0,120,2
1731507787671,MGT 172,B00,767118,Hedges; Kathleen,94,0,98,4
1731507787671,MGT 172,C00,767121,Zimmermann; Carsten,98,0,98,0
1731507787671,MGT 172,D00,767124,Zimmermann; Carsten,97,0,98,1
1731507788701,MGT 173,A00,767130,Hayes; Sherry Lorine,91,0,98,7
1731507788701,MGT 173,B00,767135,Hayes; Sherry Lorine,97,0,98,1
1731507789726,MGT 175,A00,767137,Gopal; Christopher S.,97,0,98,1
1731507790750,MGT 176,A00,767139,Gopal; Christopher S.,89,0,98,9
1731507791778,MGT 180R,A00,767140,Engelberg; Joseph Edward,287,0,300,13
1731507792806,MGT 181,A00,767145,Bliss; Barbara Ann,83,0,98,15
1731507792806,MGT 181,B00,767155,Buchanan; Harold G,109,0,120,11
1731507793835,MGT 187,A00,767157,Dunn; Louis Jean,93,0,98,5
1731507793835,MGT 187,B00,767194,Dunn; Louis Jean,92,0,98,6
1731507794877,MGT 189,A00,767242,Dunn; Louis Jean,91,0,98,7
1731507794877,MGT 189,B00,767281,Reher; Michael Christopher,84,0,98,14
1731507795904,MGT 241,A00,770734,Staff,0,0,0,0
1731507796934,MGT 249,A00,767282,August; Terrence & Shin; Hyo Duk & Erat; Sanjiv,19,0,20,1
1731507797962,MGT 256,A00,767296,Liu; Wei,0,0,0,3
1731507798987,MGT 259,A00,767311,Smith; Pamela Karen,17,0,20,3
1731507800027,MGT 296,001,795366,Gneezy; Ayelet,3,0,3,0
1731507800027,MGT 296,002,795367,Amir; On,3,0,3,0
1731507800027,MGT 296,003,795368,Amir; On & Karmarkar; Uma R,2,0,3,1
1731507800027,MGT 296,004,795373,Liu; Jun,3,0,3,0
1731507800027,MGT 296,005,795374,Hansen; Karsten T.,2,0,3,1
1731507800027,MGT 296,006,795376,Erat; Sanjiv,2,0,3,1
1731507800027,MGT 296,007,795377,Timmermann; Allan,1,0,3,2
1731507800027,MGT 296,008,795378,Smith; Pamela Karen,3,0,3,0
1731507800027,MGT 296,009,795380,Zhang; Zhe,3,0,3,0
1731507800027,MGT 296,010,795381,Oveis; Christopher S,3,0,3,0
1731507800027,MGT 296,011,795384,Amir; On & Gneezy; Ayelet,3,0,3,0
1731507800027,MGT 296,012,795385,Luo; Danqi,3,0,3,0
1731507801082,MMW 12,A01,750828,Chang; Edmond Yi-Teh,16,0,16,0
1731507801082,MMW 12,A02,750829,Chang; Edmond Yi-Teh,16,0,16,0
1731507801082,MMW 12,A03,750830,Chang; Edmond Yi-Teh,15,0,16,1
1731507801082,MMW 12,A04,750863,Chang; Edmond Yi-Teh,15,0,16,1
1731507801082,MMW 12,A05,750864,Chang; Edmond Yi-Teh,16,0,16,0
1731507801082,MMW 12,A06,750870,Chang; Edmond Yi-Teh,16,0,16,0
1731507801082,MMW 12,A07,750874,Chang; Edmond Yi-Teh,16,0,16,0
1731507801082,MMW 12,A08,750877,Chang; Edmond Yi-Teh,16,0,16,0
1731507801082,MMW 12,A09,750882,Chang; Edmond Yi-Teh,16,0,16,0
1731507801082,MMW 12,A10,750884,Chang; Edmond Yi-Teh,16,0,16,0
1731507801082,MMW 12,A11,750890,Chang; Edmond Yi-Teh,16,0,16,0
1731507801082,MMW 12,A12,750891,Chang; Edmond Yi-Teh,16,0,16,0
1731507801082,MMW 12,A13,750892,Chang; Edmond Yi-Teh,16,0,16,0
1731507801082,MMW 12,A14,750940,Chang; Edmond Yi-Teh,16,0,16,0
1731507801082,MMW 12,A15,750951,Chang; Edmond Yi-Teh,0,0,0,0
1731507801082,MMW 12,A16,750957,Chang; Edmond Yi-Teh,0,0,0,0
1731507801082,MMW 12,A17,750967,Chang; Edmond Yi-Teh,16,0,16,0
1731507801082,MMW 12,A18,750976,Chang; Edmond Yi-Teh,16,0,16,0
1731507801082,MMW 12,A19,750977,Chang; Edmond Yi-Teh,16,0,16,0
1731507801082,MMW 12,A20,750980,Chang; Edmond Yi-Teh,16,0,16,0
1731507801082,MMW 12,A21,750981,Chang; Edmond Yi-Teh,16,0,16,0
1731507801082,MMW 12,A22,751031,Chang; Edmond Yi-Teh,16,0,16,0
1731507801082,MMW 12,A23,751032,Chang; Edmond Yi-Teh,0,0,0,0
1731507801082,MMW 12,B01,751035,Adamiak; Patrick John,15,0,16,1
1731507801082,MMW 12,B02,751065,Adamiak; Patrick John,14,0,16,2
1731507801082,MMW 12,B03,751066,Adamiak; Patrick John,16,0,16,0
1731507801082,MMW 12,B04,751067,Adamiak; Patrick John,16,0,16,0
1731507801082,MMW 12,B05,751068,Adamiak; Patrick John,16,0,16,0
1731507801082,MMW 12,B06,751069,Adamiak; Patrick John,16,0,16,0
1731507801082,MMW 12,B07,751070,Adamiak; Patrick John,16,0,16,0
1731507801082,MMW 12,B08,751071,Adamiak; Patrick John,16,0,16,0
1731507801082,MMW 12,B09,751072,Adamiak; Patrick John,15,0,16,1
1731507801082,MMW 12,B10,751073,Adamiak; Patrick John,16,0,16,0
1731507801082,MMW 12,B11,751074,Adamiak; Patrick John,16,0,16,0
1731507801082,MMW 12,B12,751075,Adamiak; Patrick John,16,0,16,0
1731507801082,MMW 12,B13,751076,Adamiak; Patrick John,16,0,16,0
1731507801082,MMW 12,B14,751077,Adamiak; Patrick John,16,0,16,0
1731507801082,MMW 12,B15,751078,Adamiak; Patrick John,0,0,0,0
1731507801082,MMW 12,B16,751079,Adamiak; Patrick John,0,0,0,0
1731507801082,MMW 12,B17,751080,Adamiak; Patrick John,15,0,16,1
1731507801082,MMW 12,B18,751081,Adamiak; Patrick John,16,0,16,0
1731507801082,MMW 12,B19,751082,Adamiak; Patrick John,16,0,16,0
1731507801082,MMW 12,B20,751083,Adamiak; Patrick John,16,0,16,0
1731507801082,MMW 12,B21,751084,Adamiak; Patrick John,15,0,16,1
1731507801082,MMW 12,B22,751085,Adamiak; Patrick John,15,0,16,1
1731507801082,MMW 12,C01,751087,Herbst; Matthew,16,0,16,0
1731507801082,MMW 12,C02,751088,Herbst; Matthew,16,0,16,0
1731507801082,MMW 12,C03,751090,Herbst; Matthew,16,0,16,0
1731507801082,MMW 12,C04,751091,Herbst; Matthew,16,0,16,0
1731507801082,MMW 12,C05,751092,Herbst; Matthew,14,0,16,2
1731507801082,MMW 12,C06,751093,Herbst; Matthew,16,0,16,0
1731507801082,MMW 12,C07,751094,Herbst; Matthew,15,0,16,1
1731507801082,MMW 12,C08,751096,Herbst; Matthew,16,0,16,0
1731507801082,MMW 12,C09,751097,Herbst; Matthew,16,0,16,0
1731507801082,MMW 12,C10,751098,Herbst; Matthew,15,0,16,1
1731507801082,MMW 12,C11,751099,Herbst; Matthew,16,0,16,0
1731507801082,MMW 12,C12,751100,Herbst; Matthew,16,0,16,0
1731507801082,MMW 12,C13,751101,Herbst; Matthew,15,0,16,1
1731507801082,MMW 12,C14,751102,Herbst; Matthew,16,0,16,0
1731507801082,MMW 12,C15,751103,Herbst; Matthew,0,0,0,0
1731507801082,MMW 12,C16,751105,Herbst; Matthew,0,0,0,0
1731507801082,MMW 12,C17,751106,Herbst; Matthew,16,0,16,0
1731507801082,MMW 12,C18,751107,Herbst; Matthew,16,0,16,0
1731507801082,MMW 12,C19,751108,Herbst; Matthew,16,0,16,0
1731507801082,MMW 12,C20,751110,Herbst; Matthew,16,0,16,0
1731507801082,MMW 12,C21,751112,Herbst; Matthew,0,0,0,0
1731507801082,MMW 12,C22,751113,Herbst; Matthew,0,0,0,0
1731507802112,MMW 14,A01,751190,Chang; Edmond Yi-Teh,25,0,28,3
1731507802112,MMW 14,A02,751227,Chang; Edmond Yi-Teh,27,0,28,1
1731507802112,MMW 14,A03,751235,Chang; Edmond Yi-Teh,0,0,0,0
1731507802112,MMW 14,A04,751248,Chang; Edmond Yi-Teh,0,0,0,0
1731507802112,MMW 14,A05,751249,Chang; Edmond Yi-Teh,27,0,28,1
1731507802112,MMW 14,A06,751253,Chang; Edmond Yi-Teh,25,0,28,3
1731507802112,MMW 14,B01,751265,Hertz; Deborah,24,0,28,4
1731507802112,MMW 14,B02,751266,Hertz; Deborah,21,0,28,7
1731507802112,MMW 14,B03,751267,Hertz; Deborah,0,0,0,0
1731507802112,MMW 14,B04,751270,Hertz; Deborah,24,0,28,4
1731507802112,MMW 14,B05,751273,Hertz; Deborah,28,0,28,0
1731507802112,MMW 14,C01,751386,Herbst; Matthew,0,0,0,0
1731507803143,MMW 122,A01,751389,Peterson; Johanna L,23,0,27,4
1731507803143,MMW 122,A02,751424,Peterson; Johanna L,25,0,27,2
1731507803143,MMW 122,A03,751435,Peterson; Johanna L,27,0,27,0
1731507803143,MMW 122,A04,751437,Peterson; Johanna L,27,0,27,0
1731507803143,MMW 122,A05,751438,Peterson; Johanna L,27,0,27,0
1731507803143,MMW 122,A06,751440,Peterson; Johanna L,27,0,27,0
1731507803143,MMW 122,A07,751441,Peterson; Johanna L,0,0,0,0
1731507803143,MMW 122,A08,751442,Peterson; Johanna L,0,0,0,0
1731507803143,MMW 122,A09,751443,Peterson; Johanna L,27,0,27,0
1731507803143,MMW 122,A10,751444,Peterson; Johanna L,26,0,27,1
1731507803143,MMW 122,A11,751448,Peterson; Johanna L,0,0,0,0
1731507803143,MMW 122,A12,751493,Peterson; Johanna L,0,0,0,0
1731507803143,MMW 122,B01,751497,Rahimi; Babak,26,0,27,1
1731507803143,MMW 122,B02,751501,Rahimi; Babak,25,0,27,2
1731507803143,MMW 122,B03,751504,Rahimi; Babak,26,0,27,1
1731507803143,MMW 122,B04,751505,Rahimi; Babak,27,0,27,0
1731507803143,MMW 122,B05,751526,Rahimi; Babak,22,0,27,5
1731507803143,MMW 122,B06,751528,Rahimi; Babak,27,0,27,0
1731507803143,MMW 122,B07,751531,Rahimi; Babak,26,0,27,1
1731507803143,MMW 122,B08,751533,Rahimi; Babak,26,0,27,1
1731507803143,MMW 122,B09,751534,Rahimi; Babak,0,0,0,0
1731507803143,MMW 122,B10,751535,Rahimi; Babak,0,0,0,0
1731507803143,MMW 122,C01,751538,Herbst; Matthew,0,0,0,0
1731507804170,MSED 295,A00,751699,Staff,5,0,5,0
1731507805198,MUS 1B,A01,755885,Staff,20,0,25,5
1731507805198,MUS 1B,A02,755889,Staff,21,0,25,4
1731507805198,MUS 1B,A03,755890,Staff,23,0,25,2
1731507805198,MUS 1B,A04,755891,Staff,25,0,25,0
1731507806224,MUS 2B,A01,755895,Carlson; Erik,30,0,30,0
1731507807255,MUS 2BK,A00,755896,Ohnishi; Takae,12,0,15,3
1731507807255,MUS 2BK,B00,755897,Ohnishi; Takae,15,0,15,0
1731507808291,MUS 4,A01,755899,Day; Kevin Alexander,24,0,25,1
1731507808291,MUS 4,A02,755900,Day; Kevin Alexander,25,0,25,0
1731507808291,MUS 4,A03,755901,Day; Kevin Alexander,25,0,25,0
1731507808291,MUS 4,A04,755902,Day; Kevin Alexander,25,0,25,0
1731507808291,MUS 4,A05,755903,Day; Kevin Alexander,25,0,25,0
1731507808291,MUS 4,A06,755904,Day; Kevin Alexander,25,0,25,0
1731507808291,MUS 4,A07,755926,Day; Kevin Alexander,25,0,25,0
1731507808291,MUS 4,A08,755927,Day; Kevin Alexander,24,0,25,1
1731507808291,MUS 4,A09,755951,Day; Kevin Alexander,25,0,25,0
1731507808291,MUS 4,A10,755952,Day; Kevin Alexander,25,0,25,0
1731507809323,MUS 6,A01,755954,Freitas Caetano; Marcelo,25,0,25,0
1731507809323,MUS 6,A02,755955,Freitas Caetano; Marcelo,22,0,25,3
1731507809323,MUS 6,A03,755982,Freitas Caetano; Marcelo,22,0,25,3
1731507809323,MUS 6,A04,755983,Freitas Caetano; Marcelo,25,0,25,0
1731507810358,MUS 9,A01,756195,Staff,19,0,20,1
1731507810358,MUS 9,A02,756197,Staff,20,0,20,0
1731507810358,MUS 9,A03,756198,Staff,20,0,20,0
1731507810358,MUS 9,A04,756199,Staff,20,0,20,0
1731507810358,MUS 9,A05,756201,Staff,20,0,20,0
1731507810358,MUS 9,A06,756209,Staff,20,0,20,0
1731507811386,MUS 12,A01,756214,Davis; Anthony Curtis,25,0,25,0
1731507811386,MUS 12,A02,756219,Davis; Anthony Curtis,24,0,25,1
1731507811386,MUS 12,A03,756221,Davis; Anthony Curtis,25,0,25,0
1731507811386,MUS 12,A04,756223,Davis; Anthony Curtis,25,0,25,0
1731507812417,MUS 13,A01,756228,Leslie Santana; Myrta,22,0,25,3
1731507812417,MUS 13,A02,756233,Leslie Santana; Myrta,21,0,25,4
1731507812417,MUS 13,A03,756234,Leslie Santana; Myrta,25,0,25,0
1731507812417,MUS 13,A04,756237,Leslie Santana; Myrta,25,0,25,0
1731507813453,MUS 15,A01,756244,Narucki; Susan M,23,0,25,2
1731507813453,MUS 15,A02,756250,Narucki; Susan M,23,0,25,2
1731507813453,MUS 15,A03,756256,Narucki; Susan M,23,0,25,2
1731507813453,MUS 15,A04,756259,Narucki; Susan M,25,0,25,0
1731507813453,MUS 15,A05,756262,Narucki; Susan M,24,0,25,1
1731507813453,MUS 15,A06,756269,Narucki; Susan M,22,0,25,3
1731507813453,MUS 15,A07,756273,Narucki; Susan M,25,0,25,0
1731507813453,MUS 15,A08,756280,Narucki; Susan M,23,0,25,2
1731507813453,MUS 15,A09,756281,Narucki; Susan M,25,0,25,0
1731507813453,MUS 15,A10,756282,Narucki; Susan M,23,0,25,2
1731507814484,MUS 17,A01,756669,Staff,23,0,25,2
1731507814484,MUS 17,A02,756673,Staff,23,0,25,2
1731507814484,MUS 17,A03,756674,Staff,17,0,25,8
1731507814484,MUS 17,A04,756675,Staff,24,0,25,1
1731507814484,MUS 17,A05,756679,Staff,25,0,25,0
1731507814484,MUS 17,A06,756683,Staff,21,0,25,4
1731507814484,MUS 17,A07,756689,Staff,25,0,25,0
1731507814484,MUS 17,A08,756693,Staff,24,0,25,1
1731507814484,MUS 17,A09,756695,Staff,24,0,25,1
1731507814484,MUS 17,A10,756697,Staff,24,0,25,1
1731507814484,MUS 17,A11,756701,Staff,23,0,25,2
1731507814484,MUS 17,A12,756703,Staff,24,0,25,1
1731507815522,MUS 20R,A01,797703,Borgo; David Garcia,7,0,25,18
1731507815522,MUS 20R,A02,797705,Borgo; David Garcia,24,0,25,1
1731507815522,MUS 20R,A03,797779,Borgo; David Garcia,23,0,25,2
1731507815522,MUS 20R,A04,797780,Borgo; David Garcia,25,0,25,0
1731507815522,MUS 20R,A05,797816,Borgo; David Garcia,23,0,25,2
1731507815522,MUS 20R,A06,797825,Borgo; David Garcia,25,0,25,0
1731507815522,MUS 20R,A07,797826,Borgo; David Garcia,24,0,25,1
1731507815522,MUS 20R,A08,797831,Borgo; David Garcia,21,0,25,4
1731507815522,MUS 20R,B01,798362,Borgo; David Garcia,3,0,3,0
1731507815522,MUS 20R,B02,798369,Borgo; David Garcia,3,0,3,0
1731507815522,MUS 20R,B03,798370,Borgo; David Garcia,3,0,3,0
1731507815522,MUS 20R,B04,798372,Borgo; David Garcia,3,0,3,0
1731507815522,MUS 20R,B05,798375,Borgo; David Garcia,3,0,3,0
1731507815522,MUS 20R,B06,798377,Borgo; David Garcia,3,0,3,0
1731507815522,MUS 20R,B07,798378,Borgo; David Garcia,3,0,3,0
1731507815522,MUS 20R,B08,798379,Borgo; David Garcia,3,0,3,0
1731507816551,MUS 32,001,735915,Dresser; Mark Stuart,10,0,10,0
1731507816551,MUS 32,002,735917,Curtis; Charles Rector,10,0,10,0
1731507816551,MUS 32,003,735920,Terrazas Perez; Wilfrido D,10,0,10,0
1731507816551,MUS 32,004,735921,Ohnishi; Takae,10,0,10,0
1731507816551,MUS 32,005,735923,Carlson; Erik,10,0,10,0
1731507816551,MUS 32,006,735924,Staff,10,0,10,0
1731507816551,MUS 32,007,735926,Staff,10,0,10,0
1731507817579,MUS 32V,A00,756706,Staff,10,0,10,0
1731507817579,MUS 32V,B00,756709,Staff,10,0,10,0
1731507818607,MUS 32VM,A00,756713,Staff,15,0,15,0
1731507819639,MUS 43,A00,756714,Yadegari; Shahrokh D,90,0,96,6
1731507820664,MUS 95C,A00,756725,Staff,38,0,40,2
1731507821692,MUS 95D,A00,756726,Yadegari; Shahrokh D,30,0,30,0
1731507822716,MUS 95E,A00,756730,Staff,40,0,40,0
1731507823743,MUS 95F,A00,756732,Staff,40,0,40,0
1731507824769,MUS 95G,A00,756742,Anderson; Kenneth,386,0,395,9
1731507824769,MUS 95G,B00,756743,Anderson; Kenneth,389,0,395,6
1731507825809,MUS 95JC,A00,756745,Kenyatta; Kamau,25,0,25,0
1731507826838,MUS 95L,A00,756749,Staff,65,0,65,0
1731507827863,MUS 95P,A00,756975,Nourai; Keyavash,20,0,20,0
1731507828890,MUS 95W,A00,756976,Seshadri; Kartik,28,0,30,2
1731507828890,MUS 95W,B00,756977,Seshadri; Kartik,30,0,30,0
1731507829921,MUS 101B,A01,757168,Day; Kevin Alexander,35,0,35,0
1731507830948,MUS 103B,A00,757172,Steiger; Rand,15,0,15,0
1731507831982,MUS 103E,A00,757173,Staff,10,0,10,0
1731507833013,MUS 107,A00,757174,Roberts; Matana,15,0,15,0
1731507834044,MUS 111,A00,757176,Guy; Nancy,117,0,120,3
1731507835071,MUS 113,A00,757178,Curtis; Charles Rector,30,0,30,0
1731507836098,MUS 114,A00,757179,Terrazas Perez; Wilfrido D,135,0,140,5
1731507837126,MUS 120B,A01,757182,Leslie Santana; Myrta,25,0,25,0
1731507838174,MUS 127,A00,757183,Dresser; Mark Stuart,94,0,100,6
1731507839201,MUS 130,A00,757185,Ohnishi; Takae,35,0,35,0
1731507840235,MUS 132,001,736011,Dresser; Mark Stuart,10,0,10,0
1731507840235,MUS 132,002,736012,Curtis; Charles Rector,10,0,10,0
1731507840235,MUS 132,003,736013,Terrazas Perez; Wilfrido D,10,0,10,0
1731507840235,MUS 132,004,736014,Ohnishi; Takae,10,0,10,0
1731507840235,MUS 132,005,736015,Carlson; Erik,10,0,10,0
1731507840235,MUS 132,006,736016,Staff,10,0,10,0
1731507840235,MUS 132,007,736017,Nourai; Keyavash,10,0,10,0
1731507840235,MUS 132,008,736018,Schick; Steven,10,0,10,0
1731507841263,MUS 132R,A00,757187,Narucki; Susan M,2,0,2,0
1731507842291,MUS 132V,A00,757189,Narucki; Susan M,15,0,15,0
1731507842291,MUS 132V,B00,757190,Staff,15,0,15,0
1731507843323,MUS 134,A00,757192,Yadegari; Shahrokh D,30,0,30,0
1731507844351,MUS 137B,A00,757193,Kenyatta; Kamau,34,0,35,1
1731507845377,MUS 143,A00,757194,Yadegari; Shahrokh D,27,0,31,4
1731507846410,MUS 160A,A00,757195,Dubnov; Shlomo,14,0,15,1
1731507846410,MUS 160A,B00,757198,Smythe; Cory Benjamin,15,0,15,0
1731507847439,MUS 171,A01,757200,Smyth; Tamara R.,47,0,65,18
1731507848471,MUS 173B,A01,757203,Britt; King James,25,0,25,0
1731507849496,MUS 174B,A00,757204,Britt; King James,18,0,25,7
1731507850526,MUS 176,A00,757205,Lou; Michelle Siulai,20,0,20,0
1731507851553,MUS 201A,A00,757207,Dresser; Mark Stuart,15,0,15,0
1731507852579,MUS 201B,A00,757208,Yadegari; Shahrokh D,13,0,15,2
1731507852579,MUS 201B,B00,757210,Roberts; Matana,13,0,15,2
1731507853608,MUS 201C,A00,757211,Schick; Steven,15,0,15,0
1731507854646,MUS 202,A00,795573,Schick; Steven,14,0,15,1
1731507855672,MUS 203B,A00,757213,Obermueller; Karola,14,0,15,1
1731507856700,MUS 203D,A00,757214,Davis; Anthony Curtis,10,0,10,0
1731507856700,MUS 203D,B00,757215,Lou; Michelle Siulai,10,0,10,0
1731507856700,MUS 203D,C00,757216,Obermueller; Karola,9,0,10,1
1731507856700,MUS 203D,D00,757217,Steiger; Rand,10,0,10,0
1731507856700,MUS 203D,E00,757218,McCormack; Timothy Matthew,10,0,10,0
1731507856700,MUS 203D,F00,795580,Liang; Lei,10,0,10,0
1731507857728,MUS 204,A00,757219,Lou; Michelle Siulai,13,0,15,2
1731507858756,MUS 205,A00,757220,Hankins; Sarah E.,13,0,15,2
1731507859786,MUS 206,A00,757221,Hankins; Sarah E.,14,0,15,1
1731507859786,MUS 206,B00,757222,Narucki; Susan M,14,0,15,1
1731507859786,MUS 206,C00,795581,Smythe; Cory Benjamin,15,0,15,0
1731507860811,MUS 207,A00,757223,Guy; Nancy,14,0,15,1
1731507861838,MUS 210,A00,757224,McCormack; Timothy Matthew,13,0,15,2
1731507862869,MUS 215D,A00,757225,Cimini; Amy Marie,14,0,15,1
1731507863899,MUS 232,001,736044,Dresser; Mark Stuart,10,0,10,0
1731507863899,MUS 232,002,736045,Curtis; Charles Rector,10,0,10,0
1731507863899,MUS 232,003,736046,Terrazas Perez; Wilfrido D,9,0,10,1
1731507863899,MUS 232,004,736047,Ohnishi; Takae,10,0,10,0
1731507863899,MUS 232,005,736048,Carlson; Erik,10,0,10,0
1731507863899,MUS 232,006,736049,Narucki; Susan M,9,0,10,1
1731507863899,MUS 232,007,736050,Staff,10,0,10,0
1731507863899,MUS 232,008,736051,Schick; Steven,10,0,10,0
1731507864927,MUS 234,A00,757226,Yadegari; Shahrokh D,20,0,20,0
1731507865955,MUS 245,A00,757230,Carlson; Erik,19,0,20,1
1731507866985,MUS 267,A00,757231,Smyth; Tamara R.,18,0,20,2
1731507868016,MUS 270D,A00,795583,Freitas Caetano; Marcelo,20,0,20,0
1731507869044,MUS 271A,A00,757235,Erbe; Tom,19,0,20,1
1731507870072,NANO 11,A00,757236,Fenning; David,100,0,100,0
1731507871105,NANO 15,A01,757238,Yang; Kesong,25,0,25,0
1731507872131,NANO 104,A00,757239,Vazquez Mena; Oscar,68,0,70,2
1731507873161,NANO 107,A01,757272,Cubukcu; Ertugrul,69,0,70,1
1731507874187,NANO 114,A00,757277,Jahed Motlagh; Zeinab,38,0,40,2
1731507875215,NANO 117,A00,757280,Cubukcu; Ertugrul,68,0,70,2
1731507876246,NANO 120A,A01,757286,Sirbuly; Donald,30,0,35,5
1731507876246,NANO 120A,B01,757294,Jokerst; Jesse Vincent,35,0,35,0
1731507877275,NANO 134,A00,757295,Pokorski; Jonathan Kyle,35,0,40,5
1731507878306,NANO 141A,A00,757296,Lubarda; Vlado,38,0,40,2
1731507879333,NANO 168,A00,757297,Fullerton; Eric E,37,0,40,3
1731507880358,NANO 200,A00,757302,Jahed Motlagh; Zeinab,88,0,120,32
1731507881398,NANO 203,A00,757314,Fenning; David,20,0,60,40
1731507882427,NANO 204,A00,757315,Li; Wan-Lu,28,0,30,2
1731507883455,NANO 205,A00,757323,Jokerst; Jesse Vincent,46,0,60,14
1731507884485,NANO 206,A00,757326,Chen; Shaochen,26,0,60,34
1731507885515,NANO 247B,A00,757331,Wang; Joseph,25,0,35,10
1731507886545,NANO 252,A00,757334,Meyers; Marc,16,0,20,4
1731507887576,NANO 265,A00,757355,Luo; Jian,8,0,10,2
1731507888602,NANO 272,A00,757357,Xu; Sheng,43,0,50,7
1731507889633,NEU 200B,A00,765050,Abdel-Azim; Eiman,0,0,0,0
1731507890660,NEU 276,A01,765052,Dore; Kim Bohemie,26,0,28,2
1731507891690,NEU 296,001,791944,Evans; Sean Jeffrey,5,0,10,5
1731507891690,NEU 296,002,791945,Graves; Jennifer Sharon Ol,9,0,10,1
1731507891690,NEU 296,003,791948,Staff,10,0,10,0
1731507892715,NEUG 221,A00,765055,Staff,7,0,12,5
1731507893741,NEUG 257,A01,765057,Halgren; Eric,16,0,18,2
1731507894767,NEUG 296,A00,765058,Bloodgood; Brenda Laurie,9998,0,9999,1
1731507895795,OPTH 296,001,792241,Baxter; Sally Liu,9,0,10,1
1731507895795,OPTH 296,002,792242,Staff,10,0,10,0
1731507895795,OPTH 296,003,792243,Staff,10,0,10,0
1731507896820,ORTH 296,001,792255,Staff,10,0,10,0
1731507896820,ORTH 296,002,792256,Staff,10,0,10,0
1731507896820,ORTH 296,003,792257,Staff,10,0,10,0
1731507897845,PAE 230,A00,791542,Villarreal Jr.; Elias,30,0,30,0
1731507898872,PAE 231,A00,791543,Villarreal Jr.; Elias,30,0,30,0
1731507899898,PAE 232,A00,791544,Villarreal Jr.; Elias,30,0,30,0
1731507900926,PAE 233,A00,791545,Villarreal Jr.; Elias,30,0,30,0
1731507901954,PAE 234,A01,791547,Villarreal Jr.; Elias,30,0,30,0
1731507902981,PAE 235,A01,791549,Villarreal Jr.; Elias,30,0,30,0
1731507904008,PAE 236,A00,791550,Villarreal Jr.; Elias,30,0,30,0
1731507905036,PATH 221,A00,761937,Yang; Jing,0,0,0,0
1731507906064,PATH 224,A01,799580,Ross; Camille,20,0,20,0
1731507907091,PATH 225,A01,797833,Klemke; Richard,25,0,25,0
1731507908119,PATH 296,001,792280,Staff,10,0,10,0
1731507908119,PATH 296,002,792282,Staff,10,0,10,0
1731507908119,PATH 296,003,792283,Staff,10,0,10,0
1731507909146,PEDS 296,001,792351,Staff,10,0,10,0
1731507909146,PEDS 296,002,792352,Staff,10,0,10,0
1731507909146,PEDS 296,003,792354,Staff,10,0,10,0
1731507910178,PH 40,A00,746085,Larsen; Britta Ann,94,0,100,6
1731507911216,PH 45,A01,785847,Stone; Matthew David,26,0,30,4
1731507911216,PH 45,A02,785848,Stone; Matthew David,26,0,30,4
1731507911216,PH 45,A03,785880,Stone; Matthew David,0,0,0,0
1731507911216,PH 45,A04,785898,Stone; Matthew David,0,0,0,0
1731507912243,PH 91,A00,746164,Harrell; Maralee Mae,100,0,100,0
1731507913270,PH 95,A00,746180,Larsen; Britta Ann,30,0,30,0
1731507914300,PH 98,A00,799480,Larsen; Britta Ann,0,0,0,0
1731507915328,PH 101,A00,746187,Tan; Gene Brian,28,0,40,12
1731507915328,PH 101,B00,746272,Miller; Lindsay Morgan,35,0,40,5
1731507916355,PH 102,A01,785945,Rana; Brinda Kanti,21,0,30,9
1731507916355,PH 102,A02,785966,Rana; Brinda Kanti,24,0,30,6
1731507917385,PH 110,A00,746301,Hartman; Sheri R,55,0,55,0
1731507917385,PH 110,B00,746625,Hartman; Sheri R,40,0,45,5
1731507918414,PH 120,A00,746626,Long; Kanya Claudine,49,0,55,6
1731507919444,PH 130,A00,746635,Kayser; Georgia Lyn,57,0,65,8
1731507920477,PH 161,A00,746643,Zoumas-Morse; Christine E.,55,0,60,5
1731507921502,PH 172,A00,746647,Ryan; Margaret Angela Kapp,35,0,40,5
1731507922530,PH 193,A00,746656,Staff,0,0,0,0
1731507922530,PH 193,B00,746659,Staff,0,0,0,0
1731507922530,PH 193,C00,746662,Staff,0,0,0,0
1731507922530,PH 193,D00,746667,Staff,0,0,0,0
1731507922530,PH 193,E00,746679,Staff,0,0,0,0
1731507922530,PH 193,F00,746683,Staff,0,0,0,0
1731507923560,PH 194,A00,746685,Nguyen; Annie Lu,0,0,0,0
1731507924588,PH 196AH,A01,746696,Binkin; Nancy Jeanne,20,0,20,0
1731507925618,PHAR 222,A00,761971,Yang; Jing,20,0,20,0
1731507926645,PHAR 255,A00,761972,Joiner; William J.,24,0,24,0
1731507927684,PHAR 275,A01,761977,Antal; Corina Elena & Obara; Christopher & Mendiola; Andrew & Gonzalez; David J,10,0,10,0
1731507928709,PHAR 295,A00,761978,Joiner; William J.,9,0,10,1
1731507929735,PHB 222,A00,746697,Messer; Karen Sue,30,0,50,20
1731507930761,PHB 226,A00,746698,Tu; Xin,15,0,25,10
1731507931790,PHB 243B,A01,746710,Thomas; Ronald G,9,0,20,11
1731507932816,PHB 244B,A00,746823,Vaida; Florin,24,0,45,21
1731507933842,PHB 280,A00,746910,Natarajan; Loki,48,0,75,27
1731507934872,PHB 291,A00,795411,Staff,14,0,25,11
1731507935901,PHIL 10,A01,761088,Carr; Jennifer Rose,39,0,44,5
1731507935901,PHIL 10,A02,761090,Carr; Jennifer Rose,44,0,44,0
1731507935901,PHIL 10,A03,761092,Carr; Jennifer Rose,42,0,44,2
1731507935901,PHIL 10,A04,761096,Carr; Jennifer Rose,44,0,44,0
1731507935901,PHIL 10,A05,761198,Carr; Jennifer Rose,44,0,44,0
1731507935901,PHIL 10,A06,761200,Carr; Jennifer Rose,43,0,44,1
1731507935901,PHIL 10,A07,761236,Carr; Jennifer Rose,44,0,44,0
1731507935901,PHIL 10,A08,761241,Carr; Jennifer Rose,43,0,44,1
1731507935901,PHIL 10,A09,761243,Carr; Jennifer Rose,0,0,0,0
1731507935901,PHIL 10,A10,761244,Carr; Jennifer Rose,0,0,0,0
1731507936934,PHIL 12,A01,761252,Kovaka; Karenc,29,0,30,1
1731507936934,PHIL 12,A02,761254,Kovaka; Karenc,0,0,0,0
1731507936934,PHIL 12,A03,761277,Kovaka; Karenc,30,0,30,0
1731507936934,PHIL 12,A04,761278,Kovaka; Karenc,29,0,30,1
1731507936934,PHIL 12,A05,761279,Kovaka; Karenc,30,0,30,0
1731507936934,PHIL 12,A06,761280,Kovaka; Karenc,29,0,30,1
1731507936934,PHIL 12,A07,761281,Kovaka; Karenc,30,0,30,0
1731507936934,PHIL 12,A08,761282,Kovaka; Karenc,0,0,0,0
1731507937960,PHIL 16,A00,761283,Harrell; Maralee Mae,31,0,33,2
1731507938990,PHIL 24,A00,761284,Callender; Craig Adam,120,0,120,0
1731507940019,PHIL 27,A01,761286,Lamey; Andy M.,17,0,25,8
1731507940019,PHIL 27,A02,761287,Lamey; Andy M.,18,0,25,7
1731507940019,PHIL 27,A03,761288,Lamey; Andy M.,0,0,0,0
1731507940019,PHIL 27,A04,761289,Lamey; Andy M.,0,0,0,0
1731507940019,PHIL 27,A05,761292,Lamey; Andy M.,21,0,25,4
1731507940019,PHIL 27,A06,761294,Lamey; Andy M.,20,0,25,5
1731507941053,PHIL 28,A01,761401,Brandt; Reuven A,16,0,25,9
1731507941053,PHIL 28,A02,761404,Brandt; Reuven A,23,0,25,2
1731507941053,PHIL 28,A03,761406,Brandt; Reuven A,23,0,25,2
1731507941053,PHIL 28,A04,761425,Brandt; Reuven A,18,0,25,7
1731507941053,PHIL 28,A05,761427,Brandt; Reuven A,25,0,25,0
1731507941053,PHIL 28,A06,761433,Brandt; Reuven A,23,0,25,2
1731507941053,PHIL 28,A07,761434,Brandt; Reuven A,0,0,0,0
1731507941053,PHIL 28,A08,761438,Brandt; Reuven A,0,0,0,0
1731507941053,PHIL 28,A09,761571,Brandt; Reuven A,8,0,25,17
1731507941053,PHIL 28,A10,761572,Brandt; Reuven A,24,0,25,1
1731507942086,PHIL 32,A01,761605,Johnson; Monte,23,0,25,2
1731507942086,PHIL 32,A02,761606,Johnson; Monte,25,0,25,0
1731507943116,PHIL 35,A00,761621,Marechal; Patricia,175,0,180,5
1731507944142,PHIL 51,A00,761645,Kovaka; Karenc,216,0,216,0
1731507945171,PHIL 90,A00,761646,Rudolph; Rachel Etta,31,0,33,2
1731507945171,PHIL 90,B00,761648,Kocurek; Alexander William,32,0,33,1
1731507946200,PHIL 100,A00,761696,Marechal; Patricia,24,0,32,8
1731507947231,PHIL 107,A00,761697,Tolley; Clinton,33,0,33,0
1731507948261,PHIL 111,A00,761698,Watkins; Eric,39,0,40,1
1731507949295,PHIL 122,A00,761699,Sher; Gila,31,0,33,2
1731507950322,PHIL 132,A00,761700,Sher; Gila,31,0,33,2
1731507951348,PHIL 136,A00,761701,Grush; Rick Scott,31,0,33,2
1731507952374,PHIL 138,A00,761721,Vargas; Manuel Rogelio,58,0,60,2
1731507953402,PHIL 149,A00,761738,Fulkerson; Matthew Todd,113,0,120,7
1731507954435,PHIL 163,A01,761771,Brandt; Reuven A,23,0,25,2
1731507954435,PHIL 163,A02,761774,Brandt; Reuven A,22,0,25,3
1731507954435,PHIL 163,A03,761778,Brandt; Reuven A,22,0,25,3
1731507954435,PHIL 163,A04,761785,Brandt; Reuven A,24,0,25,1
1731507954435,PHIL 163,A05,761810,Brandt; Reuven A,0,0,0,0
1731507954435,PHIL 163,A06,761819,Brandt; Reuven A,19,0,25,6
1731507954435,PHIL 163,A07,761823,Brandt; Reuven A,18,0,25,7
1731507954435,PHIL 163,A08,761827,Brandt; Reuven A,0,0,0,0
1731507954435,PHIL 163,A09,761833,Brandt; Reuven A,24,0,25,1
1731507954435,PHIL 163,A10,761840,Brandt; Reuven A,23,0,25,2
1731507955461,PHIL 167,A00,761841,Lamey; Andy M.,29,0,33,4
1731507956488,PHIL 176,A00,761843,Vargas; Manuel Rogelio,32,0,33,1
1731507957515,PHIL 177,A00,761848,Shields; Christopher John,33,0,33,0
1731507958547,PHIL 185,A00,794683,Shields; Christopher John,30,0,33,3
1731507960604,PHIL 191B,A00,799969,Tolley; Clinton,2,0,2,0
1731507960604,PHIL 191B,B00,799970,Bazargan-Forward; Saba,1,0,1,0
1731507961633,PHIL 201A,A00,761865,Tolley; Clinton,18,0,20,2
1731507962659,PHIL 206A,A00,761866,Carr; Jennifer Rose,17,0,20,3
1731507963686,PHIL 209C,A00,761870,McKenzie; Kerry V.,5,0,5,0
1731507964713,PHIL 209D,A00,761873,Lampland; Martha,5,0,5,0
1731507965738,PHIL 210,A00,761878,Johnson; Monte,19,0,20,1
1731507966764,PHIL 245,A00,761883,Cartwright; Nancy D.,14,0,20,6
1731507967795,PHIL 260,A00,761889,Bazargan-Forward; Saba & Yuan; Yuan,20,0,20,0
1731507968824,PHIL 271,A00,761891,Vargas; Manuel Rogelio & Fulkerson; Matthew Todd,10,0,10,0
1731507969851,PHIL 275,A00,761899,Watkins; Eric,10,0,10,0
1731507970880,PHIL 277,A00,761911,Tolley; Clinton,8,0,10,2
1731507971911,PHIL 278,A00,761919,Fulkerson; Matthew Todd & Cohen; Jonathan David,10,0,10,0
1731507973007,PHIL 280,A00,761930,Kovaka; Karenc,9999,0,9999,0
1731507974036,PHIL 281,A00,761931,Tolley; Clinton,10,0,10,0
1731507975063,PHIL 283,A00,794690,Tolley; Clinton & Vargas; Manuel Rogelio,10,0,10,0
1731507976088,PHIL 284,A00,761932,Kovaka; Karenc,10,0,10,0
1731507977116,PHIL 286,A00,761933,Chen; Keming & Callender; Craig Adam,10,0,10,0
1731507978140,PHIL 287,A00,761935,Johnson; Monte,10,0,10,0
1731507979187,PHIL 290,001,776411,Nelkin; Dana Kay,9999,0,9999,0
1731507979187,PHIL 290,002,776412,Bazargan-Forward; Saba,9999,0,9999,0
1731507979187,PHIL 290,003,776413,Brandt; Reuven A,9999,0,9999,0
1731507979187,PHIL 290,004,776414,Brink; David O.,9999,0,9999,0
1731507979187,PHIL 290,005,776415,Callender; Craig Adam,9999,0,9999,0
1731507979187,PHIL 290,006,776416,Carr; Jennifer Rose,9999,0,9999,0
1731507979187,PHIL 290,007,776483,Cartwright; Nancy D.,9999,0,9999,0
1731507979187,PHIL 290,008,776498,Cohen; Jonathan David,9999,0,9999,0
1731507979187,PHIL 290,009,776743,Danks; David J,9999,0,9999,0
1731507979187,PHIL 290,010,776746,Fulkerson; Matthew Todd,9999,0,9999,0
1731507979187,PHIL 290,011,776753,Grush; Rick Scott,9999,0,9999,0
1731507979187,PHIL 290,012,776756,Hardimon; Michael O.,9999,0,9999,0
1731507979187,PHIL 290,013,776760,Harrell; Maralee Mae,9999,0,9999,0
1731507979187,PHIL 290,014,776761,Johnson; Monte,9999,0,9999,0
1731507979187,PHIL 290,015,776762,Kovaka; Karenc,9999,0,9999,0
1731507979187,PHIL 290,016,776763,Lamey; Andy M.,9999,0,9999,0
1731507979187,PHIL 290,017,776766,Marechal; Patricia,9999,0,9999,0
1731507979187,PHIL 290,018,776771,McKenzie; Kerry V.,9999,0,9999,0
1731507979187,PHIL 290,019,776778,Rickless; Samuel Charles,9999,0,9999,0
1731507979187,PHIL 290,020,776782,Sher; Gila,9999,0,9999,0
1731507979187,PHIL 290,021,776785,Shields; Christopher John,9999,0,9999,0
1731507979187,PHIL 290,022,776787,Tolley; Clinton,9999,0,9999,0
1731507979187,PHIL 290,023,776796,Vargas; Manuel Rogelio,9999,0,9999,0
1731507979187,PHIL 290,024,776799,Watkins; Eric,9999,0,9999,0
1731507979187,PHIL 290,025,776802,Chen; Keming,9999,0,9999,0
1731507979187,PHIL 290,026,794693,Rudolph; Rachel Etta,9999,0,9999,0
1731507979187,PHIL 290,027,794696,Kocurek; Alexander William,9999,0,9999,0
1731507979187,PHIL 290,028,794697,Yuan; Yuan,9999,0,9999,0
1731507980218,PHIL 295,001,776806,Bazargan-Forward; Saba,9999,0,9999,0
1731507980218,PHIL 295,002,776808,Brandt; Reuven A,9999,0,9999,0
1731507980218,PHIL 295,003,776811,Brink; David O.,9999,0,9999,0
1731507980218,PHIL 295,004,776818,Callender; Craig Adam,9999,0,9999,0
1731507980218,PHIL 295,005,776820,Carr; Jennifer Rose,9999,0,9999,0
1731507980218,PHIL 295,006,776821,Cartwright; Nancy D.,9999,0,9999,0
1731507980218,PHIL 295,007,776825,Chen; Keming,9999,0,9999,0
1731507980218,PHIL 295,008,776827,Cohen; Jonathan David,9999,0,9999,0
1731507980218,PHIL 295,009,776831,Danks; David J,9999,0,9999,0
1731507980218,PHIL 295,010,776840,Fulkerson; Matthew Todd,9999,0,9999,0
1731507980218,PHIL 295,011,776842,Grush; Rick Scott,9999,0,9999,0
1731507980218,PHIL 295,012,776846,Hardimon; Michael O.,9999,0,9999,0
1731507980218,PHIL 295,013,776933,Harrell; Maralee Mae,9999,0,9999,0
1731507980218,PHIL 295,014,776934,Johnson; Monte,9999,0,9999,0
1731507980218,PHIL 295,015,776941,Kovaka; Karenc,9999,0,9999,0
1731507980218,PHIL 295,016,776960,Lamey; Andy M.,9999,0,9999,0
1731507980218,PHIL 295,017,777007,Marechal; Patricia,9999,0,9999,0
1731507980218,PHIL 295,018,777008,McKenzie; Kerry V.,9999,0,9999,0
1731507980218,PHIL 295,019,777047,Nelkin; Dana Kay,9999,0,9999,0
1731507980218,PHIL 295,020,777237,Rickless; Samuel Charles,9999,0,9999,0
1731507980218,PHIL 295,021,777242,Sher; Gila,9999,0,9999,0
1731507980218,PHIL 295,022,777245,Shields; Christopher John,9999,0,9999,0
1731507980218,PHIL 295,023,777246,Tolley; Clinton,9999,0,9999,0
1731507980218,PHIL 295,024,777247,Vargas; Manuel Rogelio,9999,0,9999,0
1731507980218,PHIL 295,025,777248,Watkins; Eric,9999,0,9999,0
1731507980218,PHIL 295,026,794698,Rudolph; Rachel Etta,9999,0,9999,0
1731507980218,PHIL 295,027,794699,Kocurek; Alexander William,9999,0,9999,0
1731507980218,PHIL 295,028,794710,Yuan; Yuan,9999,0,9999,0
1731507981245,PHYS 1A,A00,759213,Tsai; Philbert S,330,0,360,30
1731507982282,PHYS 1AL,001,759214,Yagil; Avi & Tsai; Philbert S,25,0,30,5
1731507982282,PHYS 1AL,002,759215,Yagil; Avi & Tsai; Philbert S,29,0,30,1
1731507982282,PHYS 1AL,003,759216,Yagil; Avi & Tsai; Philbert S,28,0,30,2
1731507982282,PHYS 1AL,004,759217,Yagil; Avi & Tsai; Philbert S,28,0,30,2
1731507982282,PHYS 1AL,005,759218,Yagil; Avi & Tsai; Philbert S,21,0,30,9
1731507982282,PHYS 1AL,006,759219,Yagil; Avi & Tsai; Philbert S,28,0,30,2
1731507982282,PHYS 1AL,007,759220,Yagil; Avi & Tsai; Philbert S,26,0,30,4
1731507982282,PHYS 1AL,008,759221,Yagil; Avi & Tsai; Philbert S,30,0,30,0
1731507982282,PHYS 1AL,009,759222,Yagil; Avi & Tsai; Philbert S,28,0,30,2
1731507982282,PHYS 1AL,010,759223,Yagil; Avi & Tsai; Philbert S,27,0,30,3
1731507982282,PHYS 1AL,011,759225,Yagil; Avi & Tsai; Philbert S,26,0,30,4
1731507982282,PHYS 1AL,012,759226,Yagil; Avi & Tsai; Philbert S,28,0,30,2
1731507983310,PHYS 1B,A00,759229,Smith; Douglas E,573,0,600,27
1731507983310,PHYS 1B,B00,759230,Smith; Douglas E,575,0,600,25
1731507984343,PHYS 1BL,001,759232,Yagil; Avi & Tsai; Philbert S,29,0,30,1
1731507984343,PHYS 1BL,002,759233,Yagil; Avi & Tsai; Philbert S,28,0,30,2
1731507984343,PHYS 1BL,003,759235,Yagil; Avi & Tsai; Philbert S,20,0,30,10
1731507984343,PHYS 1BL,004,759236,Yagil; Avi & Tsai; Philbert S,23,0,30,7
1731507984343,PHYS 1BL,005,759237,Yagil; Avi & Tsai; Philbert S,30,0,30,0
1731507984343,PHYS 1BL,006,759238,Yagil; Avi & Tsai; Philbert S,27,0,30,3
1731507984343,PHYS 1BL,007,759239,Yagil; Avi & Tsai; Philbert S,26,0,30,4
1731507984343,PHYS 1BL,008,759240,Yagil; Avi & Tsai; Philbert S,30,0,30,0
1731507984343,PHYS 1BL,009,759241,Yagil; Avi & Tsai; Philbert S,26,0,30,4
1731507984343,PHYS 1BL,010,759242,Yagil; Avi & Tsai; Philbert S,29,0,30,1
1731507984343,PHYS 1BL,011,759243,Yagil; Avi & Tsai; Philbert S,28,0,30,2
1731507984343,PHYS 1BL,012,759244,Yagil; Avi & Tsai; Philbert S,29,0,30,1
1731507984343,PHYS 1BL,015,759248,Yagil; Avi & Tsai; Philbert S,20,0,30,10
1731507984343,PHYS 1BL,016,759250,Yagil; Avi & Tsai; Philbert S,26,0,30,4
1731507984343,PHYS 1BL,017,759254,Yagil; Avi & Tsai; Philbert S,20,0,30,10
1731507984343,PHYS 1BL,018,759256,Yagil; Avi & Tsai; Philbert S,27,0,30,3
1731507984343,PHYS 1BL,019,759257,Yagil; Avi & Tsai; Philbert S,30,0,30,0
1731507984343,PHYS 1BL,020,759259,Yagil; Avi & Tsai; Philbert S,27,0,30,3
1731507984343,PHYS 1BL,021,759260,Yagil; Avi & Tsai; Philbert S,30,0,30,0
1731507984343,PHYS 1BL,022,759261,Yagil; Avi & Tsai; Philbert S,29,0,30,1
1731507984343,PHYS 1BL,023,759262,Yagil; Avi & Tsai; Philbert S,29,0,30,1
1731507984343,PHYS 1BL,024,759265,Yagil; Avi & Tsai; Philbert S,30,0,30,0
1731507984343,PHYS 1BL,025,759266,Yagil; Avi & Tsai; Philbert S,28,0,30,2
1731507984343,PHYS 1BL,026,759270,Yagil; Avi & Tsai; Philbert S,28,0,30,2
1731507984343,PHYS 1BL,027,759271,Yagil; Avi & Tsai; Philbert S,27,0,30,3
1731507984343,PHYS 1BL,028,759275,Yagil; Avi & Tsai; Philbert S,29,0,30,1
1731507984343,PHYS 1BL,029,759276,Yagil; Avi & Tsai; Philbert S,27,0,30,3
1731507984343,PHYS 1BL,030,759277,Yagil; Avi & Tsai; Philbert S,29,0,30,1
1731507984343,PHYS 1BL,031,759278,Yagil; Avi & Tsai; Philbert S,27,0,30,3
1731507984343,PHYS 1BL,032,759280,Yagil; Avi & Tsai; Philbert S,30,0,30,0
1731507984343,PHYS 1BL,033,759298,Yagil; Avi & Tsai; Philbert S,30,0,30,0
1731507984343,PHYS 1BL,034,759338,Yagil; Avi & Tsai; Philbert S,30,0,30,0
1731507984343,PHYS 1BL,035,759363,Yagil; Avi & Tsai; Philbert S,26,0,30,4
1731507984343,PHYS 1BL,036,759376,Yagil; Avi & Tsai; Philbert S,28,0,30,2
1731507985371,PHYS 1C,A00,759402,Bal; Gurleen K,341,0,362,21
1731507986401,PHYS 1CL,001,759406,Yagil; Avi & Tsai; Philbert S,25,0,30,5
1731507986401,PHYS 1CL,002,759408,Yagil; Avi & Tsai; Philbert S,23,0,30,7
1731507986401,PHYS 1CL,003,759464,Yagil; Avi & Tsai; Philbert S,27,0,30,3
1731507986401,PHYS 1CL,004,759467,Yagil; Avi & Tsai; Philbert S,25,0,30,5
1731507986401,PHYS 1CL,005,759469,Yagil; Avi & Tsai; Philbert S,27,0,30,3
1731507986401,PHYS 1CL,006,794532,Yagil; Avi & Tsai; Philbert S,26,0,30,4
1731507986401,PHYS 1CL,007,794533,Yagil; Avi & Tsai; Philbert S,27,0,30,3
1731507986401,PHYS 1CL,008,794534,Yagil; Avi & Tsai; Philbert S,30,0,30,0
1731507986401,PHYS 1CL,009,794535,Yagil; Avi & Tsai; Philbert S,29,0,30,1
1731507986401,PHYS 1CL,010,794536,Yagil; Avi & Tsai; Philbert S,30,0,30,0
1731507986401,PHYS 1CL,011,794537,Yagil; Avi & Tsai; Philbert S,28,0,30,2
1731507986401,PHYS 1CL,012,794538,Yagil; Avi & Tsai; Philbert S,29,0,30,1
1731507987433,PHYS 2A,A01,759498,Bal; Gurleen K,30,0,30,0
1731507987433,PHYS 2A,A02,759546,Bal; Gurleen K,30,0,30,0
1731507987433,PHYS 2A,A03,759548,Bal; Gurleen K,30,0,30,0
1731507987433,PHYS 2A,A04,759549,Bal; Gurleen K,30,0,30,0
1731507987433,PHYS 2A,A05,759550,Bal; Gurleen K,29,0,30,1
1731507987433,PHYS 2A,A06,759551,Bal; Gurleen K,29,0,30,1
1731507987433,PHYS 2A,A07,759552,Bal; Gurleen K,30,0,30,0
1731507987433,PHYS 2A,A08,759553,Bal; Gurleen K,30,0,30,0
1731507987433,PHYS 2A,A09,759554,Bal; Gurleen K,30,0,30,0
1731507987433,PHYS 2A,A10,759555,Bal; Gurleen K,30,0,30,0
1731507987433,PHYS 2A,A11,759556,Bal; Gurleen K,30,0,30,0
1731507987433,PHYS 2A,A12,759558,Bal; Gurleen K,29,0,30,1
1731507987433,PHYS 2A,B01,759560,Dudko; Olga,26,0,30,4
1731507987433,PHYS 2A,B02,759561,Dudko; Olga,30,0,30,0
1731507987433,PHYS 2A,B03,759562,Dudko; Olga,30,0,30,0
1731507987433,PHYS 2A,B04,759563,Dudko; Olga,29,0,30,1
1731507987433,PHYS 2A,B05,759565,Dudko; Olga,27,0,30,3
1731507987433,PHYS 2A,B06,759566,Dudko; Olga,28,0,30,2
1731507987433,PHYS 2A,B07,759567,Dudko; Olga,24,0,30,6
1731507987433,PHYS 2A,B08,759568,Dudko; Olga,30,0,30,0
1731507987433,PHYS 2A,B09,759569,Dudko; Olga,27,0,30,3
1731507987433,PHYS 2A,B10,759611,Dudko; Olga,29,0,30,1
1731507987433,PHYS 2A,B11,759661,Dudko; Olga,24,0,30,6
1731507987433,PHYS 2A,B12,759664,Dudko; Olga,24,0,30,6
1731507988462,PHYS 2B,A01,759701,Shotwell; Brian,29,0,30,1
1731507988462,PHYS 2B,A02,759737,Shotwell; Brian,30,0,30,0
1731507988462,PHYS 2B,A03,759743,Shotwell; Brian,29,0,30,1
1731507988462,PHYS 2B,A04,759744,Shotwell; Brian,30,0,30,0
1731507988462,PHYS 2B,A05,759745,Shotwell; Brian,28,0,30,2
1731507988462,PHYS 2B,A06,759779,Shotwell; Brian,27,0,30,3
1731507988462,PHYS 2B,A07,759782,Shotwell; Brian,28,0,30,2
1731507988462,PHYS 2B,A08,759796,Shotwell; Brian,29,0,30,1
1731507988462,PHYS 2B,A09,759798,Shotwell; Brian,26,0,30,4
1731507988462,PHYS 2B,A10,759905,Shotwell; Brian,29,0,30,1
1731507988462,PHYS 2B,A11,759989,Shotwell; Brian,28,0,30,2
1731507988462,PHYS 2B,A12,759992,Shotwell; Brian,23,0,30,7
1731507989490,PHYS 2C,A01,759994,Jun; Suckjoon,22,0,30,8
1731507989490,PHYS 2C,A02,759995,Jun; Suckjoon,27,0,30,3
1731507989490,PHYS 2C,A03,759996,Jun; Suckjoon,30,0,30,0
1731507989490,PHYS 2C,A04,759997,Jun; Suckjoon,29,0,30,1
1731507989490,PHYS 2C,A05,760002,Jun; Suckjoon,30,0,30,0
1731507989490,PHYS 2C,A06,760021,Jun; Suckjoon,30,0,30,0
1731507989490,PHYS 2C,A07,760032,Jun; Suckjoon,28,0,30,2
1731507989490,PHYS 2C,A08,760035,Jun; Suckjoon,30,0,30,0
1731507989490,PHYS 2C,A09,760041,Jun; Suckjoon,30,0,30,0
1731507989490,PHYS 2C,A10,760042,Jun; Suckjoon,30,0,30,0
1731507989490,PHYS 2C,A11,760043,Jun; Suckjoon,30,0,30,0
1731507989490,PHYS 2C,A12,760044,Jun; Suckjoon,30,0,30,0
1731507990518,PHYS 2CL,A01,760046,Jun; Suckjoon,24,0,28,4
1731507990518,PHYS 2CL,A02,760047,Jun; Suckjoon,26,0,28,2
1731507990518,PHYS 2CL,A03,760048,Jun; Suckjoon,25,0,28,3
1731507990518,PHYS 2CL,A04,760049,Jun; Suckjoon,25,0,28,3
1731507990518,PHYS 2CL,A05,760050,Jun; Suckjoon,24,0,28,4
1731507990518,PHYS 2CL,A06,760051,Jun; Suckjoon,28,0,28,0
1731507990518,PHYS 2CL,A07,760052,Jun; Suckjoon,25,0,28,3
1731507990518,PHYS 2CL,A08,760053,Jun; Suckjoon,26,0,28,2
1731507991546,PHYS 2D,A01,760055,Hirsch; Jorge Eduardo,29,0,32,3
1731507991546,PHYS 2D,A02,760056,Hirsch; Jorge Eduardo,31,0,32,1
1731507992576,PHYS 4A,A01,760058,Averitt; Richard Douglas,41,0,45,4
1731507992576,PHYS 4A,A02,760085,Averitt; Richard Douglas,44,0,45,1
1731507992576,PHYS 4A,A03,760086,Averitt; Richard Douglas,44,0,45,1
1731507992576,PHYS 4A,A04,760087,Averitt; Richard Douglas,45,0,45,0
1731507993607,PHYS 4D,A01,760090,Frano Pereira; Alex M,40,0,40,0
1731507993607,PHYS 4D,A02,760096,Frano Pereira; Alex M,39,0,40,1
1731507993607,PHYS 4D,A03,760097,Frano Pereira; Alex M,40,0,40,0
1731507994640,PHYS 12,A01,760099,Branson; James G,59,0,60,1
1731507995669,PHYS 39,A01,796284,Jun; Suckjoon,0,0,0,0
1731507996696,PHYS 41,A01,760104,Green; Daniel Richard,48,0,50,2
1731507997722,PHYS 87,A00,796262,Grinstein; Benjamin,20,0,20,0
1731507998749,PHYS 100B,A01,760163,Barreiro Guerrero; Julio,72,0,75,3
1731507999781,PHYS 105A,A01,760203,Lin; Tongyan,33,0,38,5
1731507999781,PHYS 105A,A02,760212,Lin; Tongyan,36,0,37,1
1731508000809,PHYS 110B,A01,760214,Serra; Mattia,74,0,75,1
1731508001839,PHYS 124,A01,760217,Arnold; Kam S,38,0,40,2
1731508002864,PHYS 130A,A01,760219,Parker; Daniel E,38,0,40,2
1731508003891,PHYS 130C,A01,760221,You; Yizhuang,22,0,30,8
1731508004918,PHYS 136,A00,760222,Grinstein; Benjamin,50,0,50,0
1731508005943,PHYS 139,A00,760223,Di Ventra; Massimiliano & Schuller; Ivan K,28,0,30,2
1731508006974,PHYS 140B,A01,760225,Arovas; Daniel P,26,0,30,4
1731508008003,PHYS 142,A01,794356,Duarte; Javier Mauricio,52,0,55,3
1731508009031,PHYS 152A,A01,760229,Butov; Leonid,39,0,40,1
1731508010063,PHYS 160,A01,760231,Fuller; George Michael,64,0,65,1
1731508011093,PHYS 176,A00,760232,Hwa; Terence T.,10,0,10,0
1731508012120,PHYS 178,A00,760233,Kleinfeld; David,32,0,35,3
1731508013145,PHYS 203A,A01,760242,Fogler; Michael M.,13,0,30,17
1731508014174,PHYS 211B,A00,760255,Grover; Tarun,28,0,30,2
1731508015201,PHYS 212B,A01,760269,Chivukula; Raja S,18,0,30,12
1731508016228,PHYS 215B,A00,760325,McGreevy; John A.,24,0,30,6
1731508017258,PHYS 225B,A00,760326,Flauger; Raphael M,27,0,30,3
1731508018304,PHYS 239,A00,760327,Di Ventra; Massimiliano & Schuller; Ivan K,12,0,15,3
1731508018304,PHYS 239,B00,760328,Goldenfeld; Nigel,25,0,30,5
1731508019333,PHYS 242,A00,794365,Duarte; Javier Mauricio,2,0,5,3
1731508020359,PHYS 250,A00,760331,Parker; Daniel E,45,0,50,5
1731508021386,PHYS 251,A00,760332,Grinstein; Benjamin,18,0,20,2
1731508022412,PHYS 252,A00,760333,Diamond; Patrick H,8,0,10,2
1731508023441,PHYS 253,A00,760336,Fuller; George Michael & Keating; Brian,19,0,20,1
1731508024468,PHYS 254,A00,760337,Tan; Tzer Han,30,0,30,0
1731508025496,PHYS 259A,A00,795452,Hwa; Terence T.,18,0,20,2
1731508026521,PHYS 260,A00,760340,Fuller; George Michael,46,0,50,4
1731508027551,PHYS 261,A00,760341,Schuller; Ivan K,28,0,30,2
1731508028581,PHYS 276,A00,760342,Hwa; Terence T.,6,0,10,4
1731508029610,PHYS 278,A00,760343,Kleinfeld; David,14,0,15,1
1731508030641,POLI 5D,A01,761982,Dai; Yinlin,6,0,6,0
1731508030641,POLI 5D,A02,761984,Dai; Yinlin,6,0,6,0
1731508030641,POLI 5D,A03,761987,Dai; Yinlin,6,0,6,0
1731508030641,POLI 5D,A04,761988,Dai; Yinlin,6,0,6,0
1731508030641,POLI 5D,A05,762321,Dai; Yinlin,5,0,6,1
1731508030641,POLI 5D,B01,762356,Dai; Yinlin,6,0,6,0
1731508030641,POLI 5D,B02,762362,Dai; Yinlin,6,0,6,0
1731508030641,POLI 5D,B03,762365,Dai; Yinlin,5,0,6,1
1731508030641,POLI 5D,B04,762369,Dai; Yinlin,6,0,6,0
1731508030641,POLI 5D,B05,762370,Dai; Yinlin,6,0,6,0
1731508031671,POLI 10D,A01,762376,Noble; Benjamin S,29,0,32,3
1731508031671,POLI 10D,A02,762377,Noble; Benjamin S,29,0,32,3
1731508031671,POLI 10D,A03,762384,Noble; Benjamin S,29,0,32,3
1731508031671,POLI 10D,A04,762385,Noble; Benjamin S,29,0,32,3
1731508031671,POLI 10D,A05,762390,Noble; Benjamin S,32,0,32,0
1731508031671,POLI 10D,A06,762397,Noble; Benjamin S,32,0,32,0
1731508032699,POLI 11D,A01,762400,Desposato; Scott,33,0,34,1
1731508032699,POLI 11D,A02,762403,Desposato; Scott,32,0,34,2
1731508032699,POLI 11D,A03,762406,Desposato; Scott,33,0,34,1
1731508032699,POLI 11D,A04,762408,Desposato; Scott,33,0,34,1
1731508032699,POLI 11D,A05,762409,Desposato; Scott,33,0,34,1
1731508032699,POLI 11D,A06,762411,Desposato; Scott,34,0,34,0
1731508033728,POLI 87,A00,799971,Mignozzetti; Umberto,20,0,20,0
1731508034758,POLI 100W,A00,762448,Paglayan; Agustina,111,0,120,9
1731508035787,POLI 104B,A00,762450,Smith; Glenn Chatmas,208,0,216,8
1731508036819,POLI 104C,A00,762453,Salam; Amna,102,0,115,13
1731508037847,POLI 104J,A00,762454,Nichter; Maysa,180,0,196,16
1731508038872,POLI 104U,A00,762456,Nichter; Maysa,130,0,146,16
1731508039898,POLI 108,A00,762463,Adida; Claire,289,0,295,6
1731508040927,POLI 110B,A00,762465,Ingham; Sean,54,0,56,2
1731508041955,POLI 113BR,A00,762468,Hoston; Germaine,193,0,200,7
1731508041955,POLI 113BR,B00,796178,Hoston; Germaine,30,0,30,0
1731508042986,POLI 114BR,A00,762469,Hoston; Germaine,195,0,200,5
1731508042986,POLI 114BR,B00,796626,Hoston; Germaine,30,0,30,0
1731508044012,POLI 117R,A00,762470,Forman; Fonna,27,0,40,13
1731508045045,POLI 118,A00,762472,Wiens; David,97,0,104,7
1731508046072,POLI 120G,A00,762598,Fisk; David Lee,111,0,115,4
1731508047103,POLI 124A,A00,762698,Fortunato; David,53,0,56,3
1731508048135,POLI 127,A00,762700,Feeley; Maureen Catherine,157,0,158,1
1731508049162,POLI 135,A00,762703,Fisk; David Lee,144,0,146,2
1731508050191,POLI 137,A00,762704,Saiegh; Sebastian,53,0,56,3
1731508051218,POLI 138,A00,762707,Draper; Matthew William,111,0,115,4
1731508052253,POLI 142J,A00,762708,Slantchev; Branislav,109,0,115,6
1731508053279,POLI 142L,A00,762709,Wagner; Wendy,138,0,146,8
1731508054308,POLI 147B,A00,762711,Roeder; Philip G,143,0,146,3
1731508055334,POLI 153,A00,762712,Fisk; David Lee,139,0,146,7
1731508056360,POLI 160AA,A00,762714,Staff,207,0,223,16
1731508057386,POLI 191B,A00,762715,Fowler; James,26,0,26,0
1731508058414,POLI 194,A00,770731,Hill; Seth J,9999,0,9999,0
1731508059443,POLI 197SD,A00,794843,Nichter; Maysa,9999,0,9999,0
1731508060470,POLI 203A,A00,762716,Ingham; Sean,21,0,25,4
1731508061498,POLI 212,A00,762739,Goldman; Harvey Stern,1,0,2,1
1731508062524,POLI 216,A00,762740,Wiens; David,23,0,25,2
1731508063554,POLI 220C,A00,762771,Garfias Royo; Ek Francisco,24,0,25,1
1731508064580,POLI 229,A00,762772,Saiegh; Sebastian,11,0,12,1
1731508064580,POLI 229,B00,762783,Liu; Guoer,22,0,25,3
1731508065611,POLI 231,A00,762784,Nichter; Simeon C,22,0,25,3
1731508066639,POLI 231E,A00,762788,Lowes; Sara Rachel & Bazzi; Samuel A,3,0,5,2
1731508067665,POLI 245,A00,762789,Naoi; Megumi,8,0,12,4
1731508068690,POLI 248,A00,762792,Lake; David A,19,0,25,6
1731508069721,POLI 257,A00,762795,Hill; Seth J,25,0,25,0
1731508070751,POLI 258,A00,762798,Noble; Benjamin S,25,0,25,0
1731508071778,POLI 271,A00,762799,Ahlquist; John S.,23,0,24,1
1731508072807,POLI 272,A00,762802,Mignozzetti; Umberto,11,0,12,1
1731508073835,POLI 281,A00,762803,Ban; Pamela M,13,0,13,0
1731508074861,POLI 282,A00,762804,Ferree; Karen E,23,0,25,2
1731508075893,POLI 283,A00,762805,Slantchev; Branislav,20,0,25,5
1731508076974,POLI 285,A00,762807,Ingham; Sean,10,0,10,0
1731508078000,POLI 286,A00,762808,Mignozzetti; Umberto,25,0,25,0
1731508079027,POLI 288,A00,762810,Fowler; James,12,0,12,0
1731508080058,PSY 296,001,792382,Staff,10,0,10,0
1731508080058,PSY 296,002,792383,Staff,10,0,10,0
1731508080058,PSY 296,003,792385,Staff,10,0,10,0
1731508081086,PSYC 1,A00,762811,Wennberg; Janna Wold,288,0,300,12
1731508082119,PSYC 2,A00,762815,Moranton; Nirelia Melbina-,247,0,250,3
1731508083150,PSYC 4,A00,795584,Anagnostaras; Stephan,285,0,295,10
1731508084194,PSYC 60,A01,786029,Lowe; Angela Beth,35,0,35,0
1731508084194,PSYC 60,A02,786035,Lowe; Angela Beth,33,0,35,2
1731508084194,PSYC 60,A03,786043,Lowe; Angela Beth,32,0,35,3
1731508084194,PSYC 60,A04,786046,Lowe; Angela Beth,32,0,35,3
1731508084194,PSYC 60,A05,786048,Lowe; Angela Beth,33,0,35,2
1731508084194,PSYC 60,A06,786049,Lowe; Angela Beth,33,0,35,2
1731508084194,PSYC 60,A07,786050,Lowe; Angela Beth,35,0,35,0
1731508084194,PSYC 60,B01,786056,Steiner; Eric Tomas,33,0,35,2
1731508084194,PSYC 60,B02,786058,Steiner; Eric Tomas,32,0,35,3
1731508084194,PSYC 60,B03,786061,Steiner; Eric Tomas,33,0,35,2
1731508084194,PSYC 60,B04,786065,Steiner; Eric Tomas,33,0,35,2
1731508084194,PSYC 60,B05,786068,Steiner; Eric Tomas,34,0,35,1
1731508084194,PSYC 60,B06,786071,Steiner; Eric Tomas,34,0,35,1
1731508084194,PSYC 60,B07,786075,Steiner; Eric Tomas,34,0,35,1
1731508085229,PSYC 70,A01,786078,Geller; Emma Harlan,27,0,35,8
1731508085229,PSYC 70,A02,786081,Geller; Emma Harlan,30,0,35,5
1731508085229,PSYC 70,A03,786084,Geller; Emma Harlan,35,0,35,0
1731508085229,PSYC 70,A04,786088,Geller; Emma Harlan,35,0,35,0
1731508085229,PSYC 70,A05,786089,Geller; Emma Harlan,35,0,35,0
1731508085229,PSYC 70,A06,786094,Geller; Emma Harlan,34,0,35,1
1731508086257,PSYC 71,A01,762821,Pilegard; Celeste Cristine,10,0,25,15
1731508086257,PSYC 71,A02,762822,Pilegard; Celeste Cristine,24,0,25,1
1731508086257,PSYC 71,B01,762826,Lowe; Angela Beth,24,0,25,1
1731508086257,PSYC 71,B02,762827,Lowe; Angela Beth,23,0,25,2
1731508087284,PSYC 101,A00,762829,Walker; Caren Michelle,255,0,295,40
1731508088311,PSYC 102,A00,762832,Gentner; Tim,220,0,225,5
1731508089341,PSYC 105,A00,762833,Brady; Timothy Francis,294,0,328,34
1731508090375,PSYC 106,A00,762834,Dobkins; Karen R.,282,0,295,13
1731508091401,PSYC 108,A00,762835,Adrian; Julia Anna,240,0,250,10
1731508092427,PSYC 110,A00,762838,Heyman; Gail D.,35,0,35,0
1731508093458,PSYC 111A,A01,762841,Geller; Emma Harlan,35,0,35,0
1731508094491,PSYC 116B,A01,762844,Lang; Ariel,21,0,21,0
1731508095521,PSYC 124,A00,762845,Dickenson; Janna Alene,76,0,80,4
1731508096549,PSYC 125,A00,762851,Rose; Fred E.,134,0,145,11
1731508097579,PSYC 137,A00,762853,Lin; Chujun,289,0,295,6
1731508098605,PSYC 144,A00,762855,Yilmaz; Anne Sheyda,285,0,295,10
1731508099639,PSYC 148,A00,762856,Mc Kenzie; Craig R.M.,90,0,100,10
1731508100669,PSYC 151,A00,762858,Glaser; Dale,67,0,70,3
1731508101695,PSYC 153,A00,762859,Harris; Christine Renee,241,0,250,9
1731508102722,PSYC 154,B00,762860,Lacefield; Katharine I,277,0,295,18
1731508103753,PSYC 162,A00,762863,Wixted; John T,284,0,295,11
1731508104779,PSYC 168,A00,762864,Chapman; Eddie Nathaniel,260,0,328,68
1731508105807,PSYC 172,A00,762865,Dickenson; Janna Alene,288,0,300,12
1731508106834,PSYC 175,A00,762868,Dobkins; Karen R.,35,0,35,0
1731508107863,PSYC 179,A00,762869,Lacefield; Katharine I,269,0,328,59
1731508108889,PSYC 181,A00,762872,Anagnostaras; Stephan,318,0,328,10
1731508109914,PSYC 184,A00,762873,Wilson; Brent M,281,0,295,14
1731508110941,PSYC 185,A00,762875,Aron; Adam,249,0,250,1
1731508111971,PSYC 187,A00,762876,Schachner; Adena,0,0,35,35
1731508113006,PSYC 193,A00,762879,Chapman; Eddie Nathaniel,29,0,35,6
1731508113006,PSYC 193,B00,762880,Pilegard; Celeste Cristine,48,0,50,2
1731508113006,PSYC 193,C00,762927,Rickard; Timothy C.,24,0,25,1
1731508113006,PSYC 193,D00,762934,Mukku; Dhananjaya,34,0,35,1
1731508113006,PSYC 193,E00,762935,Staff,48,0,50,2
1731508114033,PSYC 193L,A01,762937,Staff,23,0,35,12
1731508114033,PSYC 193L,B01,762939,Brown; Sandra A,65,0,65,0
1731508115063,PSYC 194B,A01,762941,Heyman; Gail D.,25,0,25,0
1731508116092,PSYC 201B,A01,762943,Staff,11,0,20,9
1731508117122,PSYC 220,A00,762944,Winkielman; Piotr,11,0,20,9
1731508118148,PSYC 224,A00,762945,Staff,28,0,30,2
1731508119173,PSYC 242,A00,762946,Staff,27,0,30,3
1731508120204,PSYC 247,A00,762947,Walker; Caren Michelle,19,0,20,1
1731508121232,PSYC 269,A00,762948,Schachner; Adena,19,0,20,1
1731508122259,PSYC 270B,A00,762949,Dobkins; Karen R.,18,0,20,2
1731508123287,PSYC 272,A00,762950,Mukku; Dhananjaya,20,0,20,0
1731508123287,PSYC 272,B00,762951,Brashier; Nadia Marie,16,0,20,4
1731508124313,PSYC 274,A00,762954,Staff,28,0,30,2
1731508125338,PSYC 275,A00,762955,Staff,19,0,30,11
1731508126365,PSYC 280,A00,762956,Serences; John Thomas,68,0,85,17
1731508127402,PSYC 296,001,777832,Anagnostaras; Stephan,9999,0,9999,0
1731508127402,PSYC 296,002,777833,Aron; Adam,9999,0,9999,0
1731508127402,PSYC 296,003,777834,Mukku; Dhananjaya,9999,0,9999,0
1731508127402,PSYC 296,004,777835,Barner; David A.,9998,0,9999,1
1731508127402,PSYC 296,005,777845,Schachner; Adena,9999,0,9999,0
1731508127402,PSYC 296,006,777846,Brown; Sandra A,9999,0,9999,0
1731508127402,PSYC 296,007,777847,Ferreira; Victor,9999,0,9999,0
1731508127402,PSYC 296,008,777848,Geller; Emma Harlan,9998,0,9999,1
1731508127402,PSYC 296,009,777849,Gentner; Tim,9999,0,9999,0
1731508127402,PSYC 296,010,777850,Gorman; Michael R.,9999,0,9999,0
1731508127402,PSYC 296,011,777852,Gremel; Christina M,9999,0,9999,0
1731508127402,PSYC 296,012,777854,Harris; Christine Renee,9999,0,9999,0
1731508127402,PSYC 296,013,777856,Pashler; Harold E,9999,0,9999,0
1731508127402,PSYC 296,014,777857,Pilegard; Celeste Cristine,9999,0,9999,0
1731508127402,PSYC 296,015,777858,Powell; Lindsey Jane,9999,0,9999,0
1731508127402,PSYC 296,016,777864,Rickard; Timothy C.,9998,0,9999,1
1731508127402,PSYC 296,017,777866,Serences; John Thomas,9998,0,9999,1
1731508127402,PSYC 296,018,777867,Walker; Caren Michelle,9998,0,9999,1
1731508127402,PSYC 296,019,777888,Lin; Chujun,9998,0,9999,1
1731508127402,PSYC 296,020,777889,Brashier; Nadia Marie,9997,0,9999,2
1731508127402,PSYC 296,021,777890,Oesch; Nicholas W,9999,0,9999,0
1731508127402,PSYC 296,022,777892,Long; Bria,9999,0,9999,0
1731508128431,RAD 278,A00,763247,Contijoch; Francisco,0,0,0,0
1731508129458,RAD 296,001,792406,Berman; Zachary,9,0,10,1
1731508129458,RAD 296,002,792408,Staff,10,0,10,0
1731508129458,RAD 296,003,792409,Staff,10,0,10,0
1731508130490,RELI 101,A00,763768,Rahimi; Babak,36,0,40,4
1731508131517,REV 20,A00,794904,Pomeroy; Robert S.,40,0,40,0
1731508132544,REV 87,A00,794931,Markman; Kristina,20,0,20,0
1731508133575,RMAS 296,001,792520,Murphy; James D,10,0,10,0
1731508133575,RMAS 296,002,792521,Staff,10,0,10,0
1731508133575,RMAS 296,003,792522,Staff,10,0,10,0
1731508134605,RMED 296,001,792600,Duleba; Antoni,9,0,10,1
1731508134605,RMED 296,002,792611,Staff,10,0,10,0
1731508134605,RMED 296,003,792620,Staff,10,0,10,0
1731508135634,SE 9,A01,763260,Kuester; Falko,28,0,34,6
1731508135634,SE 9,A02,763263,Kuester; Falko,33,0,33,0
1731508135634,SE 9,A03,763264,Kuester; Falko,31,0,33,2
1731508136667,SE 101A,A01,763356,Van Den Einde; Yael Dahlia,194,0,200,6
1731508137693,SE 101B,A01,763358,Todd; Michael,199,0,200,1
1731508138721,SE 102,A01,763360,Jandaghi Semnani; Shabnam,32,0,45,13
1731508138721,SE 102,A02,763361,Jandaghi Semnani; Shabnam,44,0,45,1
1731508138721,SE 102,A03,763362,Jandaghi Semnani; Shabnam,40,0,45,5
1731508139751,SE 103,A01,763364,Van Den Einde; Yael Dahlia,73,0,75,2
1731508139751,SE 103,A02,763365,Van Den Einde; Yael Dahlia,69,0,75,6
1731508140776,SE 110A,A01,763508,Lanza Di Scalea; Francesco,143,0,146,3
1731508141805,SE 110B,A00,763509,Asaro; Robert J,54,0,56,2
1731508142839,SE 115,A01,763555,Zhu; Qiang,198,0,200,2
1731508143866,SE 130A,A00,763556,Loh; Kenneth J. H.,37,0,40,3
1731508144899,SE 140A,A01,763558,Uang; Chia-Ming,2,0,24,22
1731508144899,SE 140A,A02,763559,Uang; Chia-Ming,10,0,24,14
1731508144899,SE 140A,A03,763560,Uang; Chia-Ming,22,0,24,2
1731508144899,SE 140A,A04,763561,Uang; Chia-Ming,20,0,24,4
1731508145926,SE 143A,A01,763563,Kosmatka; John B,15,0,32,17
1731508145926,SE 143A,A02,763564,Kosmatka; John B,32,0,32,0
1731508146959,SE 151A,A01,763566,Shing; P. Benson,71,0,100,29
1731508147991,SE 160A,A01,763569,Kosmatka; John B,168,0,175,7
1731508149018,SE 167,A01,763571,Chadha; Mayank,12,0,15,3
1731508150046,SE 171,A01,763573,Kim; Hyonny,20,0,35,15
1731508151073,SE 182,A01,763627,Hutchinson; Tara,44,0,50,6
1731508152100,SE 201B,A00,763629,Conte; Joel P,25,0,50,25
1731508153128,SE 203A,A00,763635,Tsampras; Georgios,39,0,65,26
1731508154155,SE 207,A00,763636,Palermo; Alessandro,0,0,20,20
1731508155182,SE 232,A01,763638,Jandaghi Semnani; Shabnam,21,0,40,19
1731508156213,SE 242,A01,763644,Tomac; Ingrid,5,0,25,20
1731508157239,SE 243,A00,763684,Hutchinson; Tara,40,0,40,0
1731508158269,SE 251A,A00,763751,Qiao; Yu,19,0,25,6
1731508159297,SE 252,A00,763752,Lanza Di Scalea; Francesco,20,0,25,5
1731508160326,SE 260A,A00,763753,Kosmatka; John B,11,0,15,4
1731508161356,SE 262,A00,763754,Kim; Hyonny,4,0,5,1
1731508162385,SE 266,A00,763755,Loh; Kenneth J. H.,5,0,15,10
1731508163411,SE 267A,A01,763758,Chadha; Mayank,12,0,15,3
1731508164438,SE 270,A00,763760,Morrison; Machel Leigh,25,0,35,10
1731508165469,SE 272,A00,763761,Asaro; Robert J,13,0,15,2
1731508166496,SE 273,A00,763762,Jandaghi Semnani; Shabnam,15,0,15,0
1731508167528,SE 276B,A00,763763,Chen; Jiun-Shyan,27,0,30,3
1731508168559,SE 281,A01,763765,Kuester; Falko,27,0,40,13
1731508169591,SE 290,A00,794880,Chen; Jiun-Shyan,57,0,100,43
1731508170624,SE 296,001,779072,Asaro; Robert J,9999,0,9999,0
1731508170624,SE 296,002,779073,Chen; Jiun-Shyan,9999,0,9999,0
1731508170624,SE 296,003,779074,Conte; Joel P,9999,0,9999,0
1731508170624,SE 296,004,779075,Elgamal; Ahmed,9999,0,9999,0
1731508170624,SE 296,005,779076,Hutchinson; Tara,9999,0,9999,0
1731508170624,SE 296,006,779077,Jandaghi Semnani; Shabnam,9999,0,9999,0
1731508170624,SE 296,007,779080,Kim; Hyonny,9999,0,9999,0
1731508170624,SE 296,008,779081,Kim; Hyunsun Alicia,9999,0,9999,0
1731508170624,SE 296,009,779082,Kosmatka; John B,9999,0,9999,0
1731508170624,SE 296,010,779085,Krysl; Petr,9999,0,9999,0
1731508170624,SE 296,011,779095,Kuester; Falko,9999,0,9999,0
1731508170624,SE 296,012,779096,Lanza Di Scalea; Francesco,9999,0,9999,0
1731508170624,SE 296,013,779098,Loh; Kenneth J. H.,9999,0,9999,0
1731508170624,SE 296,014,779172,McCartney; John Scott,9999,0,9999,0
1731508170624,SE 296,015,779175,Morrison; Machel Leigh,9999,0,9999,0
1731508170624,SE 296,016,779178,Mosqueda; Gilberto,9999,0,9999,0
1731508170624,SE 296,017,779179,Qiao; Yu,9999,0,9999,0
1731508170624,SE 296,018,779180,Shing; P. Benson,9999,0,9999,0
1731508170624,SE 296,019,779182,Todd; Michael,9998,0,9999,1
1731508170624,SE 296,020,779183,Tomac; Ingrid,9999,0,9999,0
1731508170624,SE 296,021,779185,Tsampras; Georgios,9999,0,9999,0
1731508170624,SE 296,022,779186,Uang; Chia-Ming,9999,0,9999,0
1731508170624,SE 296,023,779187,Van Den Einde; Yael Dahlia,9999,0,9999,0
1731508170624,SE 296,024,779188,Zhu; Qiang,9999,0,9999,0
1731508170624,SE 296,025,779190,Tehrani; Mehran,9999,0,9999,0
1731508170624,SE 296,026,779213,Palermo; Alessandro,9999,0,9999,0
1731508170624,SE 296,027,779214,Chadha; Mayank,9999,0,9999,0
1731508171653,SIO 1,A01,764333,Stegman; David,35,0,36,1
1731508171653,SIO 1,A02,764349,Stegman; David,35,0,36,1
1731508171653,SIO 1,A03,764383,Stegman; David,36,0,36,0
1731508171653,SIO 1,A04,764386,Stegman; David,35,0,36,1
1731508172682,SIO 3,A01,764389,Aburto Oropeza; Marco Octavio,35,0,35,0
1731508172682,SIO 3,A02,794529,Aburto Oropeza; Marco Octavio,35,0,35,0
1731508172682,SIO 3,A03,794527,Aburto Oropeza; Marco Octavio,34,0,35,1
1731508172682,SIO 3,A04,794528,Aburto Oropeza; Marco Octavio,35,0,35,0
1731508173714,SIO 25,A01,764394,Rivera-Collazo; Isabel C,40,0,40,0
1731508173714,SIO 25,A02,764395,Rivera-Collazo; Isabel C,37,0,40,3
1731508173714,SIO 25,A03,764397,Rivera-Collazo; Isabel C,40,0,40,0
1731508173714,SIO 25,A04,764401,Rivera-Collazo; Isabel C,39,0,40,1
1731508173714,SIO 25,A05,764454,Rivera-Collazo; Isabel C,38,0,40,2
1731508173714,SIO 25,A06,764460,Rivera-Collazo; Isabel C,38,0,40,2
1731508173714,SIO 25,A07,764480,Rivera-Collazo; Isabel C,38,0,40,2
1731508173714,SIO 25,A08,764484,Rivera-Collazo; Isabel C,39,0,40,1
1731508173714,SIO 25,A09,764488,Rivera-Collazo; Isabel C,39,0,40,1
1731508173714,SIO 25,A10,764490,Rivera-Collazo; Isabel C,38,0,40,2
1731508174741,SIO 45,A00,764491,Cook; Geoffrey W,91,0,120,29
1731508175768,SIO 65,A00,764497,Cook; Geoffrey W,34,0,35,1
1731508176795,SIO 87,A00,764567,Aburto Oropeza; Marco Octavio,25,0,25,0
1731508176795,SIO 87,B00,764568,Cook; Geoffrey W,20,0,20,0
1731508177820,SIO 90,A00,764570,Staff,57,0,65,8
1731508178853,SIO 102,A01,764574,Day; James M.D.,41,0,45,4
1731508179881,SIO 107,A00,764576,Schartup; Amina Bocary,28,0,30,2
1731508180979,SIO 109R,A00,764581,Forman; Fonna,53,0,75,22
1731508182007,SIO 116,A00,764582,Benmarhnia; Tarik,14,0,25,11
1731508183035,SIO 119,A01,764636,Send; Uwe & Andersson; Andreas Jerry,24,0,32,8
1731508183035,SIO 119,A02,764658,Send; Uwe & Andersson; Andreas Jerry,30,0,32,2
1731508183035,SIO 119,A03,764662,Send; Uwe & Andersson; Andreas Jerry,31,0,32,1
1731508183035,SIO 119,A04,764663,Send; Uwe & Andersson; Andreas Jerry,31,0,32,1
1731508184064,SIO 120,A01,764666,Cook; Geoffrey W,19,0,24,5
1731508185094,SIO 123,A00,764667,Allen; Andrew Ellis,38,0,40,2
1731508186126,SIO 126,A01,764669,Palenik; Brian,27,0,30,3
1731508186126,SIO 126,A02,764670,Palenik; Brian,29,0,30,1
1731508187154,SIO 133,A01,764673,Baumann-Pickering ; Simone & Kacev; David,27,0,36,9
1731508187154,SIO 133,A02,764674,Baumann-Pickering ; Simone & Kacev; David,33,0,36,3
1731508187154,SIO 133,A03,764675,Baumann-Pickering ; Simone & Kacev; David,30,0,36,6
1731508187154,SIO 133,A04,764676,Baumann-Pickering ; Simone & Kacev; David,34,0,36,2
1731508188184,SIO 134,A01,764678,Barton; Andrew David,13,0,14,1
1731508188184,SIO 134,A02,764680,Barton; Andrew David,12,0,14,2
1731508188184,SIO 134,A03,764682,Barton; Andrew David,8,0,14,6
1731508188184,SIO 134,A04,764684,Barton; Andrew David,13,0,14,1
1731508188184,SIO 134,A05,764685,Barton; Andrew David,13,0,14,1
1731508188184,SIO 134,A06,764686,Barton; Andrew David,12,0,15,3
1731508188184,SIO 134,A07,764687,Barton; Andrew David,12,0,15,3
1731508188184,SIO 134,A08,764688,Barton; Andrew David,15,0,15,0
1731508189210,SIO 144,A00,764690,Day; James M.D.,5,0,5,0
1731508190236,SIO 161,A01,764693,Fan; Wenyuan,18,0,20,2
1731508191265,SIO 162,A00,764694,Wright; Vashan,23,0,25,2
1731508192293,SIO 164,A00,764696,Staff,42,0,45,3
1731508193320,SIO 172,A00,764697,Norris; Joel Roland,35,0,40,5
1731508194346,SIO 178,A00,764699,Becker; Janet Maria,20,0,20,0
1731508195372,SIO 182,A00,764701,Constable; Steven C,19,0,20,1
1731508196399,SIO 187,A01,764776,Kacev; David,33,0,35,2
1731508196399,SIO 187,A02,764777,Kacev; David,32,0,35,3
1731508196399,SIO 187,A03,764779,Kacev; David,34,0,35,1
1731508196399,SIO 187,A04,764781,Kacev; David,32,0,35,3
1731508197431,SIO 190L,A01,764790,Sandin; Stuart Adrian,32,0,35,3
1731508198459,SIO 194,A00,770729,Hill; Seth J,9999,0,9999,0
1731508199487,SIOB 262,A00,764791,Moore; Bradley S.,23,0,25,2
1731508200513,SIOB 265,A01,764793,Jensen; Paul R.,8,0,12,4
1731508201554,SIOB 272,A01,764796,Sandin; Stuart Adrian,9,0,20,11
1731508201554,SIOB 272,A02,764797,Sandin; Stuart Adrian,14,0,20,6
1731508202590,SIOB 279,A00,794515,Barton; Andrew David,11,0,20,9
1731508203629,SIOB 286,A01,764803,Mesnick; Sarah & Smith; Jennifer,0,0,20,20
1731508204655,SIOB 291,A00,764806,Staff,0,0,0,0
1731508205687,SIOB 296,A00,794530,Staff,0,0,0,20
1731508206715,SIOB 297,A00,764807,Allen; Eric,17,0,25,8
1731508207743,SIOC 200C,A00,764808,Lin; Ying-Tsong,19,0,20,1
1731508208771,SIOC 202A,A00,764810,Hao; Xuanting & Lin; Ying-Tsong,22,0,30,8
1731508209808,SIOC 203B,A00,764811,Llewellyn Smith; Stefan G.,22,0,25,3
1731508210836,SIOC 207B,A00,764813,Meyer; Florian,1,0,5,4
1731508211866,SIOC 208,A00,764814,Merrifield; Mark A,30,0,40,10
1731508212893,SIOC 209,A00,764881,Benmarhnia; Tarik,12,0,30,18
1731508212893,SIOC 209,B00,794517,Charbit; Lia,30,0,30,0
1731508213918,SIOC 211A,A00,764882,Mackinnon; Jennifer A.,18,0,25,7
1731508214948,SIOC 212A,A00,764892,Eisenman; Ian,9,0,20,11
1731508215979,SIOC 216A,A00,794518,Werner; Bradley T.,19,0,20,1
1731508217006,SIOC 217B,A00,764895,Norris; Joel Roland,12,0,20,8
1731508218033,SIOC 217D,A00,764904,Keeling; Ralph F. & Russell; Lynn M.,19,0,20,1
1731508219060,SIOC 219,A00,796147,Mackinnon; Jennifer A. & Young; William Roy,29,0,30,1
1731508220090,SIOC 221B,A00,764907,Gille; Sarah T,17,0,25,8
1731508221117,SIOC 223,A00,764910,Send; Uwe & Merrifield; Mark A,18,0,20,2
1731508222150,SIOC 237B,A00,764912,Stramski; Dariusz,17,0,20,3
1731508223179,SIOC 296,A00,799576,Staff,0,0,0,0
1731508224209,SIOG 200C,A00,794531,Fan; Wenyuan,0,0,0,0
1731508225236,SIOG 223B,A00,764966,Agnew; Duncan Carr & Fan; Wenyuan,18,0,20,2
1731508226262,SIOG 227A,A00,765040,Gabriel; Anne Alice-Agnes,5,0,10,5
1731508227289,SIOG 228,A00,765043,Kacev; David,7,0,20,13
1731508228316,SIOG 229,A00,765046,Borsa; Adrian Antal,19,0,20,1
1731508229346,SIOG 234,A00,765047,Sandwell; David T,13,0,15,2
1731508230375,SIOG 237,A01,765099,Fialko; Yuri A.,18,0,20,2
1731508231401,SIOG 239,A00,765100,Gabriel; Anne Alice-Agnes,20,0,20,0
1731508232432,SIOG 252A,A00,765102,Day; James M.D.,5,0,10,5
1731508233459,SIOG 260,A00,765105,Schartup; Amina Bocary,21,0,50,29
1731508234488,SOCE 194,A00,770728,Hill; Seth J,9999,0,9999,0
1731508235514,SOCG 202,A00,764221,Goldman; Harvey Stern,4,0,10,6
1731508236539,SOCG 203,A00,764223,Ribas Norris; Janet Vanesa,1,0,10,9
1731508237565,SOCG 205,A00,764255,Sutton; April Marie,6,0,10,4
1731508238596,SOCG 208B,A00,764258,Ng; Kwai,5,0,10,5
1731508239623,SOCG 209,A00,764259,Lewis; Kevin Michael,0,0,10,10
1731508240650,SOCG 247,A00,764260,Edington; Claire Ellen,5,0,5,0
1731508241677,SOCG 253,A00,764262,Evans; John Hyde,4,0,8,4
1731508242706,SOCG 255C,A00,764266,McKenzie; Kerry V.,5,0,5,0
1731508243732,SOCG 255D,A00,764272,Lampland; Martha,5,0,5,0
1731508244764,SOCG 284,B00,800628,Navon; Daniel,0,0,0,0
1731508245794,SOCG 290,A00,794511,Gong; Neil M,9,0,10,1
1731508246827,SOCI 1,A01,763771,Rogers; Julia Ellen,30,0,30,0
1731508246827,SOCI 1,A02,763835,Rogers; Julia Ellen,29,0,30,1
1731508246827,SOCI 1,A03,763839,Rogers; Julia Ellen,30,0,30,0
1731508246827,SOCI 1,A04,763845,Rogers; Julia Ellen,27,0,30,3
1731508246827,SOCI 1,A05,763860,Rogers; Julia Ellen,29,0,30,1
1731508246827,SOCI 1,A06,763866,Rogers; Julia Ellen,30,0,30,0
1731508247855,SOCI 2,A01,763874,Staff,32,0,32,0
1731508247855,SOCI 2,A02,763875,Staff,30,0,32,2
1731508247855,SOCI 2,A03,763876,Staff,30,0,32,2
1731508247855,SOCI 2,A04,763896,Staff,30,0,32,2
1731508247855,SOCI 2,A05,763899,Staff,30,0,32,2
1731508247855,SOCI 2,A06,763901,Staff,31,0,32,1
1731508247855,SOCI 2,A07,763902,Staff,30,0,32,2
1731508247855,SOCI 2,A08,763904,Staff,31,0,32,1
1731508248883,SOCI 20,A01,763907,Kenworthy; Lane A.,30,0,30,0
1731508248883,SOCI 20,A02,763908,Kenworthy; Lane A.,26,0,30,4
1731508249908,SOCI 60,A01,763977,Ribas Norris; Janet Vanesa,28,0,32,4
1731508249908,SOCI 60,A02,763979,Ribas Norris; Janet Vanesa,31,0,32,1
1731508250936,SOCI 70,A01,763986,Lewis; Kevin Michael,25,0,30,5
1731508250936,SOCI 70,A02,763988,Lewis; Kevin Michael,30,0,30,0
1731508250936,SOCI 70,A03,763990,Lewis; Kevin Michael,27,0,30,3
1731508250936,SOCI 70,A04,764042,Lewis; Kevin Michael,27,0,30,3
1731508251964,SOCI 100,A01,764047,Goldman; Harvey Stern,29,0,30,1
1731508251964,SOCI 100,A02,764048,Goldman; Harvey Stern,29,0,30,1
1731508251964,SOCI 100,A03,764052,Goldman; Harvey Stern,28,0,30,2
1731508251964,SOCI 100,A04,764058,Goldman; Harvey Stern,28,0,30,2
1731508252991,SOCI 103M,A00,764059,Kilpatrick; Kevin,25,0,30,5
1731508254020,SOCI 104,A00,764066,Arnal; Maud Marie Leonie,25,0,30,5
1731508255052,SOCI 106,A00,795036,Shafir; Gershon,29,0,30,1
1731508256080,SOCI 109,A00,764070,Kilpatrick; Kevin,29,0,30,1
1731508257111,SOCI 117,A01,764078,Jones; Gabrielle Anastasia,15,0,17,2
1731508257111,SOCI 117,A02,764084,Jones; Gabrielle Anastasia,16,0,17,1
1731508257111,SOCI 117,A03,764085,Jones; Gabrielle Anastasia,17,0,17,0
1731508257111,SOCI 117,A04,764086,Jones; Gabrielle Anastasia,19,0,19,0
1731508257111,SOCI 117,B01,764163,Aragon; Maria Jose,8,0,10,2
1731508257111,SOCI 117,B02,764170,Aragon; Maria Jose,10,0,10,0
1731508258135,SOCI 118,A00,764178,Rogers; Julia Ellen,74,0,75,1
1731508259163,SOCI 119,A00,764179,Victoria Torres; Pablo,86,0,90,4
1731508260190,SOCI 120T,A00,764180,Staff,56,0,56,0
1731508261221,SOCI 124,A00,764181,Kenworthy; Lane A.,48,0,50,2
1731508262254,SOCI 125,A00,764182,Watson; Tobias,63,0,65,2
1731508263282,SOCI 126,A01,764184,Jones; Makeba,17,0,20,3
1731508263282,SOCI 126,A02,764185,Jones; Makeba,20,0,20,0
1731508263282,SOCI 126,A03,764186,Jones; Makeba,20,0,20,0
1731508264311,SOCI 127,A00,764187,Fitzgerald; David S,60,0,65,5
1731508265341,SOCI 130E,A00,764188,Pitt; Richard Norris,42,0,45,3
1731508266368,SOCI 133E,A00,764189,Pitt; Richard Norris,55,0,56,1
1731508267400,SOCI 135,A00,764190,Payne; Christine Anna,70,0,74,4
1731508268427,SOCI 136E,A00,764191,Ruiz; Jonathan Joseph,55,0,56,1
1731508269458,SOCI 136F,A00,764192,Gong; Neil M,55,0,56,1
1731508270483,SOCI 140,A00,764193,Tirshfield; Jeffrey T,46,0,49,3
1731508271510,SOCI 142,A00,764194,Crofts; Christine,56,0,70,14
1731508272536,SOCI 144P,A00,764195,Estefan; Michel,71,0,75,4
1731508273567,SOCI 148,A00,764196,Payne; Christine Anna,93,0,100,7
1731508274597,SOCI 148E,A00,764197,Calderon-Zaks; Michael Aar,43,0,45,2
1731508275623,SOCI 149,A00,764198,Alvarez; Camila Huerta,49,0,55,6
1731508276657,SOCI 150,A00,764200,Victoria Torres; Pablo,74,0,75,1
1731508277684,SOCI 154,A00,764201,Crofts; Christine,46,0,55,9
1731508278715,SOCI 159,B00,764202,Staff,56,0,56,0
1731508279743,SOCI 160,A00,764203,Ostovany; Khashayar,49,0,50,1
1731508280770,SOCI 161,A00,764204,Arnal; Maud Marie Leonie,53,0,56,3
1731508281798,SOCI 162,A00,764207,Rogers; Julia Ellen,53,0,55,2
1731508282828,SOCI 169,A00,764208,Shafir; Gershon,34,0,35,1
1731508283855,SOCI 170,A00,764209,Lampland; Martha,45,0,45,0
1731508284956,SOCI 171,A00,764210,Ruiz; Jonathan Joseph,51,0,56,5
1731508285984,SOCI 173,A00,764211,Navon; Daniel,99,0,100,1
1731508287016,SOCI 175,A00,764213,Calderon-Zaks; Michael Aar,64,0,65,1
1731508288043,SOCI 180,A00,764214,Ostovany; Khashayar,48,0,50,2
1731508289068,SOCI 183,A00,764215,Sutton; April Marie,25,0,25,0
1731508290093,SOCI 188,A01,764217,Andrews; Abigail Leslie,0,0,0,0
1731508291124,SOCI 188E,A00,764219,Jules-Rosette; Bennetta W.,30,0,30,0
1731508292150,SOCI 196B,A00,764220,Turner; Christena L.,14,0,15,1
1731508293178,SOMC 225,A00,792643,Rifkin; Dena E.,160,0,160,0
1731508294210,SOMC 227,A00,792651,Gold; Jeffrey Joseph,160,0,160,0
1731508295235,SOMC 237,A00,792671,Gold; Jeffrey Joseph,160,0,160,0
1731508296265,SOMC 238,A00,792678,Papamatheakis; Demosthenes,160,0,160,0
1731508297290,SOMC 239,A00,792686,Rifkin; Dena E.,160,0,160,0
1731508298322,SOMC 243,A00,793653,Gaines; Tommi L.,160,0,160,0
1731508299351,SOMC 245B,A01,792743,Noel; Geoffroy Pierre Jean,160,0,160,0
1731508300378,SOMC 246B,A00,792744,Eyler; Lisa T.,160,0,160,0
1731508301405,SOMC 247B,A50,792756,Calcutt; Nigel A,160,0,160,0
1731508302431,SOMC 248B,A00,792757,Joshi; Weena Erin,160,0,160,0
1731508303456,SOMC 251B,A00,792760,Eyler; Lisa T.,160,0,160,0
1731508304481,SOMC 252B,A00,792780,Taddonio; Michael Adam,160,0,160,0
1731508305511,SOMC 253B,A00,792808,Wooten; Darcy A,160,0,160,0
1731508306540,SOMC 254B,A00,792815,Joshi; Weena Erin,160,0,160,0
1731508307565,SOMC 255B,A00,792836,Allison; Matthew,160,0,160,0
1731508308589,SOMC 256B,A00,792845,Shapiro; Desiree Nicolette,160,0,160,0
1731508309622,SPPH 263A,A00,792290,O'Donoghue; Anthony John & Abagyan; Ruben,47,0,50,3
1731508310649,SPPS 200A,A00,792291,Luli; Alex J,100,0,100,0
1731508311680,SPPS 202,A00,792292,Fricovsky; Eduardo Santiago,76,0,80,4
1731508312706,SPPS 207,A01,792296,Hernandez Y Delso; Inmacul,76,0,80,4
1731508313730,SPPS 208,A00,792297,Bounthavong; Mark,76,0,80,4
1731508314758,SPPS 210,001,799992,Gustafsson; Asa Birgitta,99,0,99,0
1731508315788,SPPS 212B,A01,792301,Humber; Douglas M,80,0,80,0
1731508316814,SPPS 212D,A01,792304,Patel; Nimish,80,0,80,0
1731508317844,SPPS 216,A00,792305,Fitzgerald; Robert,80,0,80,0
1731508318874,SPPS 218A,A00,792306,Vijapurkar; Ulka,80,0,80,0
1731508319906,SPPS 223,A01,792308,Hook; Vivian Yuan-Ho,95,0,99,4
1731508320935,SPPS 224,A01,792310,Momper; Jeremiah D,76,0,80,4
1731508321961,SPPS 234,A00,792312,Rifkin; Dena E.,80,0,80,0
1731508322989,SPPS 248,A00,792315,Brandl; Katharina,80,0,80,0
1731508324019,SPPS 251,A00,792316,Chen; Timothy,20,0,20,0
1731508325047,SPPS 254,A00,792317,Shapiro; Desiree Nicolette,49,0,50,1
1731508326081,SPPS 264B,A00,792319,Tsunoda; Shirley M.,30,0,30,0
1731508327108,SPPS 270B,A00,792320,Fricovsky; Eduardo Santiago,30,0,30,0
1731508328138,SPPS 274,A00,792323,Namba; Jennifer Mariko,60,0,60,0
1731508329167,SPPS 278,A00,792325,Fricovsky; Eduardo Santiago,99,0,99,0
1731508330196,SPPS 282,A00,792326,Radic; Zoran,10,0,10,0
1731508331222,SPPS 287,A00,792327,Tsunoda; Shirley M.,60,0,60,0
1731508332248,SPPS 288,A00,792328,Saunders; Ila Maewal,98,0,99,1
1731508333276,SPPS 289,A00,792329,Armour; Jon Christopher,60,0,60,0
1731508334304,SURG 296,001,792875,Reid; Christopher,9,0,10,1
1731508334304,SURG 296,002,792880,Staff,10,0,10,0
1731508334304,SURG 296,003,792882,Staff,10,0,10,0
1731508335355,SYN 1,001,768443,Rosenberg; Ryan Glenn,17,0,20,3
1731508335355,SYN 1,002,768444,Iatarola; Briana Marie,11,0,20,9
1731508335355,SYN 1,003,768445,Bishop; Graham,14,0,20,6
1731508335355,SYN 1,004,768446,Atkinson; Arthur Laird,19,0,20,1
1731508335355,SYN 1,005,768447,Girard; Gabrielle,20,0,20,0
1731508335355,SYN 1,006,768455,Girard; Gabrielle,20,0,20,0
1731508335355,SYN 1,007,768471,Fish; Gwendolyn Anne,20,0,20,0
1731508335355,SYN 1,008,768473,Deavenport; James Cary,16,0,20,4
1731508335355,SYN 1,009,768474,Hom; Kirstyn Courtney,20,0,20,0
1731508335355,SYN 1,010,768494,Hom; Kirstyn Courtney,12,0,20,8
1731508335355,SYN 1,011,768525,Deavenport; James Cary,19,0,20,1
1731508335355,SYN 1,012,768794,Lagapa; Jason,19,0,20,1
1731508335355,SYN 1,013,768795,Meyer; Leslie Rose,17,0,20,3
1731508335355,SYN 1,014,768798,Meyer; Leslie Rose,18,0,20,2
1731508336385,SYN 1R,001,768853,Atkinson; Arthur Laird,19,0,20,1
1731508337423,SYN 2,001,768857,Birberick; Brittany Celest,20,0,20,0
1731508337423,SYN 2,002,768859,Girard; Gabrielle,17,0,20,3
1731508337423,SYN 2,003,768862,Tawater; Hanna Jean,20,0,20,0
1731508337423,SYN 2,004,768869,Tawater; Hanna Jean,17,0,20,3
1731508337423,SYN 2,005,768871,Difruscio; Mark,20,0,20,0
1731508337423,SYN 2,006,768872,Rock; Martin,18,0,20,2
1731508337423,SYN 2,007,768876,Difruscio; Mark,17,0,20,3
1731508337423,SYN 2,008,768878,Staff,20,0,20,0
1731508337423,SYN 2,010,768890,Rock; Martin,18,0,20,2
1731508337423,SYN 2,011,768891,Browne; Emily,19,0,20,1
1731508338454,SYN 2R,001,768972,Staff,18,0,20,2
1731508339505,SYN 100,A01,768983,Gladstein; Jill M,15,0,15,0
1731508339505,SYN 100,A02,768990,Gladstein; Jill M,14,0,15,1
1731508339505,SYN 100,B01,769012,Tawater; Hanna Jean,6,0,15,9
1731508339505,SYN 100,B02,769014,Tawater; Hanna Jean,5,0,15,10
1731508339505,SYN 100,C01,769019,Rosenberg; Ryan Glenn,11,0,15,4
1731508339505,SYN 100,C02,769022,Rosenberg; Ryan Glenn,15,0,15,0
1731508339505,SYN 100,D01,769025,Rosenberg; Ryan Glenn,14,0,15,1
1731508339505,SYN 100,D02,769027,Rosenberg; Ryan Glenn,12,0,15,3
1731508339505,SYN 100,E01,769044,Browne; Emily,13,0,15,2
1731508339505,SYN 100,E02,769053,Browne; Emily,14,0,15,1
1731508339505,SYN 100,F01,769071,Browne; Emily,10,0,15,5
1731508339505,SYN 100,F02,769072,Browne; Emily,15,0,15,0
1731508339505,SYN 100,G01,769096,Iatarola; Briana Marie,13,0,15,2
1731508339505,SYN 100,G02,769202,Iatarola; Briana Marie,10,0,15,5
1731508339505,SYN 100,H01,769221,Meyer; Leslie Rose,12,0,15,3
1731508339505,SYN 100,H02,795165,Meyer; Leslie Rose,14,0,15,1
1731508339505,SYN 100,I01,769227,Deavenport; James Cary,11,0,15,4
1731508339505,SYN 100,I02,769228,Deavenport; James Cary,12,0,15,3
1731508339505,SYN 100,J01,769230,Hom; Kirstyn Courtney,11,0,15,4
1731508339505,SYN 100,J02,769231,Hom; Kirstyn Courtney,14,0,15,1
1731508339505,SYN 100,K01,769233,Bishop; Graham,14,0,24,10
1731508339505,SYN 100,L01,769237,Difruscio; Mark,6,0,15,9
1731508339505,SYN 100,L02,769238,Difruscio; Mark,12,0,15,3
1731508339505,SYN 100,M01,769277,Gormally; Brenna,13,0,15,2
1731508339505,SYN 100,M02,769284,Gormally; Brenna,15,0,15,0
1731508339505,SYN 100,N01,769291,Rock; Martin,11,0,15,4
1731508339505,SYN 100,N02,769292,Rock; Martin,15,0,15,0
1731508339505,SYN 100,O01,769308,Atkinson; Arthur Laird,11,0,15,4
1731508339505,SYN 100,O02,769309,Atkinson; Arthur Laird,15,0,15,0
1731508340533,SYN 150,001,769422,Gladstein; Jill M,20,0,20,0
1731508340533,SYN 150,002,769423,Vega; Adrian,19,0,20,1
1731508340533,SYN 150,003,769424,Fish; Gwendolyn Anne,19,0,20,1
1731508340533,SYN 150,004,769427,Lagapa; Jason,20,0,20,0
1731508340533,SYN 150,005,769430,Lagapa; Jason,20,0,20,0
1731508340533,SYN 150,006,769431,Fish; Gwendolyn Anne,20,0,20,0
1731508340533,SYN 150,007,796615,Vega; Adrian,19,0,20,1
1731508341560,SYN 150R,001,769499,Vega; Adrian,20,0,20,0
1731508342604,TDAC 1,A00,760383,Walsh; Kim C.,11,0,20,9
1731508342604,TDAC 1,B00,760388,Walsh; Kim C.,19,0,20,1
1731508342604,TDAC 1,C00,760389,Walsh; Kim C.,19,0,20,1
1731508342604,TDAC 1,D00,760395,Walsh; Kim C.,16,0,20,4
1731508342604,TDAC 1,E00,760396,Walsh; Kim C.,17,0,20,3
1731508342604,TDAC 1,F00,760406,Walsh; Kim C.,17,0,20,3
1731508343641,TDAC 101,A00,760817,Harting; Carla Kelso,19,0,20,1
1731508343641,TDAC 101,B00,760819,Salovey; Todd,17,0,20,3
1731508344669,TDAC 102,A00,795388,Walsh; Kim C.,19,0,20,1
1731508345695,TDAC 108,A00,795390,Staff,14,0,16,2
1731508346722,TDAC 111,A00,760821,Meyer; Ursula,20,0,20,0
1731508347747,TDAC 115,A00,760822,Buescher; Stephen W.,14,0,20,6
1731508348775,TDAC 122,A00,795391,Perry; Lamar,30,0,30,0
1731508348775,TDAC 122,B00,796062,Celik; Aysan Karagasli,30,0,30,0
1731508349810,TDDE 1,A01,760433,Guirguis; Mark C,16,0,18,2
1731508349810,TDDE 1,A02,760434,Guirguis; Mark C,17,0,18,1
1731508349810,TDDE 1,A03,760436,Guirguis; Mark C,16,0,18,2
1731508349810,TDDE 1,A04,760513,Guirguis; Mark C,18,0,18,0
1731508349810,TDDE 1,A05,760515,Guirguis; Mark C,18,0,18,0
1731508350838,TDDE 111,A00,760823,Benzoni; Elisa,0,0,0,0
1731508351865,TDDE 130,A00,760827,Guirguis; Mark C,19,0,20,1
1731508352892,TDDE 132,A00,760828,Guirguis; Mark C,20,0,20,0
1731508353920,TDDM 1,A00,760516,Wilson; Terry A.,29,0,30,1
1731508354954,TDDM 101,A00,795403,Johnston; Holly,29,0,30,1
1731508355986,TDDR 101,A00,760835,Powell; Lora,28,0,30,2
1731508357012,TDDR 102,A00,760836,Powell; Lora,20,0,20,0
1731508358039,TDDR 190,A00,795392,Perry; Lamar,35,0,35,0
1731508359066,TDGE 1,A01,760522,Salovey; Todd,20,0,20,0
1731508359066,TDGE 1,A02,760523,Salovey; Todd,20,0,20,0
1731508359066,TDGE 1,A03,760526,Salovey; Todd,20,0,20,0
1731508359066,TDGE 1,A04,760531,Salovey; Todd,18,0,20,2
1731508359066,TDGE 1,A05,760546,Salovey; Todd,20,0,20,0
1731508359066,TDGE 1,A06,760784,Salovey; Todd,19,0,20,1
1731508360096,TDGE 11,A00,760785,Anderson; Mysia Anyse,128,0,146,18
1731508361123,TDGE 25,A00,760786,Harting; Carla Kelso,18,0,20,2
1731508361123,TDGE 25,B00,760788,Harting; Carla Kelso,17,0,20,3
1731508361123,TDGE 25,C00,760789,Harting; Carla Kelso,14,0,20,6
1731508361123,TDGE 25,D00,760790,Harting; Carla Kelso,16,0,20,4
1731508362152,TDGE 87,A00,760791,Guirguis; Mark C,20,0,20,0
1731508362152,TDGE 87,B00,795393,Adler; Steven,20,0,20,0
1731508363178,TDGE 124,A00,760838,Fulton; Julia,231,0,250,19
1731508364208,TDGE 127,A00,760839,Havis; Allan,218,0,225,7
1731508365237,TDGE 131,A00,760840,Burelle; Julie Sara Veronique,203,0,205,2
1731508366265,TDGR 210B,A00,760881,Celik; Aysan Karagasli,10,0,10,0
1731508367290,TDGR 212,A00,760883,Meyer; Ursula,10,0,10,0
1731508368321,TDGR 219,A00,760886,Perry; Lamar,0,0,0,0
1731508369352,TDGR 221A,A00,760887,Staff,10,0,10,0
1731508370380,TDGR 223B,A00,760889,Buescher; Stephen W.,10,0,10,0
1731508371406,TDGR 224B,A00,760890,Meyer; Ursula,10,0,10,0
1731508372433,TDGR 225B,A00,760891,Blair; Kyle Adam,10,0,10,0
1731508373461,TDGR 229,A00,760892,Brill; Robert L.,1,0,1,0
1731508373461,TDGR 229,B00,760893,Stalling; Vanessa,1,0,1,0
1731508373461,TDGR 229,C00,760894,Porter; Lisa,1,0,1,0
1731508374488,TDGR 244,A00,760895,Iizuka; Naomi Hisako,20,0,20,0
1731508375516,TDGR 245,A00,760898,Stalling; Vanessa,5,0,5,0
1731508376546,TDGR 250,A00,760899,Stein; Deborah Isobel,7,0,7,0
1731508377571,TDGR 251,A00,760900,Iizuka; Naomi Hisako,5,0,5,0
1731508377571,TDGR 251,B00,760901,Stein; Deborah Isobel,5,0,5,0
1731508378597,TDGR 257A,A00,760903,Staff,7,0,7,0
1731508379622,TDGR 262,A01,796141,Petrovich; Victoria A.,10,0,10,0
1731508380650,TDGR 269A,A00,760905,Petrovich; Victoria A.,18,0,20,2
1731508381677,TDGR 270C,A00,760909,Kuhl; Christopher August,20,0,20,0
1731508382706,TDGR 270D,A00,760911,McElver; Robert Harrison,20,0,20,0
1731508383732,TDGR 274,A00,760912,Brill; Robert L.,9,0,10,1
1731508384758,TDGR 275,A00,760913,Kuhl; Christopher August,10,0,10,0
1731508385786,TDGR 276,A00,760914,Benzoni; Elisa,10,0,10,0
1731508386814,TDGR 278,A00,760915,Staff,10,0,10,0
1731508386814,TDGR 278,B00,760919,Staff,20,0,20,0
1731508387841,TDGR 279,A00,760920,Benzoni; Elisa,5,0,5,0
1731508387841,TDGR 279,B00,760921,Petrovich; Victoria A.,4,0,5,1
1731508387841,TDGR 279,C00,760923,McElver; Robert Harrison,5,0,5,0
1731508387841,TDGR 279,D00,760924,Kuhl; Christopher August,5,0,5,0
1731508387841,TDGR 279,E00,760927,Brill; Robert L.,4,0,5,1
1731508388941,TDGR 282,A00,760930,McElver; Robert Harrison,10,0,10,0
1731508389969,TDGR 286,A00,760931,Staff,10,0,10,0
1731508390996,TDGR 288,A00,760932,Porter; Lisa,5,0,5,0
1731508392022,TDGR 289C,A00,760933,Mehrishi; Rishika,10,0,10,0
1731508393053,TDGR 289D,A00,760934,Power; Jade Yukana,10,0,10,0
1731508394079,TDGR 292,A00,760936,Burelle; Julie Sara Veronique,14,0,15,1
1731508395108,TDGR 293,A00,760937,Perry; Lamar,2,0,2,0
1731508396134,TDGR 296,A00,760938,Porter; Lisa,3,0,3,0
1731508396134,TDGR 296,B00,760939,Powell; Lora,3,0,3,0
1731508397163,TDGR 297,001,760940,Iizuka; Naomi Hisako,3,0,3,0
1731508398192,TDHD 20,A00,760792,Jun; Grace Shin Hae,20,0,20,0
1731508399225,TDHD 176,A00,795405,Staff,45,0,45,0
1731508400259,TDHT 10,A00,760794,Power; Jade Yukana,15,0,15,0
1731508400259,TDHT 10,B00,760795,Power; Jade Yukana,13,0,15,2
1731508401290,TDHT 22,A01,760797,Yapp; Hentyle T,24,0,24,0
1731508401290,TDHT 22,A02,760799,Yapp; Hentyle T,24,0,24,0
1731508401290,TDHT 22,A03,760801,Yapp; Hentyle T,21,0,24,3
1731508402320,TDHT 101,A00,760843,Mehrishi; Rishika,24,0,25,1
1731508402320,TDHT 101,B00,760845,Perry; Lamar,23,0,25,2
1731508403351,TDHT 102,A00,760846,Anderson; Mysia Anyse,24,0,25,1
1731508404380,TDHT 111,A00,760849,Power; Jade Yukana,17,0,20,3
1731508405409,TDMV 1,A00,760802,Arcidiacono; Kristin,25,0,30,5
1731508405409,TDMV 1,B00,760803,Staff,26,0,30,4
1731508406436,TDMV 2,A00,796063,Sammartano; Tonnie,20,0,30,10
1731508407462,TDMV 3,A00,760805,Mack; Kara Shanai',34,0,40,6
1731508408491,TDMV 11,A00,760807,Staff,28,0,30,2
1731508409525,TDMV 20,A00,760808,Alvarez; Ana Maria,0,0,0,0
1731508409525,TDMV 20,B00,760810,Smith; Alison D,30,0,30,0
1731508410553,TDMV 110,A00,760851,Weinberg; Sadie,30,0,30,0
1731508411578,TDMV 120,A00,760852,Yapp; Hentyle T,29,0,30,1
1731508411578,TDMV 120,B00,760853,Brown; Bernard Joseph,0,0,0,0
1731508412609,TDMV 123,A00,760855,Duran; Marcos Antonio,28,0,30,2
1731508413635,TDMV 130,A00,760856,Mack; Kara Shanai',40,0,40,0
1731508414662,TDMV 138,A00,795397,Corrales; Joseph Bernales,34,0,40,6
1731508415689,TDMV 140,A00,760857,Staff,37,0,40,3
1731508415689,TDMV 140,B00,760859,Corrales; Joseph Bernales,37,0,40,3
1731508415689,TDMV 140,C00,760860,Caligagan; Tony,37,0,40,3
1731508416715,TDMV 142,A00,760861,Blanco; Juan Carlos,28,0,30,2
1731508417743,TDMV 143,A00,760862,Fyall; Daunte Edward,30,0,30,0
1731508418769,TDMV 144,A00,760864,Staff,29,0,30,1
1731508419794,TDMV 146,A00,760866,Caligagan; Tony,28,0,30,2
1731508420819,TDMV 148,A00,760867,Jun; Grace Shin Hae,38,0,40,2
1731508421846,TDPF 161,A00,760869,Brown; Bernard Joseph,40,0,40,0
1731508422871,TDPF 163,A00,760870,Fyall; Daunte Edward,30,0,30,0
1731508422871,TDPF 163,B00,760871,Johnston; Holly,30,0,30,0
1731508422871,TDPF 163,C00,760872,Blanco; Juan Carlos,30,0,30,0
1731508423897,TDPR 6,A01,760812,Guirguis; Mark C,50,0,50,0
1731508423897,TDPR 6,A02,760814,Guirguis; Mark C,50,0,50,0
1731508424924,TDPR 102,A00,760873,Guirguis; Mark C,20,0,20,0
1731508425954,TDPR 104,A00,760874,Powell; Lora,15,0,15,0
1731508426981,TDPW 101,A00,760875,Stein; Deborah Isobel,20,0,20,0
1731508426981,TDPW 101,B00,760876,Stein; Deborah Isobel,19,0,20,1
1731508426981,TDPW 101,C00,760877,Stein; Deborah Isobel,20,0,20,0
1731508426981,TDPW 101,D00,760878,Stein; Deborah Isobel,18,0,20,2
1731508426981,TDPW 101,E00,760879,Stein; Deborah Isobel,20,0,20,0
1731508428008,TDPW 104,A00,760880,Staff,20,0,20,0
1731508429033,TDTR 10,A00,760815,Yapp; Hentyle T,30,0,30,0
1731508430061,TDTR 15,A00,760816,Smith; Alison D,29,0,30,1
1731508431086,TDTR 104,A00,795400,Smith; Alison D,30,0,30,0
1731508432117,TMC 15,A00,799598,Staff,25,0,25,0
1731508433145,TMC 20,A00,795572,Carver; Leslie J.,25,0,25,0
1731508434173,UROL 296,001,793638,Staff,10,0,10,0
1731508434173,UROL 296,002,793644,Staff,10,0,10,0
1731508435206,USP 2,A01,762958,Pezzoli; Keith,33,0,35,2
1731508435206,USP 2,A02,762960,Pezzoli; Keith,31,0,35,4
1731508436237,USP 3,A01,762962,Wickland; Teo Akande,34,0,35,1
1731508436237,USP 3,A02,762963,Wickland; Teo Akande,31,0,35,4
1731508437262,USP 4,A00,762964,Staff,27,0,30,3
1731508438290,USP 5,A01,762967,Sun; Feiyang,31,0,35,4
1731508438290,USP 5,A02,762968,Sun; Feiyang,33,0,35,2
1731508439316,USP 6,A01,762970,Shvartzberg Carrio; Manuel,35,0,35,0
1731508439316,USP 6,A02,762971,Shvartzberg Carrio; Manuel,34,0,35,1
1731508440344,USP 15,A01,762973,Anderson; William Raymond,32,0,35,3
1731508440344,USP 15,A02,762974,Anderson; William Raymond,34,0,35,1
1731508441370,USP 25,A00,762975,Shenkman; Michael Thomas,69,0,70,1
1731508442397,USP 100,A00,762976,Arroyo; John Christopher,66,0,70,4
1731508443429,USP 101,A00,762977,Staff,65,0,65,0
1731508444484,USP 108,A00,762978,Pezzoli; Keith,29,0,30,1
1731508445511,USP 124,A00,762979,Fulton; William,64,0,70,6
1731508446539,USP 128A,A01,762982,Lewis; Leslie R,13,0,13,0
1731508447570,USP 138,A00,762984,Anderson; William Raymond,25,0,25,0
1731508448596,USP 141A,A00,762985,Lewis; Leslie R,25,0,25,0
1731508449624,USP 143,A00,762986,Hinds; Juli Beth,198,0,225,27
1731508450657,USP 150,A00,762987,Osias; David,55,0,60,5
1731508451684,USP 151,A00,763006,Boomhower; Matthew Charles,68,0,70,2
1731508452714,USP 152A,A01,763042,Moeder; Nathan L,27,0,30,3
1731508452714,USP 152A,A02,763060,Moeder; Nathan L,30,0,30,0
1731508453740,USP 153,A00,763071,Shenkman; Michael Thomas,64,0,70,6
1731508454775,USP 158A,A00,798344,Bajaj; Ravi Siddharth,35,0,35,0
1731508455801,USP 159A,A00,763078,Gherini; Paul Pier-Carlo,8,0,8,0
1731508456828,USP 165A,A00,763079,Collins; Caroline Imani,23,0,25,2
1731508457856,USP 165B,A00,763083,Shilon; Mor,13,0,15,2
1731508458881,USP 170,A00,763084,Entezam; Maryam,48,0,50,2
1731508459917,USP 171,A00,763147,Lerner; Amy M,43,0,55,12
1731508460948,USP 173,A00,763151,Shvartzberg Carrio; Manuel,44,0,50,6
1731508461974,USP 175,A00,763152,Peerson; Susan,23,0,25,2
1731508463002,USP 177A,A00,763156,Velasco; Diego,24,0,25,1
1731508463002,USP 177A,B00,763158,Garcia; Kathleen,24,0,25,1
1731508464026,USP 179,A00,763161,Peerson; Susan,23,0,25,2
1731508465053,USP 180,A00,763164,Frank; Lawrence Douglas,28,0,30,2
1731508466079,USP 183,A00,763165,Sutton; April Marie,25,0,25,0
1731508467105,USP 185B,A01,763169,Boomhower; Matthew Charles,0,0,0,4
1731508467105,USP 185B,B01,763180,Sun; Feiyang,0,0,0,0
1731508468132,USP 187,A01,763190,Martin; Isaac,23,0,30,7
1731508468132,USP 187,A02,763196,Martin; Isaac,30,0,30,0
1731508469162,USP 188,A01,763235,Andrews; Abigail Leslie,28,0,30,2
1731508470195,USP 189,A00,763237,Arroyo; John Christopher,25,0,25,0
1731508470195,USP 189,B00,763240,Osias; David,23,0,25,2
1731508471222,USP 191A,A00,763243,Staff,15,0,20,5
1731508472251,USP 193,A00,795586,Devereux; Christina Schopp,22,0,25,3
1731508473279,USP 194,A00,770726,Hill; Seth J,9999,0,9999,0
1731508474309,USP 271,A00,763245,Lerner; Amy M,0,0,5,5
1731508475352,VIS 2,A01,769502,Segade; Alexandro Abraham,25,0,25,0
1731508475352,VIS 2,A02,769503,Segade; Alexandro Abraham,24,0,25,1
1731508475352,VIS 2,A03,769504,Segade; Alexandro Abraham,25,0,25,0
1731508475352,VIS 2,A04,769505,Segade; Alexandro Abraham,24,0,25,1
1731508475352,VIS 2,A05,769506,Segade; Alexandro Abraham,25,0,25,0
1731508475352,VIS 2,A06,769507,Segade; Alexandro Abraham,25,0,25,0
1731508475352,VIS 2,A07,769508,Segade; Alexandro Abraham,0,0,0,0
1731508475352,VIS 2,A08,769509,Segade; Alexandro Abraham,0,0,0,0
1731508476381,VIS 6,A00,769510,Staff,141,0,146,5
1731508477412,VIS 11,A01,769513,Cartwright; Lisa,33,0,34,1
1731508477412,VIS 11,A02,769514,Cartwright; Lisa,33,0,34,1
1731508477412,VIS 11,A03,769515,Cartwright; Lisa,34,0,34,0
1731508477412,VIS 11,A04,769516,Cartwright; Lisa,34,0,34,0
1731508477412,VIS 11,A05,769517,Cartwright; Lisa,34,0,34,0
1731508477412,VIS 11,A06,769519,Cartwright; Lisa,33,0,34,1
1731508477412,VIS 11,A07,769521,Cartwright; Lisa,31,0,34,3
1731508477412,VIS 11,A08,769522,Cartwright; Lisa,34,0,34,0
1731508477412,VIS 11,A09,769523,Cartwright; Lisa,33,0,34,1
1731508477412,VIS 11,A10,769524,Cartwright; Lisa,33,0,34,1
1731508477412,VIS 11,A11,769554,Cartwright; Lisa,34,0,34,0
1731508477412,VIS 11,A12,769557,Cartwright; Lisa,34,0,34,0
1731508478445,VIS 21B,A01,769570,Shen; Kuiyi,31,0,32,1
1731508478445,VIS 21B,A02,769571,Shen; Kuiyi,31,0,32,1
1731508478445,VIS 21B,A03,769587,Shen; Kuiyi,31,0,32,1
1731508478445,VIS 21B,A04,769600,Shen; Kuiyi,32,0,32,0
1731508478445,VIS 21B,A05,769639,Shen; Kuiyi,32,0,32,0
1731508478445,VIS 21B,A06,769693,Shen; Kuiyi,32,0,32,0
1731508478445,VIS 21B,A07,769710,Shen; Kuiyi,31,0,32,1
1731508478445,VIS 21B,A08,769755,Shen; Kuiyi,32,0,32,0
1731508479477,VIS 22,A01,769936,Rose; Jordan M,32,0,32,0
1731508479477,VIS 22,A02,769969,Rose; Jordan M,32,0,32,0
1731508479477,VIS 22,A03,769978,Rose; Jordan M,31,0,32,1
1731508479477,VIS 22,A04,770005,Rose; Jordan M,32,0,32,0
1731508479477,VIS 22,A05,770007,Rose; Jordan M,32,0,32,0
1731508479477,VIS 22,A06,770009,Rose; Jordan M,31,0,32,1
1731508479477,VIS 22,A07,770047,Rose; Jordan M,28,0,32,4
1731508479477,VIS 22,A08,770048,Rose; Jordan M,31,0,32,1
1731508479477,VIS 22,A09,770050,Rose; Jordan M,32,0,32,0
1731508479477,VIS 22,A10,770055,Rose; Jordan M,32,0,32,0
1731508479477,VIS 22,A11,770057,Rose; Jordan M,32,0,32,0
1731508479477,VIS 22,A12,770063,Rose; Jordan M,32,0,32,0
1731508480504,VIS 41,A01,770086,D'Elena-Tweed; Jessica Erin,24,0,25,1
1731508480504,VIS 41,A02,770194,D'Elena-Tweed; Jessica Erin,23,0,25,2
1731508480504,VIS 41,A03,770195,D'Elena-Tweed; Jessica Erin,23,0,25,2
1731508480504,VIS 41,A04,770196,D'Elena-Tweed; Jessica Erin,23,0,25,2
1731508480504,VIS 41,A05,770197,D'Elena-Tweed; Jessica Erin,24,0,25,1
1731508480504,VIS 41,A06,770198,D'Elena-Tweed; Jessica Erin,25,0,25,0
1731508480504,VIS 41,A07,770199,D'Elena-Tweed; Jessica Erin,25,0,25,0
1731508480504,VIS 41,A08,770200,D'Elena-Tweed; Jessica Erin,24,0,25,1
1731508481532,VIS 60,A01,770202,Mostajo; Lorena,25,0,25,0
1731508481532,VIS 60,A02,770203,Mostajo; Lorena,25,0,25,0
1731508481532,VIS 60,A03,770204,Mostajo; Lorena,25,0,25,0
1731508481532,VIS 60,A04,770205,Mostajo; Lorena,25,0,25,0
1731508481532,VIS 60,A05,770206,Mostajo; Lorena,25,0,25,0
1731508481532,VIS 60,A06,770207,Mostajo; Lorena,25,0,25,0
1731508482564,VIS 83,A00,770208,Kester; Grant,195,0,200,5
1731508483596,VIS 100,A00,770210,Cruz; Edwin Teddy,140,0,146,6
1731508484628,VIS 101A,A00,770215,Park; Kyong Dong,10,0,15,5
1731508484628,VIS 101A,B00,770229,Riley; Joe,13,0,15,2
1731508485656,VIS 103,A00,770230,Cruz; Edwin Teddy,145,0,146,1
1731508486682,VIS 103B,A00,770234,Park; Kyong Dong,74,0,75,1
1731508487710,VIS 105A,A00,770237,Tonies; Joshua Vanjaymes,24,0,30,6
1731508488738,VIS 105B,A00,770239,Tonies; Joshua Vanjaymes,27,0,30,3
1731508489765,VIS 105C,A00,770240,Adler; Amy,13,0,15,2
1731508490794,VIS 106A,A00,770241,Tobe; Geoffroy,25,0,25,0
1731508490794,VIS 106A,B00,770243,De Luca; Mara Julia,22,0,25,3
1731508491826,VIS 106B,A00,770244,De Luca; Mara Julia,22,0,25,3
1731508492914,VIS 107A,A00,770248,Iglesias; Janelle Ann,21,0,25,4
1731508493943,VIS 107C,A00,770249,Staff,15,0,15,0
1731508494971,VIS 108,A00,770250,Moss; Ceci,15,0,15,0
1731508494971,VIS 108,B00,770251,Adler; Amy,11,0,15,4
1731508495998,VIS 110D,A00,770253,Dean; Danielle Adobi,11,0,15,4
1731508497023,VIS 110F,A00,770254,Iglesias; Janelle Ann,14,0,15,1
1731508498054,VIS 110M,A00,770256,Dean; Danielle Adobi,15,0,15,0
1731508499080,VIS 112,A00,770257,Welchman; John C.,12,0,15,3
1731508500108,VIS 114B,A00,770260,Tronzo; William,12,0,15,3
1731508501135,VIS 124G,A00,770261,Rose; Jordan M,72,0,75,3
1731508502163,VIS 125G,A00,770262,Kester; Grant,75,0,75,0
1731508503195,VIS 126HN,A00,770264,Newsome; Elizabeth Ann,74,0,75,1
1731508504225,VIS 128C,A00,770265,Gaines; Malik Julian,75,0,75,0
1731508505252,VIS 128D,A00,770267,Asplund; Ingrid Marie,73,0,75,2
1731508506279,VIS 129E,A00,770268,Shen; Kuiyi,15,0,15,0
1731508507310,VIS 131,A00,770269,Erdmann; Dean,15,0,15,0
1731508508339,VIS 133,A01,770274,Staff,34,0,34,0
1731508508339,VIS 133,A02,770275,Staff,33,0,34,1
1731508509366,VIS 133A,A00,770276,Staff,13,0,15,2
1731508510392,VIS 135,A01,770280,Staff,21,0,22,1
1731508510392,VIS 135,A02,770281,Staff,16,0,22,6
1731508511424,VIS 141A,A01,770284,Stalbaum; Brett,23,0,25,2
1731508511424,VIS 141A,A02,770285,Stalbaum; Brett,21,0,25,4
1731508512449,VIS 142,A01,770287,Stalbaum; Brett,25,0,25,0
1731508512449,VIS 142,A02,770288,Stalbaum; Brett,25,0,25,0
1731508512449,VIS 142,A03,770290,Stalbaum; Brett,25,0,25,0
1731508512449,VIS 142,A04,770291,Stalbaum; Brett,25,0,25,0
1731508512449,VIS 142,A05,770292,Stalbaum; Brett,24,0,25,1
1731508512449,VIS 142,A06,770293,Stalbaum; Brett,25,0,25,0
1731508513485,VIS 145A,A01,770301,Stone; Patricia,20,0,22,2
1731508513485,VIS 145A,A02,770302,Stone; Patricia,22,0,22,0
1731508513485,VIS 145A,A03,770303,Stone; Patricia,22,0,22,0
1731508513485,VIS 145A,A04,770304,Stone; Patricia,20,0,22,2
1731508513485,VIS 145A,A05,770306,Stone; Patricia,21,0,22,1
1731508513485,VIS 145A,A06,770307,Stone; Patricia,21,0,22,1
1731508514517,VIS 146B,A00,794512,Twomey; Robert Daniel,15,0,15,0
1731508515543,VIS 147A,A01,770309,Staff,22,0,22,0
1731508515543,VIS 147A,A02,770311,Staff,20,0,22,2
1731508515543,VIS 147A,A03,770312,Staff,22,0,22,0
1731508515543,VIS 147A,A04,770313,Staff,22,0,22,0
1731508516569,VIS 147B,A00,770316,Akten; Mehmet,11,0,15,4
1731508517600,VIS 149,A00,770318,Alexander; Amy J,14,0,15,1
1731508517600,VIS 149,B00,795449,Crandall; Jordan,13,0,15,2
1731508518626,VIS 150,A00,770319,Wardwell; Mariana Razo,70,0,75,5
1731508519654,VIS 157D,A01,770329,Williams; Alena J,33,0,34,1
1731508519654,VIS 157D,A02,770334,Williams; Alena J,33,0,34,1
1731508520680,VIS 160A,A00,770375,Akten; Mehmet,9,0,15,6
1731508520680,VIS 160A,B00,770380,Alexander; Amy J,14,0,15,1
1731508520680,VIS 160A,C00,770391,Twomey; Robert Daniel,11,0,15,4
1731508521709,VIS 161,A00,770470,D'Elena-Tweed; Jessica Erin,14,0,15,1
1731508522736,VIS 164,A00,770484,Cross; Brian R,19,0,22,3
1731508522736,VIS 164,B00,770535,Erdmann; Dean,22,0,22,0
1731508523762,VIS 165B,A00,770548,Sprague; Sean Jeffrey,20,0,22,2
1731508524794,VIS 169A,A00,770551,Mostajo; Lorena,20,0,22,2
1731508525820,VIS 171,A00,770552,Dinco; Dino,22,0,22,0
1731508526852,VIS 174,A00,770599,Cross; Brian R,20,0,22,2
1731508526852,VIS 174,B00,770666,Dinco; Dino,21,0,22,1
1731508526852,VIS 174,C00,770705,Dinco; Dino,22,0,22,0
1731508527884,VIS 179,A00,770708,Zurita; Dmitri,22,0,22,0
1731508528913,VIS 180A,A00,770709,Erdmann; Dean,22,0,22,0
1731508529944,VIS 180B,A00,770710,Stone; Patricia,21,0,22,1
1731508530972,VIS 182A,A00,770711,Sprague; Sean Jeffrey,21,0,22,1
1731508531999,VIS 185,A00,770712,Trigilio; Michael,17,0,22,5
1731508533030,VIS 200,A00,770713,Wardwell; Mariana Razo,12,0,15,3
1731508534057,VIS 201,A00,770714,Bratton; Benjamin H.,10,0,15,5
1731508535084,VIS 202,A00,770715,Mangolte; Babette,2,0,15,13
1731508536112,VIS 203,A00,770716,Segade; Alexandro Abraham,0,0,15,15
1731508537140,VIS 242,A00,770718,Cartwright; Lisa,8,0,15,7
1731508538165,VIS 255,A00,770719,Welchman; John C.,8,0,15,7
1731508539196,VIS 260,A00,770720,Newsome; Elizabeth Ann,9,0,15,6
1731508540230,WCWP 10A,001,765834,Staff,0,0,0,0
1731508540230,WCWP 10A,002,765835,Windham; Emily,13,0,20,7
1731508540230,WCWP 10A,003,765836,Windham; Emily,17,0,20,3
1731508540230,WCWP 10A,004,765837,Escobar; Jordan Christophe,17,0,20,3
1731508540230,WCWP 10A,005,765838,Windham; Emily,16,0,20,4
1731508540230,WCWP 10A,006,765839,Escobar; Jordan Christophe,18,0,20,2
1731508540230,WCWP 10A,007,765840,Escobar; Jordan Christophe,19,0,20,1
1731508540230,WCWP 10A,008,765841,Staff,0,0,0,0
1731508540230,WCWP 10A,009,765842,Merryman; Walter,19,0,20,1
1731508540230,WCWP 10A,010,765843,Merryman; Walter,18,0,20,2
1731508540230,WCWP 10A,011,765844,Staff,0,0,0,0
1731508540230,WCWP 10A,012,765855,Staff,0,0,0,0
1731508540230,WCWP 10A,013,766004,Staff,0,0,0,0
1731508540230,WCWP 10A,014,766006,Susi; Natalie,15,0,20,5
1731508540230,WCWP 10A,015,766008,Welji; Haleema Nazir,18,0,20,2
1731508540230,WCWP 10A,016,766010,Martiniuk; Jill,19,0,20,1
1731508540230,WCWP 10A,017,766012,Martiniuk; Jill,16,0,20,4
1731508540230,WCWP 10A,018,766050,Staff,0,0,0,0
1731508540230,WCWP 10A,019,766051,Martiniuk; Jill,14,0,20,6
1731508540230,WCWP 10A,020,766052,Staff,0,0,0,0
1731508540230,WCWP 10A,021,766053,Holloway Ii; Mathew,19,0,20,1
1731508540230,WCWP 10A,022,766054,Holloway Ii; Mathew,20,0,20,0
1731508540230,WCWP 10A,023,766055,Holloway Ii; Mathew,20,0,20,0
1731508541263,WCWP 10B,001,766056,Staff,0,0,0,0
1731508541263,WCWP 10B,002,766057,Ornelas; Tricia,19,0,20,1
1731508541263,WCWP 10B,003,766058,Ornelas; Tricia,19,0,20,1
1731508541263,WCWP 10B,004,766119,Gagnon; Jeffrey C,0,0,0,0
1731508541263,WCWP 10B,005,766120,Ornelas; Tricia,15,0,20,5
1731508541263,WCWP 10B,006,766127,Staff,0,0,0,0
1731508541263,WCWP 10B,007,766162,Staff,0,0,0,0
1731508541263,WCWP 10B,008,766181,Dhir; Simrita,20,0,20,0
1731508541263,WCWP 10B,009,766182,Dhir; Simrita,17,0,20,3
1731508541263,WCWP 10B,010,766186,Uriarte; Emma,11,0,20,9
1731508541263,WCWP 10B,011,766187,Dhir; Simrita,18,0,20,2
1731508541263,WCWP 10B,012,766188,Uriarte; Emma,12,0,20,8
1731508541263,WCWP 10B,013,766189,Staff,0,0,0,0
1731508541263,WCWP 10B,014,766190,Staff,0,0,0,0
1731508541263,WCWP 10B,015,766191,Staff,0,0,0,0
1731508541263,WCWP 10B,016,766193,Staff,0,0,0,0
1731508541263,WCWP 10B,017,766194,Staff,0,0,0,0
1731508541263,WCWP 10B,018,766195,Staff,0,0,0,0
1731508541263,WCWP 10B,019,766196,Staff,0,0,0,0
1731508541263,WCWP 10B,020,766198,Staff,0,0,0,0
1731508541263,WCWP 10B,021,766201,Staff,0,0,0,0
1731508541263,WCWP 10B,022,766203,Staff,0,0,0,0
1731508541263,WCWP 10B,023,766204,Staff,0,0,0,0
1731508541263,WCWP 10B,024,766205,Staff,0,0,0,0
1731508541263,WCWP 10B,025,766207,Staff,0,0,0,0
1731508541263,WCWP 10B,026,766208,Staff,0,0,0,0
1731508541263,WCWP 10B,027,766209,Staff,0,0,0,0
1731508541263,WCWP 10B,028,766210,Staff,0,0,0,0
1731508542291,WCWP 100,A00,766213,McCleary; Keith Long,17,0,20,3
1731508542291,WCWP 100,B00,766215,McCleary; Keith Long,20,0,20,0
1731508542291,WCWP 100,C00,766217,McCleary; Keith Long,20,0,20,0
1731508542291,WCWP 100,D00,766220,Twohig; Niall Ivan,17,0,20,3
1731508542291,WCWP 100,E00,766221,Twohig; Niall Ivan,14,0,20,6
1731508542291,WCWP 100,F00,766222,Young; Mark T,19,0,20,1
1731508542291,WCWP 100,G00,766223,Young; Mark T,18,0,20,2
1731508542291,WCWP 100,H00,766224,Twohig; Niall Ivan,20,0,20,0
1731508542291,WCWP 100,I00,766228,Young; Mark T,19,0,20,1
1731508543317,WES 237A,A00,763250,Weibel; Nadir,15,0,15,0
1731508544352,WES 268B,A01,763253,Ling; Patrick L,15,0,15,0
1731508545380,WES 269,A00,763255,Pannuto; Patrick William,15,0,15,0
1731508547725,AAPI 198,A00,795102,Solomon; Amanda Lee Albaniel,9999,0,9999,0
1731508548758,AAS 10,A01,734476,Butler; Elizabeth Annette,32,0,34,2
1731508548758,AAS 10,A02,734477,Butler; Elizabeth Annette,33,0,34,1
1731508549791,AAS 11,A01,734479,Butler; Elizabeth Annette,33,0,34,1
1731508549791,AAS 11,A02,734480,Butler; Elizabeth Annette,33,0,34,1
1731508550822,AESE 241,A00,733587,Erat; Sanjiv & Wade; Jon P,35,0,35,0
1731508551854,AESE 278B,A00,733588,Gessner; Richard K.,35,0,35,0
1731508552880,AESE 278C,A00,733589,Wade; Jon P,35,0,35,0
1731508553907,AESE 279A,A00,733591,Zak; Alexander & Wade; Jon P,35,0,35,0
1731508554941,ANAR 121,A01,733532,Staff,39,0,40,1
1731508555968,ANAR 143,A00,799583,Dunseth; Zachary Clark,29,0,30,1
1731508556995,ANAR 158,A00,733535,Goldstein; Paul S,36,0,40,4
1731508558020,ANAR 164,A00,733536,Staff,44,0,45,1
1731508559046,ANAR 165,A00,799586,Staff,30,0,30,0
1731508560078,ANBI 100,A00,733537,Fox; Patrick Keolu Ozer,39,0,40,1
1731508561106,ANBI 130,A00,733538,Non; Amy L,55,0,70,15
1731508562135,ANBI 134,A00,733552,Simonson; Tatum Sasha Summ,28,0,30,2
1731508563162,ANBI 140,A00,733553,Staff,34,0,40,6
1731508564193,ANBI 143,A00,733554,Wilder; Linnea Lorene,36,0,40,4
1731508565220,ANBI 173,A00,733555,Wilder; Linnea Lorene,69,0,70,1
1731508566246,ANES 296,001,791559,Staff,10,0,10,0
1731508566246,ANES 296,002,791560,Staff,10,0,10,0
1731508566246,ANES 296,003,791561,Staff,10,0,10,0
1731508567279,ANSC 101A,A00,733558,Kang; Byung Chu,148,0,150,2
1731508568310,ANSC 109,A00,733559,Pedersen; David,40,0,40,0
1731508569337,ANSC 125,A00,733560,Brenner; Suzanne A,65,0,70,5
1731508570368,ANSC 135,A00,733561,Stone; Annika Britt,38,0,40,2
1731508571397,ANSC 139,A00,733562,Csordas; Thomas J.,20,0,20,0
1731508572422,ANSC 146,A00,733563,Kang; Byung Chu,69,0,70,1
1731508573448,ANSC 148,A00,733564,Schonberg; Jeffrey,46,0,46,0
1731508574478,ANSC 150,A00,733565,Sloane; Julia Kathryn,35,0,35,0
1731508575504,ANSC 154,A00,733566,Brenner; Suzanne A,10,0,12,2
1731508576534,ANSC 164,A00,733567,Stewart; Alexander B,37,0,40,3
1731508577561,ANSC 184,A00,733568,Fortier; Jana,40,0,40,0
1731508578588,ANSC 190,A00,733569,Jassal; Aftab,39,0,40,1
1731508579615,ANTH 5,A00,733397,Semendeferi; Ekaterini,20,0,20,0
1731508580643,ANTH 10,A00,733400,Staff,247,0,250,3
1731508581674,ANTH 21,A01,733407,Stone; Annika Britt,30,0,30,0
1731508581674,ANTH 21,A02,733409,Stone; Annika Britt,29,0,30,1
1731508581674,ANTH 21,A03,733411,Stone; Annika Britt,27,0,30,3
1731508581674,ANTH 21,A04,733414,Stone; Annika Britt,24,0,30,6
1731508581674,ANTH 21,A05,733416,Stone; Annika Britt,27,0,30,3
1731508582704,ANTH 23,A01,733472,Stewart; Alexander B,35,0,35,0
1731508582704,ANTH 23,A02,733501,Stewart; Alexander B,34,0,35,1
1731508582704,ANTH 23,A03,733502,Stewart; Alexander B,34,0,35,1
1731508582704,ANTH 23,A04,733507,Stewart; Alexander B,35,0,35,0
1731508582704,ANTH 23,A05,733525,Stewart; Alexander B,35,0,35,0
1731508582704,ANTH 23,A06,733528,Stewart; Alexander B,35,0,35,0
1731508583734,ANTH 45,A00,733530,Jassal; Aftab,30,0,30,0
1731508584761,ANTH 87,A00,795649,Pedersen; David,20,0,20,0
1731508585787,ANTH 102,A00,733570,Fox; Patrick Keolu Ozer,144,0,150,6
1731508586812,ANTH 106,A00,733571,Sloane; Julia Kathryn,30,0,30,0
1731508587842,ANTH 107,A00,733572,Shtienberg; Gilad,28,0,30,2
1731508588868,ANTH 111,A00,733573,Bialecki; Jon Anthony,39,0,40,1
1731508589898,ANTH 128A,A01,733576,Lewis; Leslie R,12,0,12,0
1731508590927,ANTH 196B,A00,733577,Varma; Saiba,15,0,15,0
1731508591954,ANTH 200,A00,733578,Fox; Patrick Keolu Ozer,15,0,15,0
1731508592981,ANTH 203,A00,733579,Gagneux; Pascal,9,0,15,6
1731508594008,ANTH 212,A00,733582,Marchetto; Maria Carolina,14,0,15,1
1731508595035,ANTH 230,001,799994,Gagneux; Pascal,19,0,20,1
1731508596064,ANTH 231,A00,799587,Staff,13,0,15,2
1731508597160,ANTH 236,A00,733583,Csordas; Thomas J.,9,0,12,3
1731508598189,ANTH 269,A00,733584,Lampland; Martha,5,0,5,0
1731508599215,ANTH 273,A00,733585,McKenzie; Kerry V.,5,0,5,0
1731508600245,ANTH 280F,A00,733586,Yeh; Rihan Wen Xin,13,0,15,2
1731508601284,ANTH 295,001,799995,Algaze; Guillermo,3,0,3,0
1731508601284,ANTH 295,002,799996,Brenner; Suzanne A,3,0,3,0
1731508601284,ANTH 295,003,799997,Csordas; Thomas J.,3,0,3,0
1731508601284,ANTH 295,004,799998,Fox; Patrick Keolu Ozer,3,0,3,0
1731508601284,ANTH 295,005,799999,Gagneux; Pascal,3,0,3,0
1731508601284,ANTH 295,006,800000,Goldstein; Paul S,3,0,3,0
1731508601284,ANTH 295,007,800001,Hankins; Joseph D.,3,0,3,0
1731508601284,ANTH 295,008,800002,Jassal; Aftab,3,0,3,0
1731508601284,ANTH 295,009,800035,Jenkins; Janis A.,3,0,3,0
1731508601284,ANTH 295,010,800036,Kaiser; Bronwyn Nicole,3,0,3,0
1731508601284,ANTH 295,011,800037,Kang; Byung Chu,3,0,3,0
1731508601284,ANTH 295,012,800038,Marchetto; Maria Carolina,3,0,3,0
1731508601284,ANTH 295,013,800039,Non; Amy L,3,0,3,0
1731508601284,ANTH 295,014,800040,Pedersen; David,3,0,3,0
1731508601284,ANTH 295,015,800041,Rivera-Collazo; Isabel C,3,0,3,0
1731508601284,ANTH 295,016,800042,Varma; Saiba,3,0,3,0
1731508601284,ANTH 295,017,800043,Yeh; Rihan Wen Xin,3,0,3,0
1731508602320,ANTH 296,001,800044,Braswell; Geoffrey E.,3,0,3,0
1731508602320,ANTH 296,002,800045,Marchetto; Maria Carolina,3,0,3,0
1731508602320,ANTH 296,003,800107,Rivera-Collazo; Isabel C,3,0,3,0
1731508602320,ANTH 296,004,800108,Varma; Saiba,2,0,3,1
1731508602320,ANTH 296,005,800109,Algaze; Guillermo,3,0,3,0
1731508602320,ANTH 296,006,800110,Brenner; Suzanne A,3,0,3,0
1731508602320,ANTH 296,007,800111,Csordas; Thomas J.,3,0,3,0
1731508602320,ANTH 296,008,800112,Fox; Patrick Keolu Ozer,3,0,3,0
1731508602320,ANTH 296,009,800113,Gagneux; Pascal,3,0,3,0
1731508602320,ANTH 296,010,800114,Goldstein; Paul S,2,0,3,1
1731508602320,ANTH 296,011,800116,Hankins; Joseph D.,3,0,3,0
1731508602320,ANTH 296,012,800117,Jassal; Aftab,3,0,3,0
1731508602320,ANTH 296,013,800118,Jenkins; Janis A.,3,0,3,0
1731508602320,ANTH 296,014,800119,Kaiser; Bronwyn Nicole,2,0,3,1
1731508602320,ANTH 296,015,800120,Kang; Byung Chu,3,0,3,0
1731508602320,ANTH 296,016,800121,Levy; Thomas E,3,0,3,0
1731508602320,ANTH 296,017,800122,Non; Amy L,3,0,3,0
1731508602320,ANTH 296,018,800123,Pedersen; David,3,0,3,0
1731508602320,ANTH 296,019,800184,Postero; Nancy Grey,3,0,3,0
1731508602320,ANTH 296,020,800185,Semendeferi; Ekaterini,3,0,3,0
1731508602320,ANTH 296,021,800186,Yeh; Rihan Wen Xin,3,0,3,0
1731508603347,ASTR 3,A01,733595,Trumbo; Samantha Kathleen,294,0,300,6
1731508604380,ASTR 20B,A01,733598,Konopacky; Quinn Morgan,49,0,50,1
1731508605406,ASTR 99,001,799856,Konopacky; Quinn Morgan,9999,0,9999,0
1731508606434,ASTR 102,A01,733600,Diamond; Patrick H & Konopacky; Quinn Morgan,29,0,30,1
1731508607462,ASTR 105,A01,733607,Boggs; Steven Edward,30,0,30,0
1731508608492,ASTR 122,A01,733609,Keres; Dusan,40,0,40,0
1731508609519,ASTR 150,A01,733641,Theissen; Christopher Alexander,28,0,30,2
1731508609519,ASTR 150,A02,733642,Theissen; Christopher Alexander,28,0,30,2
1731508610548,ASTR 201,A00,790490,Burgasser; Adam Jonathan,9,0,15,6
1731508611577,ASTR 210,A00,733648,Staff,12,0,15,3
1731508612606,ASTR 220,A00,733650,Wright; Shelley Adams,12,0,15,3
1731508613632,ASTR 250,A00,733652,Theissen; Christopher Alexander & Hosseinzadeh; Griffin Alex,22,0,30,8
1731508614658,ASTR 251,A00,733653,Theissen; Christopher Alexander & Hosseinzadeh; Griffin Alex,23,0,30,7
1731508615690,AUD 236,A01,791504,Harris; Jeffrey Paul,5,0,5,0
1731508616717,AUD 263,A00,791538,Zettner; Erika,13,0,13,0
1731508617742,AUD 276,A00,791507,Zettner; Erika,13,0,13,0
1731508618769,AUD 284,A01,791509,Zettner; Erika,13,0,13,0
1731508619794,AUD 291,A00,791534,Zettner; Erika,13,0,13,0
1731508620821,AUD 296,A00,791535,Zettner; Erika,13,0,13,0
1731508621867,AWP 3,002,733077,Ajo; Frances Margaret,12,0,12,0
1731508621867,AWP 3,003,733078,Given; William Allan,12,0,12,0
1731508621867,AWP 3,004,733080,Ajo; Frances Margaret,12,0,12,0
1731508621867,AWP 3,005,733082,Westerfeld; Kevin John,12,0,12,0
1731508621867,AWP 3,007,733085,O'Neil; Courtney L,12,0,12,0
1731508621867,AWP 3,008,733087,O'Neil; Courtney L,12,0,12,0
1731508621867,AWP 3,009,733138,Zimmerman; Guy,12,0,12,0
1731508621867,AWP 3,010,733139,Zimmerman; Guy,12,0,12,0
1731508621867,AWP 3,011,733140,Westerfeld; Kevin John,12,0,12,0
1731508621867,AWP 3,012,733141,Zimmerman; Guy,11,0,12,1
1731508621867,AWP 3,013,733142,Sartor; Alexandra,12,0,12,0
1731508621867,AWP 3,014,733143,Sartor; Alexandra,12,0,12,0
1731508621867,AWP 3,015,733144,Vaughn; Kelsey Sara,12,0,12,0
1731508621867,AWP 3,016,733145,Vaughn; Kelsey Sara,12,0,12,0
1731508621867,AWP 3,019,733148,Kolodezh; Samuel,12,0,12,0
1731508621867,AWP 3,020,733149,Kolodezh; Samuel,12,0,12,0
1731508621867,AWP 3,022,733151,Kolodezh; Samuel,12,0,12,0
1731508622936,AWP 4A,001,733154,Tsurska Svetina; Olena,13,0,14,1
1731508622936,AWP 4A,002,733156,Tsurska Svetina; Olena,10,0,14,4
1731508622936,AWP 4A,003,733157,Chandler; Bailee Daniele,12,0,14,2
1731508622936,AWP 4A,004,733158,Chandler; Bailee Daniele,13,0,14,1
1731508622936,AWP 4A,005,733159,Hall; Graham T,14,0,14,0
1731508622936,AWP 4A,006,733160,Hall; Graham T,14,0,14,0
1731508622936,AWP 4A,007,733161,Falcon; Jennifer A,14,0,14,0
1731508622936,AWP 4A,008,733162,Falcon; Jennifer A,13,0,14,1
1731508622936,AWP 4A,011,733165,Tiernan; Christa Michelle,14,0,14,0
1731508622936,AWP 4A,012,733166,Tiernan; Christa Michelle,12,0,14,2
1731508622936,AWP 4A,013,733168,Gardella; Alexander Drew,14,0,14,0
1731508622936,AWP 4A,014,733169,Gardella; Alexander Drew,12,0,14,2
1731508622936,AWP 4A,016,733171,Coulter; Jane Elisabeth,14,0,14,0
1731508622936,AWP 4A,017,733172,Spicer; Jacqueline,14,0,14,0
1731508622936,AWP 4A,018,733173,Spicer; Jacqueline,14,0,14,0
1731508622936,AWP 4A,019,733174,Christie; Veronica Ann,14,0,14,0
1731508622936,AWP 4A,020,733175,Bolin; Jillian,14,0,14,0
1731508622936,AWP 4A,021,733176,Bolin; Jillian,14,0,14,0
1731508622936,AWP 4A,022,733177,Zroka; Amy Liane,14,0,14,0
1731508622936,AWP 4A,023,733178,Zroka; Amy Liane,14,0,14,0
1731508622936,AWP 4A,024,733179,Christie; Veronica Ann,13,0,14,1
1731508622936,AWP 4A,025,733181,Steinberg; Stacy A,14,0,14,0
1731508622936,AWP 4A,026,733182,Steinberg; Stacy A,12,0,14,2
1731508622936,AWP 4A,027,733184,Gilmore; Lauren Monica,14,0,14,0
1731508622936,AWP 4A,028,733185,Gilmore; Lauren Monica,14,0,14,0
1731508622936,AWP 4A,032,733195,Grant; Melinda G,14,0,14,0
1731508622936,AWP 4A,033,733198,Grant; Melinda G,14,0,14,0
1731508622936,AWP 4A,037,733286,Jones; William Jadie,13,0,14,1
1731508622936,AWP 4A,038,733310,Jones; William Jadie,14,0,14,0
1731508622936,AWP 4A,039,733318,Heiser; Jerrod A,14,0,14,0
1731508622936,AWP 4A,040,733320,Heiser; Jerrod A,13,0,14,1
1731508622936,AWP 4A,041,733321,Bourdeau; Joseph Albert,14,0,14,0
1731508622936,AWP 4A,042,733331,Bourdeau; Joseph Albert,14,0,14,0
1731508622936,AWP 4A,043,733337,Wilson; Natalie Ann,13,0,14,1
1731508622936,AWP 4A,044,733378,Wilson; Natalie Ann,12,0,14,2
1731508622936,AWP 4A,045,733379,Staff,14,0,14,0
1731508622936,AWP 4A,046,733380,Staff,14,0,14,0
1731508622936,AWP 4A,047,733385,Staff,14,0,14,0
1731508622936,AWP 4A,048,733386,Staff,14,0,14,0
1731508622936,AWP 4A,049,733388,Staff,0,0,0,0
1731508622936,AWP 4A,050,733389,Staff,0,0,0,0
1731508622936,AWP 4A,051,733390,Staff,0,0,0,0
1731508622936,AWP 4A,052,733392,Staff,0,0,0,0
1731508622936,AWP 4A,053,733394,Staff,0,0,0,0
1731508622936,AWP 4A,054,733395,Staff,0,0,0,0
1731508623963,BENG 1,A01,733659,Sah; Robert Lie-Yuan,62,0,65,3
1731508623963,BENG 1,A02,733715,Sah; Robert Lie-Yuan,60,0,65,5
1731508623963,BENG 1,A03,733716,Sah; Robert Lie-Yuan,63,0,65,2
1731508624993,BENG 112A,A01,733831,Schmid-Schoenbein; Geert W,28,0,35,7
1731508624993,BENG 112A,A02,733832,Schmid-Schoenbein; Geert W,34,0,35,1
1731508626023,BENG 119B,A00,733833,Taylor Amos; Alyssa C,22,0,30,8
1731508627050,BENG 120,A01,733837,Huang; Xiaohua,35,0,35,0
1731508627050,BENG 120,A02,733843,Huang; Xiaohua,33,0,35,2
1731508628082,BENG 123,A01,733846,Palsson; Bernhard O.,24,0,30,6
1731508628082,BENG 123,A02,733847,Palsson; Bernhard O.,24,0,30,6
1731508629109,BENG 126B,A00,733850,Taylor Amos; Alyssa C,26,0,30,4
1731508630136,BENG 127B,A00,733860,Taylor Amos; Alyssa C,30,0,30,0
1731508631162,BENG 128B,A00,733862,Taylor Amos; Alyssa C,30,0,30,0
1731508632192,BENG 129B,A00,733865,Taylor Amos; Alyssa C,30,0,30,0
1731508633223,BENG 130,A00,733907,Subramaniam; Shankar,141,0,145,4
1731508634251,BENG 139B,A00,734022,Taylor Amos; Alyssa C,30,0,30,0
1731508635279,BENG 140A,A01,734136,Silva; Gabriel,27,0,30,3
1731508635279,BENG 140A,A02,734141,Silva; Gabriel,25,0,30,5
1731508635279,BENG 140A,A03,734146,Silva; Gabriel,25,0,30,5
1731508636318,BENG 147B,A00,734149,Taylor Amos; Alyssa C,28,0,30,2
1731508637344,BENG 148B,A00,734154,Taylor Amos; Alyssa C,25,0,30,5
1731508638374,BENG 149B,A00,734172,Taylor Amos; Alyssa C,30,0,30,0
1731508639402,BENG 152,A01,734185,Taylor Amos; Alyssa C,19,0,20,1
1731508640429,BENG 161B,A00,734193,Huang; Xiaohua,55,0,70,15
1731508641460,BENG 168,A01,734228,Shi; Lingyan,22,0,40,18
1731508641460,BENG 168,A02,734229,Shi; Lingyan,39,0,40,1
1731508641460,BENG 168,A03,734231,Shi; Lingyan,37,0,40,3
1731508642487,BENG 169B,A00,734233,Taylor Amos; Alyssa C,24,0,30,6
1731508643513,BENG 179B,A00,734243,Taylor Amos; Alyssa C,28,0,30,2
1731508644545,BENG 181,A01,734246,Pevzner; Pavel Arkadjevich,37,0,40,3
1731508645575,BENG 186B,A01,734248,Cauwenberghs; Gert,69,0,70,1
1731508646606,BENG 187C,A00,734249,Taylor Amos; Alyssa C,121,0,170,49
1731508647633,BENG 189,A00,734250,Contijoch; Francisco,26,0,30,4
1731508648660,BENG 191,A00,734252,Lal; Ratnesh,15,0,20,5
1731508649688,BENG 202,A00,734255,Pevzner; Pavel Arkadjevich,25,0,25,0
1731508650717,BENG 204,A01,734257,Subramaniam; Shankar,0,0,50,50
1731508651748,BENG 207,A00,734258,Friend; James Robert,0,0,0,0
1731508652774,BENG 212,A00,734259,Palsson; Bernhard O.,0,0,20,20
1731508653804,BENG 223,A00,734260,Kravets; Vira V.,0,0,60,60
1731508654830,BENG 225,A01,734263,Bartko; Andrew Peter,0,0,0,0
1731508655857,BENG 230B,A00,734289,Engler; Adam J.,38,0,120,82
1731508656889,BENG 238,A00,734290,Chen; Ju & Sun; Wei & Shyy; Yeun-Jund & Sheikh; Farah & Ross; Robert Scott & King; Kevin R & Evans; Sylvia M & Cho; Yoshitake,0,0,40,40
1731508657916,BENG 241A,A01,734314,Cyphert; Erika Leah,0,0,50,50
1731508658946,BENG 241B,A00,734333,Khojah; Reem I,35,0,70,35
1731508659973,BENG 247B,A00,734334,Wang; Joseph,0,0,40,40
1731508661002,BENG 277,A00,734336,Khojah; Reem I,0,0,0,0
1731508662030,BENG 278,A00,734340,Contijoch; Francisco,0,0,0,0
1731508663055,BENG 280B,A00,734351,El Kaffas; Ahmed,20,0,56,36
1731508664080,BENG 281,A00,734352,Aguado; Brian Alberto,25,0,120,95
1731508665109,BENG 291,A00,734356,Lal; Ratnesh,15,0,30,15
1731508666135,BENG 292,A01,734364,Ross; Camille,20,0,20,0
1731508667165,BENG 294B,A01,734430,Schmid-Schoenbein; Geert W,12,0,20,8
1731508668190,BENG 295,A00,734431,Watson; John Thomas,9999,0,9999,0
1731508669222,BGGN 206B,A00,765115,Oegema; Karen & Desai; Arshad,28,0,60,32
1731508670252,BGGN 207,A01,765121,Ross; Camille,0,0,0,0
1731508671278,BGGN 209,A00,765126,Neal; Sonya E,0,0,30,30
1731508672303,BGGN 213,A00,765129,Grant; Barry J,24,0,30,6
1731508673330,BGGN 216,A01,765138,Mueller; Liam O'Connor,0,0,0,24
1731508674358,BGGN 225,A00,765141,Lu; Li-Fan & Zuniga; Elina I,0,0,30,30
1731508675386,BGGN 228,A00,765144,Perry; Michael William & Kiger; Amy,0,0,30,30
1731508676413,BGGN 237,A01,765148,Goren; Alon M,10,0,10,0
1731508677446,BGGN 240,A01,765160,Benna; Marcus K,4,0,5,1
1731508677446,BGGN 240,A02,765210,Benna; Marcus K,1,0,5,4
1731508677446,BGGN 240,A03,765211,Benna; Marcus K,3,0,5,2
1731508677446,BGGN 240,A04,765212,Benna; Marcus K,2,0,5,3
1731508678474,BGGN 246A,A00,765223,Sejnowski; Terrence J,18,0,30,12
1731508679502,BGGN 249B,A00,765226,Abdel-Azim; Eiman,0,0,0,0
1731508680630,BGGN 271,001,798422,Ackerman; Susan,9999,0,9999,0
1731508680630,BGGN 271,002,798586,Akbari; Omar Sultan,9997,0,9999,2
1731508680630,BGGN 271,003,798588,Allen; Nicola J,9998,0,9999,1
1731508680630,BGGN 271,004,798599,Alperin; Mariann,9998,0,9999,1
1731508680630,BGGN 271,005,798600,Antal; Corina Elena,9998,0,9999,1
1731508680630,BGGN 271,006,798612,Bouvet; Michael,9999,0,9999,0
1731508680630,BGGN 271,007,798613,Breen; Ellen C.,9999,0,9999,0
1731508680630,BGGN 271,008,798637,Bui; Jack D,9998,0,9999,1
1731508680630,BGGN 271,009,798666,Burnett; Lindsey,9998,0,9999,1
1731508680630,BGGN 271,010,798745,Caffrey; Conor,9998,0,9999,1
1731508680630,BGGN 271,011,798780,Castle; Michael James,9998,0,9999,1
1731508680630,BGGN 271,012,798781,Chang; John Tzu-yu,9999,0,9999,0
1731508680630,BGGN 271,013,798782,Chen; Xu,9998,0,9999,1
1731508680630,BGGN 271,014,798783,Cheng; Christine Shiang-Ling,9999,0,9999,0
1731508680630,BGGN 271,015,798784,Cheresh; David A.,9998,0,9999,1
1731508680630,BGGN 271,016,798803,Cherqui; Stephanie,9999,0,9999,0
1731508680630,BGGN 271,017,798804,Chu; Hiutung,9998,0,9999,1
1731508680630,BGGN 271,018,798806,Church; Kellie Breen,9999,0,9999,0
1731508680630,BGGN 271,019,798807,Cleland; Elsa Eleanor,9998,0,9999,1
1731508680630,BGGN 271,020,798808,Coufal; Nicole Gabriele,9999,0,9999,0
1731508680630,BGGN 271,021,798809,Croker; Ben Adam,9999,0,9999,0
1731508680630,BGGN 271,022,798810,Crotty Alexander; Laura E,9997,0,9999,2
1731508680630,BGGN 271,023,798811,De Silva; Shermin,9999,0,9999,0
1731508680630,BGGN 271,024,798812,Dhar; Debanjan,9998,0,9999,1
1731508680630,BGGN 271,025,798813,Doherty; Taylor Alan,9997,0,9999,2
1731508680630,BGGN 271,026,798814,Dore; Kim Bohemie,9997,0,9999,2
1731508680630,BGGN 271,027,798815,Dulawa; Stephanie Carole,9999,0,9999,0
1731508680630,BGGN 271,028,798817,Farley; Emma Kristen,9998,0,9999,1
1731508680630,BGGN 271,029,798818,Feldstein; Ariel E,9999,0,9999,0
1731508680630,BGGN 271,030,798819,Feng; Gen-Sheng,9999,0,9999,0
1731508680630,BGGN 271,031,798820,Fisch; Kathleen Marie,9995,0,9999,4
1731508680630,BGGN 271,032,798822,Friedman; Rick Adam,9999,0,9999,0
1731508680630,BGGN 271,033,798823,Furnari; Frank,9999,0,9999,0
1731508680630,BGGN 271,034,798825,George; Olivier,9998,0,9999,1
1731508680630,BGGN 271,035,798826,Ghosh; Pradipta,9998,0,9999,1
1731508680630,BGGN 271,036,798828,Glasgow; Stacey Marie,9998,0,9999,1
1731508680630,BGGN 271,037,798832,Golden; James W,9998,0,9999,1
1731508680630,BGGN 271,038,798833,Golden; Susan S.,9999,0,9999,0
1731508680630,BGGN 271,039,798834,Goren; Alon M,9998,0,9999,1
1731508680630,BGGN 271,040,798835,Guatelli; John C,9998,0,9999,1
1731508680630,BGGN 271,041,798836,Guma; Monica,9998,0,9999,1
1731508680630,BGGN 271,042,798837,Gustafsson; Asa Birgitta,9999,0,9999,0
1731508680630,BGGN 271,043,798838,Hamdoun; Amr,9999,0,9999,0
1731508680630,BGGN 271,044,798839,Hao; Nan,9999,0,9999,0
1731508680630,BGGN 271,045,798841,Hasty; Jeff M,9999,0,9999,0
1731508680630,BGGN 271,046,798842,Ideker; Trey,9999,0,9999,0
1731508680630,BGGN 271,047,798843,Jiang; Qingfei,9998,0,9999,1
1731508680630,BGGN 271,048,798845,Jin; Yishi,9997,0,9999,2
1731508680630,BGGN 271,049,798846,Joshi; Shweta,9999,0,9999,0
1731508680630,BGGN 271,050,798849,Ju; Won-Kyu,9998,0,9999,1
1731508680630,BGGN 271,051,798850,Jun; Suckjoon,9999,0,9999,0
1731508680630,BGGN 271,052,798852,Kaech; Susan Michelle,9997,0,9999,2
1731508680630,BGGN 271,053,798853,Kauffman; Alexander,9997,0,9999,2
1731508680630,BGGN 271,054,798854,Kleinfeld; David,9998,0,9999,1
1731508680630,BGGN 271,055,798855,Koloski; Miranda Jane,9998,0,9999,1
1731508680630,BGGN 271,056,798856,Komiyama; Takaki,9998,0,9999,1
1731508680630,BGGN 271,057,798858,Kronenberg; Mitchell E.,9999,0,9999,0
1731508680630,BGGN 271,058,798859,Kufareva; Irina,9999,0,9999,0
1731508680630,BGGN 271,059,798860,Lee; Yun Sok,9999,0,9999,0
1731508680630,BGGN 271,060,798861,Leutgeb; Stefan,9999,0,9999,0
1731508680630,BGGN 271,061,798862,Li; Willis Xiaowei,9998,0,9999,1
1731508680630,BGGN 271,062,798864,Lim; Byungkook,9999,0,9999,0
1731508680630,BGGN 271,063,798865,Lo; Stanley M.,9999,0,9999,0
1731508680630,BGGN 271,064,798867,Lopez Ramirez; Miguel Alej,9998,0,9999,1
1731508680630,BGGN 271,065,798868,Lu; Pengzhe,9998,0,9999,1
1731508680630,BGGN 271,066,798869,Lyons; Deirdre Colleen,9998,0,9999,1
1731508680630,BGGN 271,067,798870,Lyumkis; Dmitry Evgenievich,9999,0,9999,0
1731508680630,BGGN 271,068,798871,McConville; Patrick James,9998,0,9999,1
1731508680630,BGGN 271,069,798873,McDonnell; Lisa Marie,9999,0,9999,0
1731508680630,BGGN 271,070,798877,Mertens; Jerome Stefan,9999,0,9999,0
1731508680630,BGGN 271,071,798900,Morris; Gerald P,9999,0,9999,0
1731508680630,BGGN 271,072,798911,Muotri; Alysson,9999,0,9999,0
1731508680630,BGGN 271,073,798916,Muroyama; Andrew David,9998,0,9999,1
1731508680630,BGGN 271,074,798919,Murre; Cornelis,9998,0,9999,1
1731508680630,BGGN 271,075,798920,Nieh; James Charles,9997,0,9999,2
1731508680630,BGGN 271,076,798922,Niwa; Maho,9999,0,9999,0
1731508680630,BGGN 271,077,798925,Parast; Mana,9999,0,9999,0
1731508680630,BGGN 271,078,798927,Perry; Michael William,9999,0,9999,0
1731508680630,BGGN 271,079,798929,Pillus; Lorraine,9998,0,9999,1
1731508680630,BGGN 271,080,798932,Pogliano; Joseph,9999,0,9999,0
1731508680630,BGGN 271,081,798936,Pride; David Tevis,9999,0,9999,0
1731508680630,BGGN 271,082,798939,Pruneda-Paz; Jose L.,9998,0,9999,1
1731508680630,BGGN 271,083,798940,Rana; Tariq,9999,0,9999,0
1731508680630,BGGN 271,084,798945,Rao; Anjana,9999,0,9999,0
1731508680630,BGGN 271,085,798950,Raz; Eyal,9997,0,9999,2
1731508680630,BGGN 271,086,798952,Ren; Bing,9999,0,9999,0
1731508680630,BGGN 271,087,798955,Rifkin; Scott,9998,0,9999,1
1731508680630,BGGN 271,088,798956,Risbrough; Victoria Blythe,9998,0,9999,1
1731508680630,BGGN 271,089,798958,Rose; Noah Hartmann,9999,0,9999,0
1731508680630,BGGN 271,090,798962,Rosenfeld; Michael G,9999,0,9999,0
1731508680630,BGGN 271,091,798964,Saier; Milton H.,9998,0,9999,1
1731508680630,BGGN 271,092,798966,Saltiel; Alan,9997,0,9999,2
1731508680630,BGGN 271,093,798967,Sanchez-Lopez; Elsa,9998,0,9999,1
1731508680630,BGGN 271,094,798969,Schroeder; Julian I,9998,0,9999,1
1731508680630,BGGN 271,095,798970,Sebat; Lilia Mikhailovna,9997,0,9999,2
1731508680630,BGGN 271,096,798972,Sen; George L,9999,0,9999,0
1731508680630,BGGN 271,097,798974,Shaner; Nathan C.,9999,0,9999,0
1731508680630,BGGN 271,098,798976,Shurin; Jonathan,9997,0,9999,2
1731508680630,BGGN 271,099,798982,Sicklick; Jason Keith,9999,0,9999,0
1731508680630,BGGN 271,100,798985,Signer; Robert,9999,0,9999,0
1731508680630,BGGN 271,101,798986,Simonson; Tatum Sasha Summ,9998,0,9999,1
1731508680630,BGGN 271,102,798990,Steinmetz; Nicole F,9999,0,9999,0
1731508680630,BGGN 271,103,798992,Su; Chih-Ying,9999,0,9999,0
1731508680630,BGGN 271,104,798994,Suel; Gurol Mehmet,9999,0,9999,0
1731508680630,BGGN 271,105,799024,Telese; Francesca,9999,0,9999,0
1731508680630,BGGN 271,106,799032,Towers; Christina Garlingt,9997,0,9999,2
1731508680630,BGGN 271,107,799089,Valdez-Jasso; Daniela,9999,0,9999,0
1731508680630,BGGN 271,108,799108,Wahlin; Karl Jonas,9997,0,9999,2
1731508680630,BGGN 271,109,799109,Webster; Nicholas J G,9999,0,9999,0
1731508680630,BGGN 271,110,799127,Welsbie; Derek,9999,0,9999,0
1731508680630,BGGN 271,111,799128,Wildonger; Jill Cathleen,9997,0,9999,2
1731508680630,BGGN 271,112,799129,Yaksh; Tony L.,9999,0,9999,0
1731508680630,BGGN 271,113,799150,Yeo; Eugene Wei-Ming,9998,0,9999,1
1731508680630,BGGN 271,114,799151,Ying; Wei,9997,0,9999,2
1731508680630,BGGN 271,115,799152,Young; Jared W.,9999,0,9999,0
1731508680630,BGGN 271,116,799153,Zage; Peter,9999,0,9999,0
1731508680630,BGGN 271,117,799154,Zengler; Karsten B,9998,0,9999,1
1731508680630,BGGN 271,118,799155,Zhang; Jin,9999,0,9999,0
1731508680630,BGGN 271,119,799156,Zhao; Yunde,9999,0,9999,0
1731508680630,BGGN 271,120,799157,Zheng; Ye,9998,0,9999,1
1731508680630,BGGN 271,121,799158,Zhou; Huilin,9999,0,9999,0
1731508680630,BGGN 271,122,799159,Zou; Yimin,9998,0,9999,1
1731508681660,BGGN 275,A00,765242,Flagg; Matthew Paul,0,0,0,12
1731508682689,BGGN 276,A00,765243,Flagg; Matthew Paul,0,0,0,12
1731508683718,BGGN 290,A00,765245,Pasquinelli; Amy & Hampton; Randolph Y.,0,0,0,8
1731508684750,BGGN 293,A00,765250,Tour; Ella,0,0,30,30
1731508684750,BGGN 293,B00,765260,Petrie; Katherine Lynn,0,0,0,12
1731508685776,BGJC 204,A00,765301,Lu; Li-Fan & Chang; John Tzu-yu,9982,0,9999,17
1731508686924,BGRD 200,001,799275,Ackerman; Susan,9999,0,9999,0
1731508686924,BGRD 200,002,799276,Akbari; Omar Sultan,9997,0,9999,2
1731508686924,BGRD 200,003,799277,Allen; Eric,9999,0,9999,0
1731508686924,BGRD 200,004,799278,Allen; Nicola J,9998,0,9999,1
1731508686924,BGRD 200,005,799279,Alperin; Mariann,9998,0,9999,1
1731508686924,BGRD 200,006,799280,Amaro; Rommie E,9999,0,9999,0
1731508686924,BGRD 200,007,799281,Antal; Corina Elena,9998,0,9999,1
1731508686924,BGRD 200,008,799282,Asahina; Kenta,9999,0,9999,0
1731508686924,BGRD 200,009,799283,Augustine; Vineet,9999,0,9999,0
1731508686924,BGRD 200,010,799284,Ayres; Janelle Samantha,9998,0,9999,1
1731508686924,BGRD 200,011,799285,Banghart; Matthew Ryan,9999,0,9999,0
1731508686924,BGRD 200,012,799286,Barton; Andrew David,9999,0,9999,0
1731508686924,BGRD 200,013,799287,Benna; Marcus K,9999,0,9999,0
1731508686924,BGRD 200,014,799288,Bennett; Eric J,9999,0,9999,0
1731508686924,BGRD 200,015,799289,Biering; Scott B,9999,0,9999,0
1731508686924,BGRD 200,016,799290,Bloodgood; Brenda Laurie,9999,0,9999,0
1731508686924,BGRD 200,017,799291,Bouvet; Michael,9999,0,9999,0
1731508686924,BGRD 200,018,799292,Breen; Ellen C.,9999,0,9999,0
1731508686924,BGRD 200,019,799293,Briggs; Steven,9999,0,9999,0
1731508686924,BGRD 200,020,799294,Bui; Jack D,9998,0,9999,1
1731508686924,BGRD 200,021,799295,Burnett; Lindsey,9998,0,9999,1
1731508686924,BGRD 200,022,799296,Caffrey; Conor,9998,0,9999,1
1731508686924,BGRD 200,023,799297,Callaway; Edward M,9999,0,9999,0
1731508686924,BGRD 200,024,799298,Castle; Michael James,9999,0,9999,0
1731508686924,BGRD 200,025,799299,Chaim; Isaac,9999,0,9999,0
1731508686924,BGRD 200,026,799300,Chang; John Tzu-yu,9998,0,9999,1
1731508686924,BGRD 200,027,799301,Chen; Xu,9999,0,9999,0
1731508686924,BGRD 200,028,799302,Cheng; Christine Shiang-Ling,9999,0,9999,0
1731508686924,BGRD 200,029,799303,Cheresh; David A.,9998,0,9999,1
1731508686924,BGRD 200,030,799304,Cherqui; Stephanie,9999,0,9999,0
1731508686924,BGRD 200,031,799305,Chu; Hiutung,9998,0,9999,1
1731508686924,BGRD 200,032,799306,Church; Kellie Breen,9999,0,9999,0
1731508686924,BGRD 200,033,799307,Cleland; Elsa Eleanor,9997,0,9999,2
1731508686924,BGRD 200,034,799308,Cooper; Kimberly Lynn,9999,0,9999,0
1731508686924,BGRD 200,035,799309,Coufal; Nicole Gabriele,9999,0,9999,0
1731508686924,BGRD 200,036,799310,Croker; Ben Adam,9999,0,9999,0
1731508686924,BGRD 200,037,799311,Crotty Alexander; Laura E,9997,0,9999,2
1731508686924,BGRD 200,038,799313,Daugherty; Matthew Dorton,9998,0,9999,1
1731508686924,BGRD 200,039,799314,De Silva; Shermin,9999,0,9999,0
1731508686924,BGRD 200,040,799315,Desai; Arshad,9999,0,9999,0
1731508686924,BGRD 200,041,799316,Dhar; Debanjan,9998,0,9999,1
1731508686924,BGRD 200,042,799317,Dickinson; Alexandra Jazz,9999,0,9999,0
1731508686924,BGRD 200,043,799318,Dixon; Jesse,9998,0,9999,1
1731508686924,BGRD 200,044,799319,Doherty; Taylor Alan,9997,0,9999,2
1731508686924,BGRD 200,045,799320,Dore; Kim Bohemie,9997,0,9999,2
1731508686924,BGRD 200,046,799321,Dulawa; Stephanie Carole,9999,0,9999,0
1731508686924,BGRD 200,047,799323,Ecker; Joseph R,9998,0,9999,1
1731508686924,BGRD 200,048,799324,Engle; Dannielle D,9999,0,9999,0
1731508686924,BGRD 200,049,799325,Ernst; Andreas,9998,0,9999,1
1731508686924,BGRD 200,050,799326,Esko; Jeffrey D.,9999,0,9999,0
1731508686924,BGRD 200,051,799327,Farley; Emma Kristen,9998,0,9999,1
1731508686924,BGRD 200,052,799328,Feldstein; Ariel E,9999,0,9999,0
1731508686924,BGRD 200,053,799329,Feng; Gen-Sheng,9999,0,9999,0
1731508686924,BGRD 200,054,799330,Fisch; Kathleen Marie,9995,0,9999,4
1731508686924,BGRD 200,055,799331,Friedman; Rick Adam,9999,0,9999,0
1731508686924,BGRD 200,056,799332,Furnari; Frank,9999,0,9999,0
1731508686924,BGRD 200,057,799333,Gage; Fred H,9999,0,9999,0
1731508686924,BGRD 200,058,799334,George; Olivier,9998,0,9999,1
1731508686924,BGRD 200,059,799335,Ghosh; Pradipta,9998,0,9999,1
1731508686924,BGRD 200,060,799336,Glasgow; Stacey Marie,9998,0,9999,1
1731508686924,BGRD 200,061,799337,Glass; Christopher,9999,0,9999,0
1731508686924,BGRD 200,062,799338,Golden; James W,9998,0,9999,1
1731508686924,BGRD 200,063,799339,Golden; Susan S.,9999,0,9999,0
1731508686924,BGRD 200,064,799340,Goren; Alon M,9998,0,9999,1
1731508686924,BGRD 200,065,799341,Guatelli; John C,9998,0,9999,1
1731508686924,BGRD 200,066,799342,Guma; Monica,9998,0,9999,1
1731508686924,BGRD 200,067,799343,Gustafsson; Asa Birgitta,9999,0,9999,0
1731508686924,BGRD 200,068,799344,Gutkind; Jorge Silvio,9999,0,9999,0
1731508686924,BGRD 200,069,799345,Hamdoun; Amr,9999,0,9999,0
1731508686924,BGRD 200,070,799346,Hampton; Randolph Y.,9998,0,9999,1
1731508686924,BGRD 200,071,799347,Hao; Nan,9999,0,9999,0
1731508686924,BGRD 200,072,799348,Hargreaves; Diana Clare,9998,0,9999,1
1731508686924,BGRD 200,073,799349,Hasty; Jeff M,9999,0,9999,0
1731508686924,BGRD 200,074,799350,Hollern; Daniel Patrick,9998,0,9999,1
1731508686924,BGRD 200,075,799351,Holway; David A.,9999,0,9999,0
1731508686924,BGRD 200,076,799352,Huffaker; Alisa,9998,0,9999,1
1731508686924,BGRD 200,077,799353,Hui; Enfu,9999,0,9999,0
1731508686924,BGRD 200,078,799354,Hwa; Terence T.,9999,0,9999,0
1731508686924,BGRD 200,079,799355,Ideker; Trey,9999,0,9999,0
1731508686924,BGRD 200,080,799356,Jackrel; Sara,9997,0,9999,2
1731508686924,BGRD 200,081,799357,Jiang; Qingfei,9998,0,9999,1
1731508686924,BGRD 200,082,799358,Jin; Yishi,9997,0,9999,2
1731508686924,BGRD 200,083,799359,Joshi; Shweta,9999,0,9999,0
1731508686924,BGRD 200,084,799360,Ju; Won-Kyu,9998,0,9999,1
1731508686924,BGRD 200,085,799361,Jun; Suckjoon,9999,0,9999,0
1731508686924,BGRD 200,086,799362,Kadonaga; James T,9999,0,9999,0
1731508686924,BGRD 200,087,799363,Kaech; Susan Michelle,9995,0,9999,4
1731508686924,BGRD 200,088,799364,Kauffman; Alexander,9997,0,9999,2
1731508686924,BGRD 200,089,799365,Kleinfeld; David,9999,0,9999,0
1731508686924,BGRD 200,090,799366,Knight; Robin,9999,0,9999,0
1731508686924,BGRD 200,091,799367,Koloski; Miranda Jane,9998,0,9999,1
1731508686924,BGRD 200,092,799368,Komiyama; Takaki,9997,0,9999,2
1731508686924,BGRD 200,093,799369,Kosuri; Pallav,9998,0,9999,1
1731508686924,BGRD 200,094,799370,Kronenberg; Mitchell E.,9999,0,9999,0
1731508686924,BGRD 200,095,799371,Staff,9999,0,9999,0
1731508686924,BGRD 200,096,799372,Kryazhimskiy; Sergey A,9999,0,9999,0
1731508686924,BGRD 200,097,799373,Kufareva; Irina,9999,0,9999,0
1731508686924,BGRD 200,098,799374,Lee; Kuo Fen,9999,0,9999,0
1731508686924,BGRD 200,099,799375,Lee; Yun Sok,9999,0,9999,0
1731508686924,BGRD 200,100,799376,Leutgeb; Jill K.,9999,0,9999,0
1731508686924,BGRD 200,101,799377,Leutgeb; Stefan,9999,0,9999,0
1731508686924,BGRD 200,102,799378,Li; Willis Xiaowei,9998,0,9999,1
1731508686924,BGRD 200,103,799379,Lim; Byungkook,9998,0,9999,1
1731508686924,BGRD 200,104,799380,Lo; Stanley M.,9999,0,9999,0
1731508686924,BGRD 200,105,799381,Looger; Loren Lee,9998,0,9999,1
1731508686924,BGRD 200,106,799382,Lopez Ramirez; Miguel Alej,9998,0,9999,1
1731508686924,BGRD 200,107,799383,Lovett-Barron; Matthew Rod,9997,0,9999,2
1731508686924,BGRD 200,108,799384,Lu; Li-Fan,9998,0,9999,1
1731508686924,BGRD 200,109,799385,Lu; Pengzhe,9998,0,9999,1
1731508686924,BGRD 200,110,799386,Lykke-Andersen; Jens,9998,0,9999,1
1731508686924,BGRD 200,111,799387,Lyons; Deirdre Colleen,9998,0,9999,1
1731508686924,BGRD 200,112,799388,Lyumkis; Dmitry Evgenievich,9998,0,9999,1
1731508686924,BGRD 200,113,799389,Manor; Uri,9999,0,9999,0
1731508686924,BGRD 200,114,799390,Mayfield; Stephen P.,9998,0,9999,1
1731508686924,BGRD 200,115,799391,McConville; Patrick James,9999,0,9999,0
1731508686924,BGRD 200,116,799392,McDonnell; Lisa Marie,9999,0,9999,0
1731508686924,BGRD 200,117,799393,Mertens; Jerome Stefan,9999,0,9999,0
1731508686924,BGRD 200,118,799394,Meyer; Justin Raymond,9999,0,9999,0
1731508686924,BGRD 200,119,799395,Morris; Gerald P,9999,0,9999,0
1731508686924,BGRD 200,120,799396,Mueller; Lena,9998,0,9999,1
1731508686924,BGRD 200,121,799397,Muotri; Alysson,9999,0,9999,0
1731508686924,BGRD 200,122,799398,Muroyama; Andrew David,9995,0,9999,4
1731508686924,BGRD 200,123,799399,Murre; Cornelis,9998,0,9999,1
1731508686924,BGRD 200,124,799400,Reyes De Barboza; Nabora S,9999,0,9999,0
1731508686924,BGRD 200,125,799401,Neal; Sonya E,9998,0,9999,1
1731508686924,BGRD 200,126,799402,Nieh; James Charles,9997,0,9999,2
1731508686924,BGRD 200,127,799403,Nimmerjahn; Axel,9999,0,9999,0
1731508686924,BGRD 200,128,799404,Niwa; Maho,9999,0,9999,0
1731508686924,BGRD 200,129,799405,Nizet; Victor F.,9999,0,9999,0
1731508686924,BGRD 200,130,799406,Oegema; Karen,9999,0,9999,0
1731508686924,BGRD 200,131,799407,Panda; Satchidananda,9998,0,9999,1
1731508686924,BGRD 200,132,799408,Parast; Mana,9999,0,9999,0
1731508686924,BGRD 200,133,799409,Pasquinelli; Amy,9998,0,9999,1
1731508686924,BGRD 200,134,799410,Pekkurnaz Banghart; Gulcin,9999,0,9999,0
1731508686924,BGRD 200,135,799411,Perry; Michael William,9999,0,9999,0
1731508686924,BGRD 200,136,799413,Pillus; Lorraine,9998,0,9999,1
1731508686924,BGRD 200,137,799414,Pogliano; Joseph,9999,0,9999,0
1731508686924,BGRD 200,138,799415,Pogliano; Kit J.,9999,0,9999,0
1731508686924,BGRD 200,139,799416,Pride; David Tevis,9999,0,9999,0
1731508686924,BGRD 200,140,799417,Pruneda-Paz; Jose L.,9998,0,9999,1
1731508686924,BGRD 200,141,799418,Ramanan; Deepshika,9998,0,9999,1
1731508686924,BGRD 200,142,799419,Rana; Tariq,9998,0,9999,1
1731508686924,BGRD 200,143,799420,Rao; Anjana,9999,0,9999,0
1731508686924,BGRD 200,144,799421,Raz; Eyal,9997,0,9999,2
1731508686924,BGRD 200,145,799422,Reck-Peterson; Samara L,9999,0,9999,0
1731508686924,BGRD 200,146,799423,Ren; Bing,9999,0,9999,0
1731508686924,BGRD 200,147,799424,Rennison; Diana,9998,0,9999,1
1731508686924,BGRD 200,148,799425,Rifkin; Scott,9999,0,9999,0
1731508686924,BGRD 200,149,799426,Risbrough; Victoria Blythe,9998,0,9999,1
1731508686924,BGRD 200,150,799427,Rivera; Fabian Chavez,9997,0,9999,2
1731508686924,BGRD 200,151,799428,Rohner; Patrick Thomas,9999,0,9999,0
1731508686924,BGRD 200,152,799429,Rose; Noah Hartmann,9999,0,9999,0
1731508686924,BGRD 200,153,799430,Rosenfeld; Michael G,9999,0,9999,0
1731508686924,BGRD 200,154,799431,Russell; Alistair B,9999,0,9999,0
1731508686924,BGRD 200,155,799432,Saier; Milton H.,9998,0,9999,1
1731508686924,BGRD 200,156,799433,Saltiel; Alan,9997,0,9999,2
1731508686924,BGRD 200,157,799434,Sanchez-Lopez; Elsa,9999,0,9999,0
1731508686924,BGRD 200,158,799435,Saphire; Erica Ollmann,9999,0,9999,0
1731508686924,BGRD 200,159,799436,Schroeder; Julian I,9997,0,9999,2
1731508686924,BGRD 200,160,799437,Sebat; Lilia Mikhailovna,9997,0,9999,2
1731508686924,BGRD 200,161,799438,Sen; George L,9999,0,9999,0
1731508686924,BGRD 200,162,799439,Shah; Sameer B,9999,0,9999,0
1731508686924,BGRD 200,163,799440,Shaner; Nathan C.,9999,0,9999,0
1731508686924,BGRD 200,164,799441,Sharpee; Tatyana,9999,0,9999,0
1731508686924,BGRD 200,165,799442,Shaw; Reuben,9999,0,9999,0
1731508686924,BGRD 200,166,799443,Shurin; Jonathan,9997,0,9999,2
1731508686924,BGRD 200,167,799444,Sicklick; Jason Keith,9999,0,9999,0
1731508686924,BGRD 200,168,799445,Signer; Robert,9999,0,9999,0
1731508686924,BGRD 200,169,799446,Simonson; Tatum Sasha Summ,9998,0,9999,1
1731508686924,BGRD 200,170,799447,Soncin; Francesca,9999,0,9999,0
1731508686924,BGRD 200,171,799448,Steinmetz; Nicole F,9999,0,9999,0
1731508686924,BGRD 200,172,799449,Su; Chih-Ying,9998,0,9999,1
1731508686924,BGRD 200,173,799450,Suel; Gurol Mehmet,9997,0,9999,2
1731508686924,BGRD 200,174,799451,Sun; Xin,9998,0,9999,1
1731508686924,BGRD 200,175,799452,Telese; Francesca,9998,0,9999,1
1731508686924,BGRD 200,176,799453,Towers; Christina Garlingt,9995,0,9999,4
1731508686924,BGRD 200,177,799454,Traver; David,9999,0,9999,0
1731508686924,BGRD 200,178,799455,Troemel; Emily Ruth,9998,0,9999,1
1731508686924,BGRD 200,179,799456,Valdez-Jasso; Daniela,9999,0,9999,0
1731508686924,BGRD 200,180,799457,Vijayanand; Pandurangan,9999,0,9999,0
1731508686924,BGRD 200,181,799458,Villa Rodriguez; Elizabeth,9999,0,9999,0
1731508686924,BGRD 200,182,799459,Wahlin; Karl Jonas,9997,0,9999,2
1731508686924,BGRD 200,183,799460,Wang; Jean Yin Jen,9999,0,9999,0
1731508686924,BGRD 200,184,799461,Webster; Nicholas J G,9999,0,9999,0
1731508686924,BGRD 200,185,799462,Welsbie; Derek,9999,0,9999,0
1731508686924,BGRD 200,186,799463,Wildonger; Jill Cathleen,9996,0,9999,3
1731508686924,BGRD 200,187,799464,Winzeler; Elizabeth A,9999,0,9999,0
1731508686924,BGRD 200,188,799465,Yaksh; Tony L.,9999,0,9999,0
1731508686924,BGRD 200,189,799466,Yelon; Deborah,9997,0,9999,2
1731508686924,BGRD 200,190,799467,Yeo; Eugene Wei-Ming,9998,0,9999,1
1731508686924,BGRD 200,191,799468,Ying; Wei,9997,0,9999,2
1731508686924,BGRD 200,192,799469,Young; Jared W.,9999,0,9999,0
1731508686924,BGRD 200,193,799470,Zage; Peter,9999,0,9999,0
1731508686924,BGRD 200,194,799471,Zengler; Karsten B,9997,0,9999,2
1731508686924,BGRD 200,195,799472,Zhang; Dong-Er,9999,0,9999,0
1731508686924,BGRD 200,196,799473,Zhang; Jin,9999,0,9999,0
1731508686924,BGRD 200,197,799474,Zhao; Yunde,9999,0,9999,0
1731508686924,BGRD 200,198,799475,Zheng; Binhai,9999,0,9999,0
1731508686924,BGRD 200,199,799476,Zheng; Ye,9998,0,9999,1
1731508686924,BGRD 200,200,799477,Zhou; Huilin,9999,0,9999,0
1731508686924,BGRD 200,201,799478,Zou; Yimin,9998,0,9999,1
1731508686924,BGRD 200,202,799479,Zuniga; Elina I,9998,0,9999,1
1731508687950,BGSE 200,A00,765304,Tour; Ella & Petrie; Katherine Lynn,9987,0,9999,12
1731508688977,BGSE 205,A00,765321,Bennett; Eric J,43,0,50,7
1731508688977,BGSE 205,B00,765322,Bennett; Eric J,46,0,50,4
1731508688977,BGSE 205,C00,765369,Bennett; Eric J,36,0,50,14
1731508688977,BGSE 205,D00,765470,Bennett; Eric J,40,0,50,10
1731508688977,BGSE 205,E00,765471,Bennett; Eric J,45,0,50,5
1731508690029,BIBC 100,A01,786720,Hui; Enfu,70,0,73,3
1731508690029,BIBC 100,A02,786721,Hui; Enfu,64,0,73,9
1731508690029,BIBC 100,A03,786723,Hui; Enfu,67,0,73,6
1731508690029,BIBC 100,A04,786775,Hui; Enfu,67,0,73,6
1731508691057,BIBC 102,A01,786782,Feng; Gen-Sheng,72,0,73,1
1731508691057,BIBC 102,A02,786783,Feng; Gen-Sheng,71,0,73,2
1731508691057,BIBC 102,A03,786784,Feng; Gen-Sheng,73,0,73,0
1731508691057,BIBC 102,A04,786790,Feng; Gen-Sheng,73,0,73,0
1731508691057,BIBC 102,B01,786791,Dickinson; Alexandra Jazz,61,0,73,12
1731508691057,BIBC 102,B02,786792,Dickinson; Alexandra Jazz,64,0,73,9
1731508691057,BIBC 102,B03,786845,Dickinson; Alexandra Jazz,68,0,73,5
1731508691057,BIBC 102,B04,786859,Dickinson; Alexandra Jazz,50,0,73,23
1731508692086,BIBC 103,A01,757720,Coleman; Aaron B.,21,0,24,3
1731508692086,BIBC 103,A02,757773,Coleman; Aaron B.,22,0,24,2
1731508692086,BIBC 103,B01,757783,Coleman; Aaron B.,18,0,24,6
1731508692086,BIBC 103,B02,757784,Coleman; Aaron B.,21,0,24,3
1731508692086,BIBC 103,C01,758001,Burg; Michael,17,0,24,7
1731508692086,BIBC 103,C02,758019,Burg; Michael,24,0,24,0
1731508693113,BIBC 120,A01,758029,Hampton; Randolph Y.,61,0,87,26
1731508693113,BIBC 120,A02,758032,Hampton; Randolph Y.,65,0,87,22
1731508693113,BIBC 120,A03,758038,Hampton; Randolph Y.,77,0,87,10
1731508693113,BIBC 120,A04,758119,Hampton; Randolph Y.,74,0,87,13
1731508694143,BIBC 194,A00,758136,Hui; Enfu,25,0,32,7
1731508694143,BIBC 194,B00,758137,Niwa; Maho,25,0,32,7
1731508694143,BIBC 194,C00,758138,Corbett; Kevin Daniel,25,0,32,7
1731508695182,BICD 100,A01,786869,Troemel; Emily Ruth,72,0,73,1
1731508695182,BICD 100,A02,786870,Troemel; Emily Ruth,73,0,73,0
1731508695182,BICD 100,A03,786871,Troemel; Emily Ruth,73,0,73,0
1731508695182,BICD 100,A04,786872,Troemel; Emily Ruth,73,0,73,0
1731508695182,BICD 100,B01,786873,Grossman; Emily N,66,0,73,7
1731508695182,BICD 100,B02,786874,Grossman; Emily N,66,0,73,7
1731508695182,BICD 100,B03,786875,Grossman; Emily N,71,0,73,2
1731508695182,BICD 100,B04,786876,Grossman; Emily N,70,0,73,3
1731508695182,BICD 100,C01,786877,Grossman; Emily N,64,0,73,9
1731508695182,BICD 100,C02,786878,Grossman; Emily N,71,0,73,2
1731508695182,BICD 100,C03,786879,Grossman; Emily N,70,0,73,3
1731508695182,BICD 100,C04,786880,Grossman; Emily N,71,0,73,2
1731508696218,BICD 110,A01,758191,Chaim; Isaac,54,0,63,9
1731508696218,BICD 110,A02,758193,Chaim; Isaac,42,0,63,21
1731508696218,BICD 110,A03,758194,Chaim; Isaac,61,0,63,2
1731508696218,BICD 110,A04,758196,Chaim; Isaac,56,0,61,5
1731508696218,BICD 110,B01,758200,Manor; Uri,60,0,63,3
1731508696218,BICD 110,B02,758201,Manor; Uri,63,0,63,0
1731508696218,BICD 110,B03,758202,Manor; Uri,55,0,63,8
1731508696218,BICD 110,B04,758204,Manor; Uri,56,0,61,5
1731508697243,BICD 120,A01,758206,Estelle; Mark,20,0,23,3
1731508697243,BICD 120,A02,758208,Estelle; Mark,22,0,23,1
1731508697243,BICD 120,A03,758209,Estelle; Mark,23,0,23,0
1731508697243,BICD 120,A04,758214,Estelle; Mark,17,0,21,4
1731508698269,BICD 194,A00,758215,Hueschen; Christina Lynn,29,0,32,3
1731508699300,BIEB 102,A01,758218,Jackrel; Sara,46,0,48,2
1731508699300,BIEB 102,A02,758219,Jackrel; Sara,47,0,48,1
1731508699300,BIEB 102,A03,758220,Jackrel; Sara,48,0,48,0
1731508699300,BIEB 102,A04,758222,Jackrel; Sara,48,0,48,0
1731508700328,BIEB 121,A00,758224,Butler; Shannon Rhey,8,0,32,24
1731508700328,BIEB 121,B00,758225,Butler; Shannon Rhey,20,0,32,12
1731508701362,BIEB 134,A01,758227,Barton; Andrew David,10,0,11,1
1731508701362,BIEB 134,A02,758230,Barton; Andrew David,11,0,11,0
1731508701362,BIEB 134,A03,758231,Barton; Andrew David,9,0,11,2
1731508701362,BIEB 134,A04,758232,Barton; Andrew David,11,0,11,0
1731508701362,BIEB 134,A05,758233,Barton; Andrew David,7,0,11,4
1731508701362,BIEB 134,A06,758236,Barton; Andrew David,9,0,10,1
1731508701362,BIEB 134,A07,758237,Barton; Andrew David,10,0,10,0
1731508701362,BIEB 134,A08,758239,Barton; Andrew David,10,0,10,0
1731508702392,BIEB 135,A01,758241,Shurin; Jonathan,20,0,36,16
1731508703424,BIEB 140,A01,758243,Roy; Kaustuv,35,0,40,5
1731508703424,BIEB 140,A02,758248,Roy; Kaustuv,36,0,40,4
1731508703424,BIEB 140,A03,758250,Roy; Kaustuv,35,0,40,5
1731508703424,BIEB 140,A04,758251,Roy; Kaustuv,32,0,40,8
1731508704455,BIEB 152,A01,758255,Wodarz; Dominik Franz Xave,57,0,63,6
1731508704455,BIEB 152,A02,758256,Wodarz; Dominik Franz Xave,62,0,63,1
1731508704455,BIEB 152,A03,758257,Wodarz; Dominik Franz Xave,54,0,63,9
1731508704455,BIEB 152,A04,758260,Wodarz; Dominik Franz Xave,50,0,61,11
1731508705483,BIEB 156,A01,758262,Rose; Noah Hartmann & Rennison; Diana,26,0,29,3
1731508705483,BIEB 156,A02,758267,Rose; Noah Hartmann & Rennison; Diana,26,0,29,3
1731508705483,BIEB 156,A03,758269,Rose; Noah Hartmann & Rennison; Diana,29,0,29,0
1731508705483,BIEB 156,A04,758272,Rose; Noah Hartmann & Rennison; Diana,28,0,28,0
1731508706523,BILD 1,A01,786580,Ochoa Mikrut; Stacy Daniel,93,0,100,7
1731508706523,BILD 1,A02,786585,Ochoa Mikrut; Stacy Daniel,100,0,100,0
1731508706523,BILD 1,A03,786589,Ochoa Mikrut; Stacy Daniel,98,0,100,2
1731508706523,BILD 1,A04,786591,Ochoa Mikrut; Stacy Daniel,96,0,100,4
1731508706523,BILD 1,B01,786593,Madigan; Cressida Ariana,85,0,100,15
1731508706523,BILD 1,B02,786612,Madigan; Cressida Ariana,73,0,100,27
1731508706523,BILD 1,B03,786613,Madigan; Cressida Ariana,93,0,100,7
1731508706523,BILD 1,B04,786614,Madigan; Cressida Ariana,97,0,100,3
1731508706523,BILD 1,C01,786630,Cooper; Andrew Michael,97,0,100,3
1731508706523,BILD 1,C02,786631,Cooper; Andrew Michael,99,0,100,1
1731508706523,BILD 1,C03,786669,Cooper; Andrew Michael,100,0,100,0
1731508706523,BILD 1,C04,786704,Cooper; Andrew Michael,99,0,100,1
1731508707561,BILD 2,A01,786707,Owens; Melinda Tsao-Ying,64,0,65,1
1731508707561,BILD 2,A02,786708,Owens; Melinda Tsao-Ying,58,0,60,2
1731508707561,BILD 2,A03,786709,Owens; Melinda Tsao-Ying,57,0,60,3
1731508707561,BILD 2,A04,786710,Owens; Melinda Tsao-Ying,60,0,60,0
1731508707561,BILD 2,B01,786920,Owens; Melinda Tsao-Ying,59,0,60,1
1731508707561,BILD 2,B02,786975,Owens; Melinda Tsao-Ying,60,0,60,0
1731508707561,BILD 2,B03,786976,Owens; Melinda Tsao-Ying,64,0,65,1
1731508707561,BILD 2,B04,786979,Owens; Melinda Tsao-Ying,64,0,65,1
1731508707561,BILD 2,C01,786980,Su; Chih-Ying,61,0,63,2
1731508707561,BILD 2,C02,786981,Su; Chih-Ying,58,0,63,5
1731508707561,BILD 2,C03,786983,Su; Chih-Ying,60,0,63,3
1731508707561,BILD 2,C04,786985,Su; Chih-Ying,61,0,61,0
1731508708592,BILD 3,A01,786711,Hammond; LaTisha Marie,49,0,60,11
1731508708592,BILD 3,A02,786712,Hammond; LaTisha Marie,44,0,60,16
1731508708592,BILD 3,A03,786713,Hammond; LaTisha Marie,59,0,60,1
1731508708592,BILD 3,A04,786714,Hammond; LaTisha Marie,54,0,60,6
1731508708592,BILD 3,B01,786715,Hammond; LaTisha Marie,58,0,60,2
1731508708592,BILD 3,B02,786716,Hammond; LaTisha Marie,60,0,60,0
1731508708592,BILD 3,B03,786717,Hammond; LaTisha Marie,55,0,60,5
1731508708592,BILD 3,B04,786719,Hammond; LaTisha Marie,59,0,60,1
1731508708592,BILD 3,D01,786997,Pirino; Giorgia,58,0,60,2
1731508708592,BILD 3,D02,786998,Pirino; Giorgia,58,0,60,2
1731508708592,BILD 3,D03,786999,Pirino; Giorgia,58,0,60,2
1731508708592,BILD 3,D04,787001,Pirino; Giorgia,60,0,60,0
1731508709622,BILD 4,A01,757384,Gonzalez Gamboa; Ivonne,20,0,24,4
1731508709622,BILD 4,A02,757387,Gonzalez Gamboa; Ivonne,22,0,24,2
1731508709622,BILD 4,A03,757388,Gonzalez Gamboa; Ivonne,24,0,24,0
1731508709622,BILD 4,A04,757396,Gonzalez Gamboa; Ivonne,24,0,24,0
1731508709622,BILD 4,A05,757397,Gonzalez Gamboa; Ivonne,22,0,24,2
1731508709622,BILD 4,A06,757399,Gonzalez Gamboa; Ivonne,24,0,24,0
1731508709622,BILD 4,A07,757403,Gonzalez Gamboa; Ivonne,23,0,24,1
1731508709622,BILD 4,A08,757404,Gonzalez Gamboa; Ivonne,22,0,24,2
1731508709622,BILD 4,B01,757410,Gonzalez Gamboa; Ivonne,15,0,24,9
1731508709622,BILD 4,B02,757413,Gonzalez Gamboa; Ivonne,21,0,24,3
1731508709622,BILD 4,B03,757416,Gonzalez Gamboa; Ivonne,23,0,24,1
1731508709622,BILD 4,B04,757417,Gonzalez Gamboa; Ivonne,23,0,24,1
1731508709622,BILD 4,B05,757419,Gonzalez Gamboa; Ivonne,23,0,24,1
1731508709622,BILD 4,B06,757421,Gonzalez Gamboa; Ivonne,23,0,24,1
1731508709622,BILD 4,B07,757423,Gonzalez Gamboa; Ivonne,23,0,24,1
1731508709622,BILD 4,B08,757434,Gonzalez Gamboa; Ivonne,23,0,24,1
1731508709622,BILD 4,C01,757437,Ochoa Mikrut; Stacy Daniel,22,0,24,2
1731508709622,BILD 4,C02,757439,Ochoa Mikrut; Stacy Daniel,23,0,24,1
1731508709622,BILD 4,C03,757440,Ochoa Mikrut; Stacy Daniel,24,0,24,0
1731508709622,BILD 4,C04,757495,Ochoa Mikrut; Stacy Daniel,23,0,24,1
1731508709622,BILD 4,C05,757496,Ochoa Mikrut; Stacy Daniel,24,0,24,0
1731508709622,BILD 4,C06,757497,Ochoa Mikrut; Stacy Daniel,24,0,24,0
1731508709622,BILD 4,C07,757498,Ochoa Mikrut; Stacy Daniel,24,0,24,0
1731508709622,BILD 4,C08,757499,Ochoa Mikrut; Stacy Daniel,24,0,24,0
1731508709622,BILD 4,D01,757501,Lo; Stanley M.,14,0,24,10
1731508709622,BILD 4,D02,757502,Lo; Stanley M.,22,0,24,2
1731508709622,BILD 4,D03,757503,Lo; Stanley M.,24,0,24,0
1731508709622,BILD 4,D04,757504,Lo; Stanley M.,22,0,24,2
1731508709622,BILD 4,D05,757505,Lo; Stanley M.,22,0,24,2
1731508709622,BILD 4,D06,757506,Lo; Stanley M.,22,0,24,2
1731508709622,BILD 4,D07,757507,Lo; Stanley M.,24,0,24,0
1731508709622,BILD 4,D08,757508,Lo; Stanley M.,22,0,24,2
1731508710655,BILD 5,A01,786885,Mueller; Liam O'Connor,60,0,65,5
1731508710655,BILD 5,A02,786886,Mueller; Liam O'Connor,58,0,65,7
1731508710655,BILD 5,A03,786887,Mueller; Liam O'Connor,64,0,65,1
1731508710655,BILD 5,A04,786888,Mueller; Liam O'Connor,64,0,65,1
1731508710655,BILD 5,B01,786889,Reuther; Keefe,65,0,65,0
1731508710655,BILD 5,B02,786890,Reuther; Keefe,60,0,65,5
1731508710655,BILD 5,B03,786891,Reuther; Keefe,64,0,65,1
1731508710655,BILD 5,B04,786892,Reuther; Keefe,65,0,65,0
1731508711683,BILD 12,A01,757527,Komiyama; Takaki,24,0,24,0
1731508711683,BILD 12,A02,757530,Komiyama; Takaki,24,0,24,0
1731508711683,BILD 12,A03,757531,Komiyama; Takaki,21,0,24,3
1731508711683,BILD 12,A04,757532,Komiyama; Takaki,24,0,24,0
1731508712708,BILD 22,A01,757534,Strause; Linda G.,69,0,75,6
1731508712708,BILD 22,A02,757535,Strause; Linda G.,70,0,75,5
1731508712708,BILD 22,A03,757544,Strause; Linda G.,75,0,75,0
1731508712708,BILD 22,A04,757547,Strause; Linda G.,74,0,75,1
1731508713737,BILD 28,A01,757549,Idoyaga; Juliana,30,0,30,0
1731508713737,BILD 28,A02,757550,Idoyaga; Juliana,30,0,30,0
1731508713737,BILD 28,A03,757551,Idoyaga; Juliana,30,0,30,0
1731508713737,BILD 28,A04,757552,Idoyaga; Juliana,30,0,30,0
1731508714764,BILD 60,A01,757569,Meharena; Hiruy Sibhatu,16,0,16,0
1731508714764,BILD 60,A02,757570,Meharena; Hiruy Sibhatu,16,0,16,0
1731508714764,BILD 60,A03,757571,Meharena; Hiruy Sibhatu,16,0,16,0
1731508714764,BILD 60,A04,757572,Meharena; Hiruy Sibhatu,16,0,16,0
1731508715790,BILD 62,A01,757574,Juavinett; Ashley Lauren,22,0,24,2
1731508715790,BILD 62,A02,757575,Juavinett; Ashley Lauren,23,0,24,1
1731508715790,BILD 62,A03,757576,Juavinett; Ashley Lauren,21,0,24,3
1731508715790,BILD 62,A04,757712,Juavinett; Ashley Lauren,22,0,24,2
1731508716818,BILD 87,A00,757714,Saier; Milton H.,20,0,20,0
1731508716818,BILD 87,B00,757715,Saier; Milton H.,19,0,20,1
1731508717847,BIMM 100,A01,785694,Cook-Andersen; Heidi Leigh,46,0,48,2
1731508717847,BIMM 100,A02,785696,Cook-Andersen; Heidi Leigh,48,0,48,0
1731508717847,BIMM 100,A03,785706,Cook-Andersen; Heidi Leigh,42,0,48,6
1731508717847,BIMM 100,A04,785714,Cook-Andersen; Heidi Leigh,48,0,48,0
1731508717847,BIMM 100,B01,785715,Akbari; Omar Sultan,45,0,48,3
1731508717847,BIMM 100,B02,785716,Akbari; Omar Sultan,39,0,48,9
1731508717847,BIMM 100,B03,785717,Akbari; Omar Sultan,46,0,48,2
1731508717847,BIMM 100,B04,785718,Akbari; Omar Sultan,46,0,48,2
1731508718878,BIMM 101,A01,758279,Meaders; Clara Leigh,0,0,24,24
1731508718878,BIMM 101,A02,758280,Meaders; Clara Leigh,0,0,24,24
1731508718878,BIMM 101,B01,758282,Tour; Ella,8,0,24,16
1731508718878,BIMM 101,B02,758283,Tour; Ella,14,0,24,10
1731508718878,BIMM 101,C01,758285,Day; Christopher D,19,0,24,5
1731508718878,BIMM 101,C02,758286,Day; Christopher D,22,0,24,2
1731508718878,BIMM 101,D01,758293,Cooper; Andrew Michael,19,0,24,5
1731508718878,BIMM 101,D02,758323,Cooper; Andrew Michael,20,0,24,4
1731508718878,BIMM 101,E01,758342,Rusert; Jessica Marie,21,0,24,3
1731508718878,BIMM 101,E02,758343,Rusert; Jessica Marie,24,0,24,0
1731508718878,BIMM 101,F01,758345,Rusert; Jessica Marie,23,0,24,1
1731508718878,BIMM 101,F02,758346,Rusert; Jessica Marie,24,0,24,0
1731508719912,BIMM 112,A01,758422,Kadonaga; James T,38,0,40,2
1731508719912,BIMM 112,A02,758427,Kadonaga; James T,33,0,40,7
1731508719912,BIMM 112,A03,758428,Kadonaga; James T,35,0,40,5
1731508719912,BIMM 112,A04,758429,Kadonaga; James T,39,0,40,1
1731508720941,BIMM 114,A01,758433,Daugherty; Matthew Dorton,39,0,48,9
1731508720941,BIMM 114,A02,758434,Daugherty; Matthew Dorton,46,0,48,2
1731508720941,BIMM 114,A03,758441,Daugherty; Matthew Dorton,45,0,48,3
1731508720941,BIMM 114,A04,758449,Daugherty; Matthew Dorton,42,0,48,6
1731508721984,BIMM 121,A01,758694,Gustafson-Brown; Cindy,13,0,24,11
1731508721984,BIMM 121,A02,758695,Gustafson-Brown; Cindy,20,0,24,4
1731508721984,BIMM 121,B01,758854,Gustafson-Brown; Cindy,18,0,24,6
1731508721984,BIMM 121,B02,758855,Gustafson-Brown; Cindy,19,0,24,5
1731508721984,BIMM 121,C01,758859,Pirino; Giorgia,4,0,24,20
1731508721984,BIMM 121,C02,758860,Pirino; Giorgia,11,0,24,13
1731508723011,BIMM 134,A01,758866,Burg; Michael,76,0,103,27
1731508723011,BIMM 134,A02,758867,Burg; Michael,102,0,103,1
1731508723011,BIMM 134,A03,758868,Burg; Michael,84,0,103,19
1731508723011,BIMM 134,A04,758870,Burg; Michael,97,0,101,4
1731508724039,BIMM 143,A01,758872,Grant; Barry J,12,0,40,28
1731508724039,BIMM 143,B01,759109,Bozinovic; Goran,30,0,40,10
1731508725064,BIMM 143R,A01,759111,Bozinovic; Goran,23,0,40,17
1731508726096,BIMM 172,A01,759115,Briggs; Steven,10,0,15,5
1731508726096,BIMM 172,A02,759116,Briggs; Steven,11,0,15,4
1731508726096,BIMM 172,A03,759117,Briggs; Steven,5,0,15,10
1731508726096,BIMM 172,A04,759119,Briggs; Steven,10,0,15,5
1731508727122,BIMM 181,A01,759121,Pevzner; Pavel Arkadjevich,31,0,60,29
1731508728149,BIMM 194,A00,759122,Akbari; Omar Sultan,31,0,32,1
1731508728149,BIMM 194,B00,759123,Lykke-Andersen; Jens,11,0,32,21
1731508728149,BIMM 194,C00,759125,Hasty; Jeff M,29,0,32,3
1731508729179,BIOM 200C,A00,734458,Benner; Christopher William,2,0,28,26
1731508730207,BIOM 202,A01,734460,Corbett; Kevin Daniel,23,0,35,12
1731508731233,BIOM 203B,A00,800936,Gustafsson; Asa Birgitta,35,0,35,0
1731508732262,BIOM 218,A00,734462,Gagneux; Pascal,12,0,12,0
1731508733290,BIOM 246,A00,796600,Gordts; Philip & Lewis; Amanda Lark & Godula; Kamil & Gagneux; Pascal & Esko; Jeffrey D. & Bode; Lars,0,0,0,0
1731508734315,BIOM 253,A00,734463,Nizet; Victor F.,7,0,15,8
1731508735341,BIOM 255,A00,734466,Joiner; William J.,0,0,0,0
1731508736367,BIOM 256,A00,734467,Yang; Jing,0,0,0,0
1731508737392,BIOM 262,A01,734469,Goren; Alon M,19,0,20,1
1731508738424,BIOM 275,A01,734471,Antal; Corina Elena & Obara; Christopher & Mendiola; Andrew & Gonzalez; David J,1,0,28,27
1731508739455,BIOM 277,A01,797835,Klemke; Richard,0,0,0,0
1731508740484,BIOM 287,A00,734472,Khojah; Reem I,0,0,0,0
1731508741515,BIOM 295,A00,734474,Joiner; William J.,0,0,0,0
1731508742547,BIPN 100,A01,787002,Maita; Isabella Vincenza,57,0,61,4
1731508742547,BIPN 100,A02,787005,Maita; Isabella Vincenza,58,0,61,3
1731508742547,BIPN 100,A03,787008,Maita; Isabella Vincenza,58,0,61,3
1731508742547,BIPN 100,A04,787009,Maita; Isabella Vincenza,60,0,62,2
1731508742547,BIPN 100,B01,786881,Reyes Gonzalez; Catalina,61,0,61,0
1731508742547,BIPN 100,B02,786882,Reyes Gonzalez; Catalina,60,0,61,1
1731508742547,BIPN 100,B03,786883,Reyes Gonzalez; Catalina,55,0,61,6
1731508742547,BIPN 100,B04,786884,Reyes Gonzalez; Catalina,55,0,62,7
1731508742547,BIPN 100,C01,787011,Marino; Marc J,53,0,61,8
1731508742547,BIPN 100,C02,787013,Marino; Marc J,56,0,61,5
1731508742547,BIPN 100,C03,787014,Marino; Marc J,59,0,61,2
1731508742547,BIPN 100,C04,787015,Marino; Marc J,53,0,62,9
1731508742547,BIPN 100,D01,794575,Yang; Mingyu,35,0,36,1
1731508742547,BIPN 100,D02,794600,Yang; Mingyu,35,0,36,1
1731508742547,BIPN 100,D03,794576,Yang; Mingyu,35,0,36,1
1731508742547,BIPN 100,D04,794601,Yang; Mingyu,37,0,37,0
1731508743575,BIPN 102,A01,759131,Reyes Gonzalez; Catalina,36,0,61,25
1731508743575,BIPN 102,A02,759133,Reyes Gonzalez; Catalina,56,0,61,5
1731508743575,BIPN 102,A03,759134,Reyes Gonzalez; Catalina,56,0,61,5
1731508743575,BIPN 102,A04,759135,Reyes Gonzalez; Catalina,59,0,62,3
1731508744607,BIPN 105,A01,759139,Armour; Jon Christopher,4,0,21,17
1731508744607,BIPN 105,A02,759140,Armour; Jon Christopher,15,0,21,6
1731508744607,BIPN 105,B01,759144,Armour; Jon Christopher,14,0,21,7
1731508744607,BIPN 105,B02,759147,Armour; Jon Christopher,21,0,21,0
1731508745634,BIPN 140,A01,759149,Lovett-Barron; Matthew Rod,31,0,40,9
1731508745634,BIPN 140,A02,759150,Lovett-Barron; Matthew Rod,40,0,40,0
1731508745634,BIPN 140,A03,759152,Lovett-Barron; Matthew Rod,38,0,40,2
1731508745634,BIPN 140,A04,759154,Lovett-Barron; Matthew Rod,37,0,38,1
1731508746665,BIPN 145,A01,759171,Juavinett; Ashley Lauren,34,0,42,8
1731508746665,BIPN 145,B01,759173,Maita; Isabella Vincenza,40,0,42,2
1731508746665,BIPN 145,C01,759176,Marino; Marc J,30,0,42,12
1731508747691,BIPN 154,A01,759178,Lim; Byungkook,26,0,30,4
1731508747691,BIPN 154,A02,759179,Lim; Byungkook,28,0,30,2
1731508747691,BIPN 154,A03,759180,Lim; Byungkook,28,0,30,2
1731508747691,BIPN 154,A04,759181,Lim; Byungkook,26,0,31,5
1731508748717,BIPN 160,A01,759183,Root; Cory Matthew,45,0,62,17
1731508748717,BIPN 160,A02,759186,Root; Cory Matthew,58,0,62,4
1731508748717,BIPN 160,A03,759187,Root; Cory Matthew,61,0,62,1
1731508748717,BIPN 160,A04,759188,Root; Cory Matthew,51,0,61,10
1731508749748,BIPN 162,A01,759190,Benna; Marcus K,4,0,7,3
1731508749748,BIPN 162,A02,759191,Benna; Marcus K,2,0,7,5
1731508749748,BIPN 162,A03,759192,Benna; Marcus K,4,0,7,3
1731508749748,BIPN 162,A04,759194,Benna; Marcus K,8,0,9,1
1731508750775,BIPN 194,A00,759195,Ackerman; Susan,31,0,32,1
1731508750775,BIPN 194,B00,759196,Leutgeb; Jill K.,14,0,32,18
1731508750775,BIPN 194,C00,759197,Banghart; Matthew Ryan,28,0,32,4
1731508750775,BIPN 194,E00,759201,Meharena; Hiruy Sibhatu,32,0,32,0
1731508751807,BISP 193,001,795783,Maita; Isabella Vincenza,9999,0,9999,0
1731508752835,BISP 194,A00,759202,Newsam; John,14,0,32,18
1731508752835,BISP 194,B00,759203,Cooper; Kimberly Lynn,20,0,32,12
1731508753865,BNFO 262,A01,734447,Goren; Alon M,4,0,5,1
1731508754899,BNFO 281,A00,734448,Gaasterland; Theresa,74,0,100,26
1731508755928,BNFO 283,A00,734456,Fisch; Kathleen Marie & Sahoo; Debashis,7,0,23,16
1731508755928,BNFO 283,B00,734457,Abagyan; Ruben & Bansal; Vikas,11,0,23,12
1731508756958,BNFO 286,A00,734451,Ideker; Trey,26,0,30,4
1731508757984,BNFO 294,A01,734453,Ross; Camille,45,0,50,5
1731508759050,CAT 2,A01,740617,Bronstein; Phoebe Malan,16,0,16,0
1731508759050,CAT 2,A02,740618,Bronstein; Phoebe Malan,9,0,16,7
1731508759050,CAT 2,A03,740619,Bronstein; Phoebe Malan,0,0,16,16
1731508759050,CAT 2,A04,740620,Bronstein; Phoebe Malan,9,0,16,7
1731508759050,CAT 2,A05,740621,Bronstein; Phoebe Malan,8,0,16,8
1731508759050,CAT 2,A06,740623,Bronstein; Phoebe Malan,12,0,16,4
1731508759050,CAT 2,A07,740625,Bronstein; Phoebe Malan,14,0,16,2
1731508759050,CAT 2,A08,740628,Bronstein; Phoebe Malan,15,0,16,1
1731508759050,CAT 2,A09,740629,Bronstein; Phoebe Malan,16,0,16,0
1731508759050,CAT 2,A10,740679,Bronstein; Phoebe Malan,16,0,16,0
1731508759050,CAT 2,A11,740681,Bronstein; Phoebe Malan,13,0,16,3
1731508759050,CAT 2,A12,740686,Bronstein; Phoebe Malan,13,0,16,3
1731508759050,CAT 2,A13,740698,Bronstein; Phoebe Malan,12,0,16,4
1731508759050,CAT 2,A14,740703,Bronstein; Phoebe Malan,12,0,16,4
1731508759050,CAT 2,A15,740704,Bronstein; Phoebe Malan,15,0,16,1
1731508759050,CAT 2,A16,740709,Bronstein; Phoebe Malan,13,0,16,3
1731508759050,CAT 2,B01,740715,Bigham; David Joseph,15,0,16,1
1731508759050,CAT 2,B02,740761,Bigham; David Joseph,14,0,16,2
1731508759050,CAT 2,B03,740762,Bigham; David Joseph,12,0,16,4
1731508759050,CAT 2,B04,740763,Bigham; David Joseph,12,0,16,4
1731508759050,CAT 2,B05,740764,Bigham; David Joseph,16,0,16,0
1731508759050,CAT 2,B06,740765,Bigham; David Joseph,13,0,16,3
1731508759050,CAT 2,B07,740767,Bigham; David Joseph,16,0,16,0
1731508759050,CAT 2,B08,740768,Bigham; David Joseph,16,0,16,0
1731508759050,CAT 2,B09,740770,Bigham; David Joseph,16,0,16,0
1731508759050,CAT 2,B10,740772,Bigham; David Joseph,12,0,16,4
1731508759050,CAT 2,B11,740773,Bigham; David Joseph,15,0,16,1
1731508759050,CAT 2,B12,740774,Bigham; David Joseph,16,0,16,0
1731508759050,CAT 2,B13,740777,Bigham; David Joseph,14,0,16,2
1731508759050,CAT 2,B14,740780,Bigham; David Joseph,12,0,16,4
1731508759050,CAT 2,B15,740781,Bigham; David Joseph,16,0,16,0
1731508759050,CAT 2,B16,740848,Bigham; David Joseph,16,0,16,0
1731508759050,CAT 2,C01,740895,Marchisotto; Jennifer Anne,16,0,16,0
1731508759050,CAT 2,C02,740896,Marchisotto; Jennifer Anne,13,0,16,3
1731508759050,CAT 2,C03,740908,Marchisotto; Jennifer Anne,12,0,16,4
1731508759050,CAT 2,C04,740944,Marchisotto; Jennifer Anne,14,0,16,2
1731508759050,CAT 2,C05,740945,Marchisotto; Jennifer Anne,15,0,16,1
1731508759050,CAT 2,C06,740946,Marchisotto; Jennifer Anne,16,0,16,0
1731508759050,CAT 2,C07,740947,Marchisotto; Jennifer Anne,14,0,16,2
1731508759050,CAT 2,C08,740949,Marchisotto; Jennifer Anne,16,0,16,0
1731508759050,CAT 2,C09,740960,Marchisotto; Jennifer Anne,16,0,16,0
1731508759050,CAT 2,C10,740966,Marchisotto; Jennifer Anne,15,0,16,1
1731508759050,CAT 2,C11,741017,Marchisotto; Jennifer Anne,15,0,16,1
1731508759050,CAT 2,C12,741018,Marchisotto; Jennifer Anne,14,0,16,2
1731508759050,CAT 2,C13,741019,Marchisotto; Jennifer Anne,16,0,16,0
1731508759050,CAT 2,C14,741024,Marchisotto; Jennifer Anne,15,0,16,1
1731508759050,CAT 2,D01,741027,Nguyen; Hoang A.,14,0,16,2
1731508759050,CAT 2,D02,741028,Nguyen; Hoang A.,6,0,16,10
1731508759050,CAT 2,D03,741029,Nguyen; Hoang A.,9,0,16,7
1731508759050,CAT 2,D04,741031,Nguyen; Hoang A.,15,0,16,1
1731508759050,CAT 2,D05,741033,Nguyen; Hoang A.,16,0,16,0
1731508759050,CAT 2,D06,741034,Nguyen; Hoang A.,15,0,16,1
1731508759050,CAT 2,D07,741035,Nguyen; Hoang A.,16,0,16,0
1731508759050,CAT 2,D08,741036,Nguyen; Hoang A.,16,0,16,0
1731508759050,CAT 2,D09,741039,Nguyen; Hoang A.,14,0,16,2
1731508759050,CAT 2,D10,741042,Nguyen; Hoang A.,14,0,16,2
1731508759050,CAT 2,D11,741045,Nguyen; Hoang A.,15,0,16,1
1731508759050,CAT 2,D12,741047,Nguyen; Hoang A.,15,0,16,1
1731508759050,CAT 2,D13,741049,Nguyen; Hoang A.,15,0,16,1
1731508759050,CAT 2,D14,741054,Nguyen; Hoang A.,15,0,16,1
1731508760077,CAT 2CE,A01,741072,Popko; Elizabeth Ashley,24,0,25,1
1731508761160,CAT 87,A00,741105,Bronstein; Phoebe Malan,20,0,20,0
1731508761160,CAT 87,B00,795240,Delaville; Romain,20,0,20,0
1731508762188,CAT 124,A01,741118,Geibel; William,20,0,20,0
1731508762188,CAT 124,B01,799621,Staff,20,0,20,0
1731508763228,CAT 125,001,741143,Bigham; David Joseph,20,0,20,0
1731508763228,CAT 125,002,741149,Bigham; David Joseph,16,0,20,4
1731508763228,CAT 125,003,741152,Marchisotto; Jennifer Anne,20,0,20,0
1731508763228,CAT 125,004,741162,Marchisotto; Jennifer Anne,16,0,20,4
1731508763228,CAT 125,006,741164,Delaville; Romain,19,0,20,1
1731508763228,CAT 125,007,741180,Vanderschuit; Maya Alysia,19,0,20,1
1731508763228,CAT 125,008,741192,Vanderschuit; Maya Alysia,20,0,20,0
1731508763228,CAT 125,009,741193,Vanderschuit; Maya Alysia,19,0,20,1
1731508763228,CAT 125,010,741205,Morales; Celeste Georgianna,19,0,20,1
1731508763228,CAT 125,011,741207,Morales; Celeste Georgianna,20,0,20,0
1731508763228,CAT 125,012,741208,Morales; Celeste Georgianna,20,0,20,0
1731508763228,CAT 125,013,741209,Rose; Becca Rae,18,0,20,2
1731508763228,CAT 125,014,741215,Rose; Becca Rae,20,0,20,0
1731508763228,CAT 125,015,741222,Rose; Becca Rae,20,0,20,0
1731508763228,CAT 125,016,741224,Tosun; Adriana,18,0,20,2
1731508763228,CAT 125,017,741225,Tosun; Adriana,19,0,20,1
1731508764256,CAT 125R,A00,741229,Smith; Lauryn Alissa,17,0,20,3
1731508764256,CAT 125R,B00,741230,Smith; Lauryn Alissa,18,0,20,2
1731508764256,CAT 125R,C00,741231,Smith; Lauryn Alissa,16,0,20,4
1731508764256,CAT 125R,D00,741237,Hyland; Tina Mae,16,0,20,4
1731508764256,CAT 125R,E00,741240,Hyland; Tina Mae,17,0,20,3
1731508764256,CAT 125R,F00,741242,Hyland; Tina Mae,18,0,20,2
1731508764256,CAT 125R,G00,741243,Tosun; Adriana,15,0,20,5
1731508765290,CCE 1,001,744105,Labat Ii; Michael Luis,38,0,40,2
1731508765290,CCE 1,002,744106,Garcia; Kathryn Mary,37,0,40,3
1731508765290,CCE 1,003,744107,Lee; Kassandra,38,0,40,2
1731508765290,CCE 1,004,744108,Crawford; James,36,0,40,4
1731508765290,CCE 1,005,744109,Merryman; Ashley,39,0,40,1
1731508765290,CCE 1,006,744110,Santos; Vabianna Daria,39,0,40,1
1731508765290,CCE 1,007,744125,Bigley; Michele Heather,37,0,40,3
1731508766320,CCE 2,001,744126,Staff,19,0,20,1
1731508766320,CCE 2,002,744127,Garcia; Kathryn Mary,20,0,20,0
1731508766320,CCE 2,003,744128,Labat Ii; Michael Luis,20,0,20,0
1731508766320,CCE 2,004,744129,Labat Ii; Michael Luis,20,0,20,0
1731508766320,CCE 2,005,744130,Garcia; Kathryn Mary,20,0,20,0
1731508766320,CCE 2,006,744131,Lee; Kassandra,20,0,20,0
1731508766320,CCE 2,007,744132,Lee; Kassandra,20,0,20,0
1731508766320,CCE 2,008,744133,Santos; Vabianna Daria,20,0,20,0
1731508766320,CCE 2,009,744134,Santos; Vabianna Daria,19,0,20,1
1731508766320,CCE 2,010,744135,Bigley; Michele Heather,20,0,20,0
1731508766320,CCE 2,011,744167,Merryman; Ashley,20,0,20,0
1731508766320,CCE 2,012,744168,Merryman; Ashley,20,0,20,0
1731508767347,CCS 102,A00,795242,Werner; Bradley T.,15,0,20,5
1731508768372,CCS 123,A00,794510,Staff,25,0,25,0
1731508769402,CENG 15,A01,734482,Yang; Kesong,25,0,25,0
1731508770429,CENG 101A,A00,734483,Staff,49,0,50,1
1731508771457,CENG 101B,A00,734484,Liu; Ping,99,0,100,1
1731508772484,CENG 102,A00,734485,Powell; Alyssa,69,0,70,1
1731508772484,CENG 102,B00,734486,Powell; Alyssa,68,0,70,2
1731508773517,CENG 114,A00,734487,Jahed Motlagh; Zeinab,97,0,100,3
1731508774544,CENG 124A,A00,734488,Drews; Aaron,42,0,60,18
1731508774544,CENG 124A,B00,734489,Russ; Benjamin Edward,53,0,60,7
1731508775570,CENG 134,A00,734490,Pokorski; Jonathan Kyle,63,0,70,7
1731508776604,CENG 176A,A01,734492,Opatkiewicz; Justin Paul,11,0,48,37
1731508776604,CENG 176A,B01,734494,Zhang; Liangfang,55,0,60,5
1731508777630,CENG 205,A00,734495,Jahed Motlagh; Zeinab,40,0,60,20
1731508778657,CENG 213,A00,734496,Fenning; David,6,0,10,4
1731508779685,CENG 214,A00,734497,Li; Wan-Lu,10,0,10,0
1731508780713,CENG 215,A00,734498,Jokerst; Jesse Vincent,10,0,10,0
1731508781738,CENG 221B,A00,734499,Staff,28,0,50,22
1731508782766,CENG 251,A00,734500,Pascal; Tod A,29,0,50,21
1731508783796,CENG 252,A00,734501,Chen; Zheng,28,0,50,22
1731508784825,CENG 256,A00,734502,Meyers; Marc,10,0,10,0
1731508785851,CGS 101,A00,740473,Cuong; Marisol,35,0,35,0
1731508786880,CGS 108,A00,740486,Lu; Lillian,20,0,20,0
1731508787907,CGS 111,A00,740518,Martin Sandino; Amanda Maria Yoland,31,0,35,4
1731508788938,CGS 116,A00,740521,Cuong; Marisol,31,0,32,1
1731508789967,CGS 124,A00,740524,Martin Sandino; Amanda Maria Yoland,14,0,15,1
1731508790993,CGS 125,A00,740528,Browne; Errol Tsekani,19,0,20,1
1731508792018,CGS 135,A00,740534,Okonkwo; Holly,15,0,15,0
1731508793049,CGS 136,A00,740538,Chatti; Deepti,15,0,15,0
1731508794077,CGS 137,A00,740541,Martin Sandino; Amanda Maria Yoland,19,0,20,1
1731508795106,CGS 165,A00,740547,Browne; Errol Tsekani,13,0,15,2
1731508796132,CGS 167A,A00,740604,Patel; Shaista,11,0,12,1
1731508797158,CGS 187,A00,740608,Cuong; Marisol,13,0,15,2
1731508798185,CGS 196A,A00,740611,Taylor-Garcia; Daphne,1,0,1,0
1731508798185,CGS 196A,B00,799481,Hankins; Joseph D.,1,0,1,0
1731508798185,CGS 196A,C00,799482,Yapp; Hentyle T,1,0,1,0
1731508799210,CHEM 1,A00,734503,Brydges; Stacey,39,0,40,1
1731508800252,CHEM 6A,A01,784433,Lam; Tin Yiu,38,0,40,2
1731508800252,CHEM 6A,A02,784434,Lam; Tin Yiu,40,0,40,0
1731508800252,CHEM 6A,A03,784436,Lam; Tin Yiu,39,0,40,1
1731508800252,CHEM 6A,A04,784437,Lam; Tin Yiu,35,0,40,5
1731508800252,CHEM 6A,A05,784438,Lam; Tin Yiu,40,0,40,0
1731508800252,CHEM 6A,A06,784440,Lam; Tin Yiu,40,0,40,0
1731508800252,CHEM 6A,A07,784441,Lam; Tin Yiu,0,0,0,0
1731508800252,CHEM 6A,B01,784443,Lam; Tin Yiu,40,0,40,0
1731508800252,CHEM 6A,B02,784445,Lam; Tin Yiu,34,0,36,2
1731508800252,CHEM 6A,B03,784446,Lam; Tin Yiu,34,0,40,6
1731508800252,CHEM 6A,B04,784449,Lam; Tin Yiu,38,0,40,2
1731508800252,CHEM 6A,B05,784454,Lam; Tin Yiu,37,0,40,3
1731508800252,CHEM 6A,B06,784455,Lam; Tin Yiu,39,0,40,1
1731508800252,CHEM 6A,B07,784456,Lam; Tin Yiu,0,0,0,0
1731508800252,CHEM 6A,C01,784457,Ternansky; Robert J.,40,0,40,0
1731508800252,CHEM 6A,C02,784458,Ternansky; Robert J.,33,0,40,7
1731508800252,CHEM 6A,C03,784460,Ternansky; Robert J.,33,0,40,7
1731508800252,CHEM 6A,C04,784461,Ternansky; Robert J.,40,0,40,0
1731508800252,CHEM 6A,C05,784462,Ternansky; Robert J.,40,0,40,0
1731508800252,CHEM 6A,C06,784465,Ternansky; Robert J.,40,0,40,0
1731508800252,CHEM 6A,C07,784468,Ternansky; Robert J.,0,0,0,0
1731508801293,CHEM 6B,A01,784469,Kummel; Andrew C,40,0,40,0
1731508801293,CHEM 6B,A02,784470,Kummel; Andrew C,40,0,40,0
1731508801293,CHEM 6B,A03,784471,Kummel; Andrew C,39,0,40,1
1731508801293,CHEM 6B,A04,784472,Kummel; Andrew C,38,0,40,2
1731508801293,CHEM 6B,A05,784473,Kummel; Andrew C,37,0,40,3
1731508801293,CHEM 6B,A06,784474,Kummel; Andrew C,39,0,40,1
1731508801293,CHEM 6B,A07,784475,Kummel; Andrew C,0,0,0,0
1731508801293,CHEM 6B,B01,784481,Sailor; Michael Joseph,39,0,40,1
1731508801293,CHEM 6B,B02,784482,Sailor; Michael Joseph,39,0,40,1
1731508801293,CHEM 6B,B03,784483,Sailor; Michael Joseph,39,0,40,1
1731508801293,CHEM 6B,B04,784484,Sailor; Michael Joseph,40,0,40,0
1731508801293,CHEM 6B,B05,784485,Sailor; Michael Joseph,40,0,40,0
1731508801293,CHEM 6B,B06,784486,Sailor; Michael Joseph,40,0,40,0
1731508801293,CHEM 6B,B07,784487,Sailor; Michael Joseph,0,0,0,0
1731508801293,CHEM 6B,C01,784489,Stallings; Dontarie M,33,0,40,7
1731508801293,CHEM 6B,C02,784490,Stallings; Dontarie M,20,0,24,4
1731508801293,CHEM 6B,C03,784491,Stallings; Dontarie M,37,0,40,3
1731508801293,CHEM 6B,C04,784525,Stallings; Dontarie M,36,0,40,4
1731508801293,CHEM 6B,C05,784529,Stallings; Dontarie M,40,0,40,0
1731508801293,CHEM 6B,C06,784532,Stallings; Dontarie M,39,0,40,1
1731508801293,CHEM 6B,C07,784534,Stallings; Dontarie M,0,0,0,0
1731508801293,CHEM 6B,D01,784537,Stallings; Dontarie M,29,0,40,11
1731508801293,CHEM 6B,D02,784540,Stallings; Dontarie M,33,0,40,7
1731508801293,CHEM 6B,D03,784543,Stallings; Dontarie M,37,0,40,3
1731508801293,CHEM 6B,D04,784544,Stallings; Dontarie M,37,0,40,3
1731508801293,CHEM 6B,D05,784546,Stallings; Dontarie M,38,0,40,2
1731508801293,CHEM 6B,D06,784547,Stallings; Dontarie M,38,0,40,2
1731508801293,CHEM 6B,D07,784553,Stallings; Dontarie M,0,0,0,0
1731508801293,CHEM 6B,E01,784556,Young; Mark,40,0,40,0
1731508801293,CHEM 6B,E02,784557,Young; Mark,40,0,40,0
1731508801293,CHEM 6B,E03,784566,Young; Mark,40,0,40,0
1731508801293,CHEM 6B,E04,784568,Young; Mark,40,0,40,0
1731508801293,CHEM 6B,E05,784571,Young; Mark,40,0,40,0
1731508801293,CHEM 6B,E06,784572,Young; Mark,39,0,40,1
1731508801293,CHEM 6B,E07,784574,Young; Mark,0,0,0,0
1731508801293,CHEM 6B,F01,784578,Young; Mark,40,0,40,0
1731508801293,CHEM 6B,F02,784581,Young; Mark,40,0,40,0
1731508801293,CHEM 6B,F03,784582,Young; Mark,40,0,40,0
1731508801293,CHEM 6B,F04,784584,Young; Mark,40,0,40,0
1731508801293,CHEM 6B,F05,784585,Young; Mark,40,0,40,0
1731508801293,CHEM 6B,F06,784589,Young; Mark,40,0,40,0
1731508801293,CHEM 6B,F07,784591,Young; Mark,0,0,0,0
1731508801293,CHEM 6B,G01,785227,Schurmeier; Kimberly,35,0,40,5
1731508801293,CHEM 6B,G02,785228,Schurmeier; Kimberly,37,0,40,3
1731508801293,CHEM 6B,G03,785229,Schurmeier; Kimberly,35,0,40,5
1731508801293,CHEM 6B,G04,785230,Schurmeier; Kimberly,0,0,0,0
1731508801293,CHEM 6B,G05,785231,Schurmeier; Kimberly,39,0,40,1
1731508801293,CHEM 6B,G06,785233,Schurmeier; Kimberly,34,0,40,6
1731508801293,CHEM 6B,G07,785234,Schurmeier; Kimberly,39,0,40,1
1731508802326,CHEM 6BH,A01,785675,Yuen Zhou; Joel,49,0,50,1
1731508803357,CHEM 6C,A01,785073,Ternansky; Robert J.,40,0,40,0
1731508803357,CHEM 6C,A02,785074,Ternansky; Robert J.,37,0,40,3
1731508803357,CHEM 6C,A03,785148,Ternansky; Robert J.,38,0,40,2
1731508803357,CHEM 6C,A04,785155,Ternansky; Robert J.,40,0,40,0
1731508803357,CHEM 6C,A05,785158,Ternansky; Robert J.,0,0,0,0
1731508803357,CHEM 6C,A06,785159,Ternansky; Robert J.,36,0,40,4
1731508803357,CHEM 6C,A07,785160,Ternansky; Robert J.,40,0,40,0
1731508803357,CHEM 6C,B01,784597,Albizati; Kim F.,26,0,40,14
1731508803357,CHEM 6C,B02,784600,Albizati; Kim F.,38,0,40,2
1731508803357,CHEM 6C,B03,784603,Albizati; Kim F.,34,0,40,6
1731508803357,CHEM 6C,B04,784604,Albizati; Kim F.,34,0,40,6
1731508803357,CHEM 6C,B05,784606,Albizati; Kim F.,39,0,40,1
1731508803357,CHEM 6C,B06,784607,Albizati; Kim F.,38,0,40,2
1731508803357,CHEM 6C,B07,784610,Albizati; Kim F.,0,0,0,0
1731508804392,CHEM 7L,A01,734519,Leigh; Brian,24,0,24,0
1731508804392,CHEM 7L,A02,734520,Leigh; Brian,23,0,24,1
1731508804392,CHEM 7L,A03,734521,Leigh; Brian,24,0,24,0
1731508804392,CHEM 7L,A04,734522,Leigh; Brian,21,0,21,0
1731508804392,CHEM 7L,A05,734523,Leigh; Brian,22,0,24,2
1731508804392,CHEM 7L,A06,734524,Leigh; Brian,24,0,24,0
1731508804392,CHEM 7L,A07,734525,Leigh; Brian,23,0,24,1
1731508804392,CHEM 7L,A08,734526,Leigh; Brian,23,0,24,1
1731508804392,CHEM 7L,A09,734527,Leigh; Brian,23,0,24,1
1731508804392,CHEM 7L,A10,734528,Leigh; Brian,19,0,21,2
1731508804392,CHEM 7L,B01,734530,Leigh; Brian,14,0,24,10
1731508804392,CHEM 7L,B02,734531,Leigh; Brian,22,0,24,2
1731508804392,CHEM 7L,B03,734532,Leigh; Brian,24,0,24,0
1731508804392,CHEM 7L,B04,734533,Leigh; Brian,24,0,24,0
1731508804392,CHEM 7L,B05,734534,Leigh; Brian,24,0,24,0
1731508804392,CHEM 7L,B06,734535,Leigh; Brian,22,0,24,2
1731508804392,CHEM 7L,B07,734536,Leigh; Brian,20,0,21,1
1731508804392,CHEM 7L,B08,734537,Leigh; Brian,13,0,24,11
1731508804392,CHEM 7L,B09,734538,Leigh; Brian,21,0,24,3
1731508804392,CHEM 7L,B10,734539,Leigh; Brian,22,0,24,2
1731508804392,CHEM 7L,C01,734541,Leigh; Brian,21,0,24,3
1731508804392,CHEM 7L,C02,734542,Leigh; Brian,23,0,24,1
1731508804392,CHEM 7L,C03,734543,Leigh; Brian,23,0,24,1
1731508804392,CHEM 7L,C04,734624,Leigh; Brian,24,0,24,0
1731508804392,CHEM 7L,C05,734625,Leigh; Brian,20,0,24,4
1731508804392,CHEM 7L,C06,734626,Leigh; Brian,23,0,24,1
1731508804392,CHEM 7L,C07,734658,Leigh; Brian,21,0,24,3
1731508804392,CHEM 7L,C08,734668,Leigh; Brian,23,0,24,1
1731508804392,CHEM 7L,C09,734754,Leigh; Brian,24,0,24,0
1731508804392,CHEM 7L,C10,734758,Leigh; Brian,19,0,21,2
1731508805425,CHEM 11,A01,785161,Huang; Xuemei,36,0,40,4
1731508805425,CHEM 11,A02,785164,Huang; Xuemei,39,0,40,1
1731508805425,CHEM 11,A03,785168,Huang; Xuemei,39,0,40,1
1731508805425,CHEM 11,A04,785169,Huang; Xuemei,40,0,40,0
1731508805425,CHEM 11,A05,785175,Huang; Xuemei,39,0,40,1
1731508805425,CHEM 11,A06,785177,Huang; Xuemei,35,0,40,5
1731508805425,CHEM 11,A07,785178,Huang; Xuemei,39,0,40,1
1731508805425,CHEM 11,A08,785179,Huang; Xuemei,39,0,40,1
1731508806461,CHEM 40A,A01,784614,Cohen; Seth M,29,0,40,11
1731508806461,CHEM 40A,A02,784615,Cohen; Seth M,38,0,40,2
1731508806461,CHEM 40A,A03,784617,Cohen; Seth M,32,0,39,7
1731508806461,CHEM 40A,A04,784632,Cohen; Seth M,38,0,40,2
1731508806461,CHEM 40A,A05,784657,Cohen; Seth M,36,0,40,4
1731508806461,CHEM 40A,A06,784658,Cohen; Seth M,38,0,40,2
1731508806461,CHEM 40A,A07,784689,Cohen; Seth M,40,0,40,0
1731508806461,CHEM 40A,A08,784695,Cohen; Seth M,40,0,40,0
1731508807511,CHEM 40B,A01,785501,Weizman; Haim,38,0,40,2
1731508807511,CHEM 40B,A02,785503,Weizman; Haim,30,0,40,10
1731508807511,CHEM 40B,A03,785504,Weizman; Haim,25,0,40,15
1731508807511,CHEM 40B,A04,785505,Weizman; Haim,38,0,40,2
1731508807511,CHEM 40B,A05,785506,Weizman; Haim,39,0,40,1
1731508807511,CHEM 40B,A06,785507,Weizman; Haim,0,0,0,0
1731508807511,CHEM 40B,A07,798353,Weizman; Haim,35,0,40,5
1731508807511,CHEM 40B,A08,798354,Weizman; Haim,38,0,40,2
1731508807511,CHEM 40B,B01,785184,Romero; Erik Anthony,37,0,40,3
1731508807511,CHEM 40B,B02,785185,Romero; Erik Anthony,39,0,40,1
1731508807511,CHEM 40B,B03,785186,Romero; Erik Anthony,40,0,40,0
1731508807511,CHEM 40B,B04,785187,Romero; Erik Anthony,37,0,40,3
1731508807511,CHEM 40B,B05,785190,Romero; Erik Anthony,40,0,40,0
1731508807511,CHEM 40B,B06,785191,Romero; Erik Anthony,0,0,0,0
1731508807511,CHEM 40B,B07,795158,Romero; Erik Anthony,40,0,40,0
1731508807511,CHEM 40B,B08,795161,Romero; Erik Anthony,40,0,40,0
1731508807511,CHEM 40B,C01,785509,Pun; Andrew Brian,31,0,38,7
1731508807511,CHEM 40B,C02,785510,Pun; Andrew Brian,31,0,40,9
1731508807511,CHEM 40B,C03,785512,Pun; Andrew Brian,38,0,40,2
1731508807511,CHEM 40B,C04,785513,Pun; Andrew Brian,37,0,40,3
1731508807511,CHEM 40B,C05,785514,Pun; Andrew Brian,39,0,40,1
1731508807511,CHEM 40B,C06,785515,Pun; Andrew Brian,34,0,40,6
1731508807511,CHEM 40B,C07,795106,Pun; Andrew Brian,29,0,40,11
1731508807511,CHEM 40B,C08,795148,Pun; Andrew Brian,0,0,0,0
1731508808538,CHEM 41A,A01,785193,Yang; Jerry,35,0,36,1
1731508808538,CHEM 41A,A02,785220,Yang; Jerry,31,0,36,5
1731508808538,CHEM 41A,A03,785221,Yang; Jerry,35,0,37,2
1731508808538,CHEM 41A,A04,785222,Yang; Jerry,37,0,37,0
1731508809566,CHEM 41B,A01,785594,Theodorakis; Emmanuel,35,0,40,5
1731508809566,CHEM 41B,A02,785595,Theodorakis; Emmanuel,40,0,40,0
1731508809566,CHEM 41B,A03,785598,Theodorakis; Emmanuel,36,0,40,4
1731508809566,CHEM 41B,A04,785599,Theodorakis; Emmanuel,24,0,24,0
1731508809566,CHEM 41B,A05,785656,Theodorakis; Emmanuel,39,0,40,1
1731508809566,CHEM 41B,A06,785657,Theodorakis; Emmanuel,40,0,40,0
1731508809566,CHEM 41B,A07,785658,Theodorakis; Emmanuel,37,0,40,3
1731508810601,CHEM 43A,A01,734984,Figueroa; Joshua,13,0,24,11
1731508810601,CHEM 43A,A02,734985,Figueroa; Joshua,22,0,24,2
1731508810601,CHEM 43A,A03,734986,Figueroa; Joshua,24,0,24,0
1731508810601,CHEM 43A,A04,734987,Figueroa; Joshua,22,0,24,2
1731508810601,CHEM 43A,A05,734988,Figueroa; Joshua,0,0,0,0
1731508810601,CHEM 43A,A06,735039,Figueroa; Joshua,0,0,0,0
1731508810601,CHEM 43A,A07,735040,Figueroa; Joshua,0,0,0,0
1731508810601,CHEM 43A,A08,735130,Figueroa; Joshua,0,0,0,0
1731508810601,CHEM 43A,B01,735277,Tor; Yitzhak,0,0,24,24
1731508810601,CHEM 43A,B02,735279,Tor; Yitzhak,12,0,24,12
1731508810601,CHEM 43A,B03,735281,Tor; Yitzhak,19,0,24,5
1731508810601,CHEM 43A,B04,735282,Tor; Yitzhak,16,0,24,8
1731508810601,CHEM 43A,B05,735284,Tor; Yitzhak,0,0,0,0
1731508810601,CHEM 43A,B06,735288,Tor; Yitzhak,0,0,0,0
1731508810601,CHEM 43A,B07,735289,Tor; Yitzhak,0,0,0,0
1731508810601,CHEM 43A,B08,735290,Tor; Yitzhak,0,0,0,0
1731508810601,CHEM 43A,C01,735300,Klosterman; Jeremy K,0,0,0,0
1731508810601,CHEM 43A,C02,735304,Klosterman; Jeremy K,0,0,0,0
1731508810601,CHEM 43A,C03,735308,Klosterman; Jeremy K,0,0,0,0
1731508810601,CHEM 43A,C04,735312,Klosterman; Jeremy K,20,0,24,4
1731508810601,CHEM 43A,C05,735317,Klosterman; Jeremy K,23,0,24,1
1731508810601,CHEM 43A,C06,735319,Klosterman; Jeremy K,24,0,24,0
1731508810601,CHEM 43A,C07,735320,Klosterman; Jeremy K,16,0,17,1
1731508810601,CHEM 43A,C08,735331,Klosterman; Jeremy K,24,0,24,0
1731508811633,CHEM 100A,A01,735347,Slade; Jonathan,19,0,23,4
1731508811633,CHEM 100A,A02,735632,Slade; Jonathan,21,0,24,3
1731508811633,CHEM 100A,A03,735636,Slade; Jonathan,19,0,23,4
1731508811633,CHEM 100A,A04,735637,Slade; Jonathan,21,0,24,3
1731508811633,CHEM 100A,A05,735638,Slade; Jonathan,19,0,24,5
1731508811633,CHEM 100A,A06,735639,Slade; Jonathan,22,0,23,1
1731508812662,CHEM 100B,A01,735649,Pomeroy; Robert S.,18,0,26,8
1731508813692,CHEM 105A,A01,735653,Sinha; Amitabha,31,0,42,11
1731508814722,CHEM 108,A01,735655,Jennings; Patricia A.,9,0,20,11
1731508814722,CHEM 108,A02,735658,Jennings; Patricia A.,23,0,24,1
1731508814722,CHEM 108,B01,735663,Jennings; Patricia A.,13,0,20,7
1731508814722,CHEM 108,B02,735666,Jennings; Patricia A.,21,0,24,3
1731508815756,CHEM 109,A01,735680,Piercy; Marc Anthony,6,0,20,14
1731508815756,CHEM 109,A02,735689,Piercy; Marc Anthony,19,0,24,5
1731508815756,CHEM 109,B01,735768,Piercy; Marc Anthony,17,0,20,3
1731508815756,CHEM 109,B02,735769,Piercy; Marc Anthony,23,0,24,1
1731508816785,CHEM 114A,A01,784696,Komor; Alexis C,39,0,40,1
1731508816785,CHEM 114A,A02,784723,Komor; Alexis C,38,0,40,2
1731508816785,CHEM 114A,A03,784725,Komor; Alexis C,38,0,40,2
1731508817820,CHEM 114B,A01,785242,Budin; Itay,26,0,40,14
1731508817820,CHEM 114B,A02,785299,Budin; Itay,40,0,40,0
1731508817820,CHEM 114B,A03,785306,Budin; Itay,37,0,40,3
1731508817820,CHEM 114B,A04,785309,Budin; Itay,39,0,40,1
1731508817820,CHEM 114B,B01,785313,Ghosh; Partho,39,0,40,1
1731508817820,CHEM 114B,B02,785375,Ghosh; Partho,38,0,40,2
1731508817820,CHEM 114B,B03,785407,Ghosh; Partho,40,0,40,0
1731508817820,CHEM 114B,B04,785410,Ghosh; Partho,40,0,40,0
1731508818847,CHEM 115,A00,735864,Komor; Alexis C,1,0,30,29
1731508819880,CHEM 120A,A01,785412,Stauber; Julia Megan,28,0,40,12
1731508819880,CHEM 120A,A02,785415,Stauber; Julia Megan,37,0,40,3
1731508819880,CHEM 120A,A03,785417,Stauber; Julia Megan,39,0,39,0
1731508819880,CHEM 120A,A04,785423,Stauber; Julia Megan,38,0,39,1
1731508820909,CHEM 126A,A01,784731,Yong; Haiwang,39,0,40,1
1731508820909,CHEM 126A,A02,784732,Yong; Haiwang,38,0,40,2
1731508820909,CHEM 126A,A03,784737,Yong; Haiwang,38,0,40,2
1731508821943,CHEM 126B,A01,785659,Tauber; Michael,14,0,40,26
1731508821943,CHEM 126B,A02,785664,Tauber; Michael,32,0,40,8
1731508821943,CHEM 126B,A03,785665,Tauber; Michael,20,0,40,20
1731508821943,CHEM 126B,A04,785668,Tauber; Michael,39,0,40,1
1731508821943,CHEM 126B,A05,785669,Tauber; Michael,35,0,40,5
1731508821943,CHEM 126B,A06,785671,Tauber; Michael,33,0,40,7
1731508822978,CHEM 131,A01,785425,Galperin; Michael,37,0,40,3
1731508822978,CHEM 131,A02,785499,Galperin; Michael,38,0,40,2
1731508822978,CHEM 131,A03,785500,Galperin; Michael,39,0,40,1
1731508824007,CHEM 134,A00,735869,Pokorski; Jonathan Kyle,16,0,18,2
1731508825040,CHEM 143B,A01,735871,Weizman; Haim,21,0,24,3
1731508825040,CHEM 143B,A02,735872,Weizman; Haim,20,0,24,4
1731508825040,CHEM 143B,A03,735914,Weizman; Haim,11,0,24,13
1731508825040,CHEM 143B,A04,735916,Weizman; Haim,0,0,0,0
1731508825040,CHEM 143B,A05,735918,Weizman; Haim,0,0,0,0
1731508826067,CHEM 151,A00,735919,Donoghue; Daniel J.,86,0,100,14
1731508827093,CHEM 154,A00,735922,Romero; Nathan A & Schmidt; Valerie A,29,0,30,1
1731508828122,CHEM 155,A00,735925,Theodorakis; Emmanuel,10,0,10,0
1731508829155,CHEM 168,A01,785516,Devaraj; Neal Krishna,39,0,40,1
1731508829155,CHEM 168,A02,785551,Devaraj; Neal Krishna,39,0,40,1
1731508829155,CHEM 168,A03,785554,Devaraj; Neal Krishna,37,0,40,3
1731508829155,CHEM 168,A04,785557,Devaraj; Neal Krishna,37,0,40,3
1731508829155,CHEM 168,A05,785559,Devaraj; Neal Krishna,34,0,40,6
1731508829155,CHEM 168,A06,785566,Devaraj; Neal Krishna,36,0,40,4
1731508830181,CHEM 169,A00,794456,Jinich; Adrian,48,0,50,2
1731508831206,CHEM 172,A01,785676,Pomeroy; Robert S.,46,0,50,4
1731508832234,CHEM 187,A00,735955,Brydges; Stacey,19,0,20,1
1731508833259,CHEM 194,A00,735956,Newsam; John,13,0,18,5
1731508834285,CHEM 200B,A00,735957,Pomeroy; Robert S.,8,0,20,12
1731508835315,CHEM 212,A00,735958,Budin; Itay,14,0,30,16
1731508836345,CHEM 213B,A00,735990,Debelouchina; Galia T,32,0,50,18
1731508837371,CHEM 215,A00,735991,Komor; Alexis C,12,0,30,18
1731508838398,CHEM 219C,A00,735992,Jennings; Patricia A.,9,0,15,6
1731508839426,CHEM 223,A00,735993,Oconnor; Joseph M.,25,0,30,5
1731508840454,CHEM 227,A00,735994,Stauber; Julia Megan,28,0,30,2
1731508841481,CHEM 229,A00,735995,Cohen; Seth M,15,0,20,5
1731508842512,CHEM 232A,A00,735996,Yuen Zhou; Joel,13,0,15,2
1731508843545,CHEM 254,A00,735997,Romero; Nathan A & Schmidt; Valerie A,27,0,30,3
1731508844575,CHEM 255,A00,735998,Theodorakis; Emmanuel,18,0,20,2
1731508845605,CHEM 269,A00,794455,Jinich; Adrian,8,0,25,17
1731508846632,CHEM 291,A00,735999,Debelouchina; Galia T,30,0,30,0
1731508847658,CHEM 294,A00,736000,Romero; Nathan A,48,0,50,2
1731508848685,CHIN 10BD,A01,736053,Liu; Mingming,16,0,16,0
1731508848685,CHIN 10BD,A02,736054,Liu; Mingming,16,0,16,0
1731508849710,CHIN 10BM,A01,736056,Chen; Pei-Chia,18,0,20,2
1731508849710,CHIN 10BM,A02,736057,Chen; Pei-Chia,14,0,15,1
1731508850740,CHIN 10BN,A01,736063,Xu; Li,13,0,13,0
1731508850740,CHIN 10BN,A02,736064,Xu; Li,11,0,13,2
1731508850740,CHIN 10BN,B01,736084,Xu; Li,10,0,13,3
1731508850740,CHIN 10BN,B02,736097,Xu; Li,12,0,13,1
1731508850740,CHIN 10BN,C01,736345,Xu; Li,9,0,13,4
1731508850740,CHIN 10BN,C02,736346,Xu; Li,0,0,0,0
1731508851766,CHIN 20BD,A01,795569,Liu; Mingming,14,0,14,0
1731508851766,CHIN 20BD,A02,795570,Liu; Mingming,14,0,14,0
1731508852802,CHIN 20BM,A01,736414,Wang; Xiao,15,0,16,1
1731508852802,CHIN 20BM,A02,736421,Wang; Xiao,16,0,16,0
1731508853837,CHIN 20BN,A01,736427,Anderson; Qin-Hong,13,0,14,1
1731508853837,CHIN 20BN,A02,736430,Anderson; Qin-Hong,13,0,14,1
1731508853837,CHIN 20BN,B01,736434,Anderson; Qin-Hong,0,0,0,0
1731508853837,CHIN 20BN,B02,736440,Anderson; Qin-Hong,0,0,0,0
1731508854867,CHIN 100BM,A00,736443,Wang; Xiao,20,0,20,0
1731508855894,CHIN 100BN,A00,736444,Chen; Pei-Chia,20,0,21,1
1731508856920,CHIN 169A,A00,736447,Wang; Xiao,20,0,20,0
1731508857950,CHIN 182A,A00,736468,Liu; Mingming,19,0,20,1
1731508858978,CLAS 87,A00,736801,Herbst; Matthew,20,0,20,0
1731508860008,CLIN 227A,A01,799589,Gold; Jeffrey Joseph,20,0,20,0
1731508861038,CLIN 227B,A00,799590,Gold; Jeffrey Joseph,20,0,20,0
1731508862069,CLIN 228,A01,799594,Gold; Jeffrey Joseph,20,0,20,0
1731508863097,CLIN 294B,A00,799595,Thomas; Kelsey Rae,10,0,10,0
1731508864130,CLIN 296,001,799596,Brookman; Lauren Irene,100,0,100,0
1731508864130,CLIN 296,002,799597,Brookman; Lauren Irene,10,0,10,0
1731508865212,CLRE 236R,A00,736762,Mehta; Ravindra L.,9994,0,9999,5
1731508866238,CLRE 237,A00,736763,Morris; Sheldon,9994,0,9999,5
1731508867269,CLRE 250R,A01,736787,Graves; Jennifer Sharon Ol,9999,0,9999,0
1731508868298,CLRE 251R,A00,795042,Mehta; Ravindra L.,9999,0,9999,0
1731508869324,CLRE 253,A00,736792,Vaida; Florin,9998,0,9999,1
1731508870355,CLRE 259,A00,736793,Patel; Hemal,9996,0,9999,3
1731508871383,CLRE 260,A00,736795,Cuomo; Raphael Eduardo,9996,0,9999,3
1731508871383,CLRE 260,B00,800937,Cuomo; Raphael Eduardo,9999,0,9999,0
1731508872409,CLRE 267,A00,795044,Vaida; Florin,9995,0,9999,4
1731508873435,CLRE 295B,A00,736798,Cuomo; Raphael Eduardo,9999,0,9999,0
1731508874460,CLRE 297,001,736799,Cuomo; Raphael Eduardo,9999,0,9999,0
1731508875489,CMM 246,A00,796595,Gordts; Philip & Lewis; Amanda Lark & Godula; Kamil & Gagneux; Pascal & Esko; Jeffrey D. & Bode; Lars,10,0,10,0
1731508876519,COGR 200B,A00,738801,Cordoba Azcarate; Matilde,5,0,5,0
1731508877545,COGR 200C,A00,738803,Geiger; Richard Stuart,5,0,5,0
1731508878578,COGR 201J,A00,738804,Hallin; Daniel C,8,0,10,2
1731508879605,COGR 225C,A00,738805,McKenzie; Kerry V.,4,0,5,1
1731508880638,COGR 225D,A00,738806,Lampland; Martha,5,0,5,0
1731508881668,COGR 237,A00,738807,Anderson; Patrick W.,3,0,10,7
1731508882697,COGR 275,A00,738808,Dominguez Rubio; Fernando,10,0,10,0
1731508883726,COGS 1,A01,737008,Kiyonaga; Anastasia,55,0,62,7
1731508883726,COGS 1,A02,737010,Kiyonaga; Anastasia,62,0,65,3
1731508883726,COGS 1,A03,737011,Kiyonaga; Anastasia,65,0,66,1
1731508883726,COGS 1,A04,737014,Kiyonaga; Anastasia,56,0,56,0
1731508883726,COGS 1,A05,737015,Kiyonaga; Anastasia,56,0,56,0
1731508883726,COGS 1,A06,737016,Kiyonaga; Anastasia,50,0,56,6
1731508883726,COGS 1,A07,737018,Kiyonaga; Anastasia,55,0,56,1
1731508884757,COGS 9,A01,737025,Staff,55,0,56,1
1731508884757,COGS 9,A02,737028,Staff,54,0,56,2
1731508884757,COGS 9,A03,737029,Staff,55,0,56,1
1731508884757,COGS 9,A04,737030,Staff,53,0,56,3
1731508884757,COGS 9,A05,737031,Staff,54,0,56,2
1731508884757,COGS 9,A06,737033,Staff,45,0,48,3
1731508885789,COGS 10,A01,737044,Morgan; Eric,48,0,56,8
1731508885789,COGS 10,A02,737045,Morgan; Eric,51,0,58,7
1731508885789,COGS 10,A03,737047,Morgan; Eric,52,0,56,4
1731508885789,COGS 10,A04,737049,Morgan; Eric,53,0,56,3
1731508885789,COGS 10,A05,737050,Morgan; Eric,51,0,52,1
1731508885789,COGS 10,A06,737051,Morgan; Eric,48,0,50,2
1731508886826,COGS 11,A01,737077,Boyle; Mary E. T.,46,0,50,4
1731508886826,COGS 11,A02,737078,Boyle; Mary E. T.,50,0,50,0
1731508886826,COGS 11,A03,737135,Boyle; Mary E. T.,44,0,47,3
1731508887855,COGS 13,A01,737138,Staff,63,0,65,2
1731508887855,COGS 13,A02,737139,Staff,53,0,56,3
1731508887855,COGS 13,A03,737142,Staff,54,0,56,2
1731508887855,COGS 13,A04,737144,Staff,56,0,56,0
1731508887855,COGS 13,A05,737145,Staff,53,0,56,3
1731508887855,COGS 13,A06,737148,Staff,56,0,56,0
1731508887855,COGS 13,A07,737149,Staff,65,0,65,0
1731508888881,COGS 14A,A01,737151,Barrera; Steven James,57,0,60,3
1731508888881,COGS 14A,A02,737152,Barrera; Steven James,55,0,60,5
1731508888881,COGS 14A,A03,737153,Barrera; Steven James,59,0,60,1
1731508888881,COGS 14A,A04,737154,Barrera; Steven James,58,0,60,2
1731508888881,COGS 14A,A05,737155,Barrera; Steven James,59,0,60,1
1731508889914,COGS 14B,A01,737157,Hoffman; Drew Ellen,46,0,50,4
1731508889914,COGS 14B,A02,737158,Hoffman; Drew Ellen,48,0,50,2
1731508889914,COGS 14B,A03,737159,Hoffman; Drew Ellen,48,0,50,2
1731508889914,COGS 14B,A04,737160,Hoffman; Drew Ellen,49,0,50,1
1731508889914,COGS 14B,A05,737189,Hoffman; Drew Ellen,50,0,50,0
1731508890943,COGS 17,A01,737193,Johnson; Christine M.,56,0,60,4
1731508890943,COGS 17,A02,737200,Johnson; Christine M.,57,0,60,3
1731508890943,COGS 17,A03,737210,Johnson; Christine M.,57,0,60,3
1731508890943,COGS 17,A04,737211,Johnson; Christine M.,59,0,60,1
1731508890943,COGS 17,A05,737234,Johnson; Christine M.,57,0,60,3
1731508890943,COGS 17,A06,737237,Johnson; Christine M.,58,0,60,2
1731508891972,COGS 18,A01,737254,Morgan; Eric,32,0,35,3
1731508891972,COGS 18,A02,737255,Morgan; Eric,33,0,35,2
1731508891972,COGS 18,A03,737256,Morgan; Eric,31,0,35,4
1731508891972,COGS 18,A04,737257,Morgan; Eric,31,0,35,4
1731508891972,COGS 18,A05,737264,Morgan; Eric,28,0,35,7
1731508891972,COGS 18,A06,737265,Morgan; Eric,32,0,35,3
1731508891972,COGS 18,A07,737288,Morgan; Eric,32,0,35,3
1731508891972,COGS 18,A08,737333,Morgan; Eric,35,0,35,0
1731508891972,COGS 18,A09,737334,Morgan; Eric,33,0,35,2
1731508893001,COGS 87,A00,737335,Deak; Gedeon O.,19,0,20,1
1731508894032,COGS 100,A01,737386,Allen; Michael Gordon,49,0,56,7
1731508894032,COGS 100,A02,737387,Allen; Michael Gordon,56,0,56,0
1731508894032,COGS 100,A03,737390,Allen; Michael Gordon,55,0,56,1
1731508894032,COGS 100,A04,737392,Allen; Michael Gordon,55,0,56,1
1731508894032,COGS 100,A05,737393,Allen; Michael Gordon,58,0,61,3
1731508894032,COGS 100,A06,737394,Allen; Michael Gordon,65,0,65,0
1731508895059,COGS 101A,A01,737396,Barrera; Steven James,57,0,61,4
1731508895059,COGS 101A,A02,737399,Barrera; Steven James,61,0,65,4
1731508895059,COGS 101A,A03,737400,Barrera; Steven James,53,0,56,3
1731508895059,COGS 101A,A04,737401,Barrera; Steven James,53,0,56,3
1731508895059,COGS 101A,A05,737404,Barrera; Steven James,54,0,56,2
1731508895059,COGS 101A,A06,737405,Barrera; Steven James,56,0,56,0
1731508896086,COGS 101B,A01,737408,Allen; Michael Gordon,46,0,50,4
1731508896086,COGS 101B,A02,737412,Allen; Michael Gordon,49,0,50,1
1731508896086,COGS 101B,A03,737413,Allen; Michael Gordon,49,0,50,1
1731508896086,COGS 101B,A04,737414,Allen; Michael Gordon,50,0,50,0
1731508896086,COGS 101B,A05,737415,Allen; Michael Gordon,49,0,50,1
1731508896086,COGS 101B,A06,737417,Allen; Michael Gordon,50,0,50,0
1731508897116,COGS 107A,A01,737419,Boyle; Mary E. T.,51,0,56,5
1731508897116,COGS 107A,A02,737421,Boyle; Mary E. T.,44,0,56,12
1731508897116,COGS 107A,A03,737423,Boyle; Mary E. T.,43,0,56,13
1731508897116,COGS 107A,A04,737424,Boyle; Mary E. T.,49,0,56,7
1731508897116,COGS 107A,A05,737425,Boyle; Mary E. T.,50,0,56,6
1731508897116,COGS 107A,A06,737426,Boyle; Mary E. T.,56,0,65,9
1731508897116,COGS 107A,A07,737429,Boyle; Mary E. T.,51,0,65,14
1731508898143,COGS 107B,A01,737431,Mooshagian; Eric Frederick,49,0,50,1
1731508898143,COGS 107B,A02,737435,Mooshagian; Eric Frederick,49,0,50,1
1731508898143,COGS 107B,A03,737436,Mooshagian; Eric Frederick,55,0,65,10
1731508898143,COGS 107B,A04,737438,Mooshagian; Eric Frederick,61,0,63,2
1731508898143,COGS 107B,A05,737439,Mooshagian; Eric Frederick,47,0,50,3
1731508898143,COGS 107B,A06,737440,Mooshagian; Eric Frederick,50,0,50,0
1731508899174,COGS 108,A01,737442,Ellis; Shannon Elizabeth,46,0,56,10
1731508899174,COGS 108,A02,737447,Ellis; Shannon Elizabeth,52,0,56,4
1731508899174,COGS 108,A03,737450,Ellis; Shannon Elizabeth,54,0,56,2
1731508899174,COGS 108,A04,737451,Ellis; Shannon Elizabeth,52,0,56,4
1731508899174,COGS 108,A05,737452,Ellis; Shannon Elizabeth,52,0,56,4
1731508899174,COGS 108,A06,737454,Ellis; Shannon Elizabeth,59,0,65,6
1731508899174,COGS 108,A07,737455,Ellis; Shannon Elizabeth,61,0,65,4
1731508899174,COGS 108,B01,737457,Ellis; Shannon Elizabeth,47,0,56,9
1731508899174,COGS 108,B02,737459,Ellis; Shannon Elizabeth,48,0,56,8
1731508899174,COGS 108,B03,737460,Ellis; Shannon Elizabeth,47,0,56,9
1731508899174,COGS 108,B04,737461,Ellis; Shannon Elizabeth,41,0,56,15
1731508899174,COGS 108,B05,737462,Ellis; Shannon Elizabeth,35,0,56,21
1731508899174,COGS 108,B06,737471,Ellis; Shannon Elizabeth,62,0,65,3
1731508899174,COGS 108,B07,737472,Ellis; Shannon Elizabeth,64,0,65,1
1731508900206,COGS 109,A01,737475,Staff,34,0,35,1
1731508900206,COGS 109,A02,737476,Staff,33,0,35,2
1731508900206,COGS 109,A03,737477,Staff,35,0,35,0
1731508900206,COGS 109,A04,737478,Staff,31,0,35,4
1731508901232,COGS 111,A01,737480,Hoffman; Drew Ellen,49,0,50,1
1731508901232,COGS 111,A02,737482,Hoffman; Drew Ellen,49,0,50,1
1731508901232,COGS 111,A03,737483,Hoffman; Drew Ellen,49,0,50,1
1731508901232,COGS 111,A04,737485,Hoffman; Drew Ellen,45,0,50,5
1731508902260,COGS 115,A01,737487,Deak; Gedeon O.,52,0,60,8
1731508903286,COGS 116,A01,737490,Greene; Deanna Jacquelyn,42,0,49,7
1731508903286,COGS 116,A02,737491,Greene; Deanna Jacquelyn,45,0,49,4
1731508904315,COGS 118C,A01,737493,Mukamel; Eran A,47,0,75,28
1731508905343,COGS 120,A01,737503,Xia; Haijun,44,0,50,6
1731508905343,COGS 120,A02,737763,Xia; Haijun,40,0,50,10
1731508905343,COGS 120,A03,737765,Xia; Haijun,50,0,50,0
1731508905343,COGS 120,A04,737766,Xia; Haijun,44,0,50,6
1731508905343,COGS 120,A05,737775,Xia; Haijun,50,0,50,0
1731508905343,COGS 120,A06,737781,Xia; Haijun,37,0,50,13
1731508906369,COGS 122,A01,737787,Dow; Steven P,0,0,0,5
1731508907394,COGS 126,A01,737795,Hollan; James D.,47,0,50,3
1731508908423,COGS 127,A01,737801,Guo; Philip J,46,0,50,4
1731508908423,COGS 127,A02,737805,Guo; Philip J,41,0,50,9
1731508908423,COGS 127,A03,737806,Guo; Philip J,44,0,50,6
1731508908423,COGS 127,A04,737811,Guo; Philip J,40,0,50,10
1731508908423,COGS 127,A05,737818,Guo; Philip J,3,0,50,47
1731508909454,COGS 144,A01,737824,Rossano; Federico,48,0,50,2
1731508910481,COGS 153,A00,737829,Staff,138,0,149,11
1731508911508,COGS 155,A01,737836,Cooperrider; Kensy A,48,0,50,2
1731508912534,COGS 156,A01,737841,Creel; Sarah,69,0,75,6
1731508913565,COGS 160,A00,737849,Kirsh; David Joel,25,0,25,0
1731508913565,COGS 160,B00,796034,Beatty-Martinez; Anne,74,0,75,1
1731508913565,COGS 160,C00,796035,Staff,149,0,149,0
1731508914592,COGS 164,A01,737961,Chiba; Andrea,40,0,45,5
1731508914592,COGS 164,A02,796040,Chiba; Andrea,28,0,45,17
1731508915618,COGS 177,A00,737964,Staff,110,0,120,10
1731508916720,COGS 181,A01,796038,Tu; Zhuowen,37,0,50,13
1731508916720,COGS 181,A02,796039,Tu; Zhuowen,31,0,50,19
1731508917746,COGS 187B,A01,737972,Kirsh; David Joel,47,0,50,3
1731508917746,COGS 187B,A02,738380,Kirsh; David Joel,17,0,50,33
1731508918771,COGS 188,A01,738029,Fleischer; Jason G,39,0,60,21
1731508918771,COGS 188,A02,738030,Fleischer; Jason G,56,0,60,4
1731508919801,COGS 189,A00,738031,De Sa; Virginia,165,0,200,35
1731508920829,COGS 190B,:00,796056,Staff,20,0,20,0
1731508920829,COGS 190B,A00,738176,Chiba; Andrea,9999,0,9999,0
1731508920829,COGS 190B,B00,738177,Fleischer; Jason G,20,0,20,0
1731508920829,COGS 190B,C00,738258,Hoffman; Drew Ellen,20,0,20,0
1731508920829,COGS 190B,D00,738259,Voytek; Bradley Thomas,20,0,20,0
1731508920829,COGS 190B,E00,738272,Kirsh; David Joel,20,0,20,0
1731508920829,COGS 190B,F00,738287,Kiyonaga; Anastasia,20,0,20,0
1731508920829,COGS 190B,G00,796051,Beatty-Martinez; Anne,20,0,20,0
1731508920829,COGS 190B,H00,796052,Nitz; Douglas A.,20,0,20,0
1731508920829,COGS 190B,I00,796053,De Sa; Virginia,20,0,20,0
1731508920829,COGS 190B,J00,796054,Rangel; Lara M,20,0,20,0
1731508920829,COGS 190B,K00,796055,Boyle; Mary E. T.,20,0,20,0
1731508920829,COGS 190B,L00,796058,Jernigan; Terry Lynne,20,0,20,0
1731508920829,COGS 190B,M00,796059,Deak; Gedeon O.,20,0,20,0
1731508920829,COGS 190B,N00,796060,Tu; Zhuowen,20,0,20,0
1731508920829,COGS 190B,O00,796061,Creel; Sarah,20,0,20,0
1731508921859,COGS 194,A00,738288,Hill; Seth J,9999,0,9999,0
1731508922887,COGS 198,001,738361,Voytek; Bradley Thomas,20,0,20,0
1731508923914,COGS 205,A00,738365,Chiba; Andrea,17,0,20,3
1731508924951,COGS 210B,001,736818,Nitz; Douglas A.,9998,0,9999,1
1731508924951,COGS 210B,002,736819,Xia; Haijun,9999,0,9999,0
1731508924951,COGS 210B,003,736820,Bergen; Benjamin,9998,0,9999,1
1731508924951,COGS 210B,004,736822,Kirsh; David Joel,9999,0,9999,0
1731508924951,COGS 210B,005,736824,Rangel; Lara M,9998,0,9999,1
1731508924951,COGS 210B,006,736825,Rossano; Federico,9999,0,9999,0
1731508924951,COGS 210B,007,736826,Guo; Philip J,9999,0,9999,0
1731508924951,COGS 210B,008,736829,De Sa; Virginia,9999,0,9999,0
1731508924951,COGS 210B,009,796069,Greene; Deanna Jacquelyn,9999,0,9999,0
1731508924951,COGS 210B,010,796070,Hollan; James D.,9999,0,9999,0
1731508924951,COGS 210B,011,796071,Kiyonaga; Anastasia,9999,0,9999,0
1731508924951,COGS 210B,012,796073,Coulson; Seana M,9999,0,9999,0
1731508924951,COGS 210B,013,796074,Dow; Steven P,9999,0,9999,0
1731508925978,COGS 211B,A00,736830,Coulson; Seana M,17,0,20,3
1731508927006,COGS 219,A01,736835,Zettersten; Martin,0,0,0,17
1731508928034,COGS 223,A00,736836,Dow; Steven P,18,0,25,7
1731508929060,COGS 229,A00,736842,Vaccaro; Kristen Marie,9,0,10,1
1731508930085,COGS 260,A00,736843,Kiyonaga; Anastasia,16,0,25,9
1731508931116,COMM 10,A01,738505,Armenta; John E,21,0,25,4
1731508931116,COMM 10,A02,738683,Armenta; John E,21,0,25,4
1731508931116,COMM 10,A03,738685,Armenta; John E,18,0,25,7
1731508931116,COMM 10,A04,738686,Armenta; John E,23,0,25,2
1731508931116,COMM 10,A05,738687,Armenta; John E,23,0,25,2
1731508931116,COMM 10,A06,738688,Armenta; John E,23,0,25,2
1731508931116,COMM 10,A07,738689,Armenta; John E,25,0,25,0
1731508931116,COMM 10,A08,738690,Armenta; John E,25,0,25,0
1731508931116,COMM 10,A09,738691,Armenta; John E,25,0,25,0
1731508931116,COMM 10,A10,738693,Armenta; John E,25,0,25,0
1731508931116,COMM 10,A11,738694,Armenta; John E,25,0,25,0
1731508931116,COMM 10,A12,738695,Armenta; John E,24,0,25,1
1731508932141,COMM 20,A01,738704,McKenna; Denise,73,0,75,2
1731508933170,COMM 30,A00,738705,Schmidt; Thomas Rainer,72,0,75,3
1731508934194,COMM 50,A00,738706,Armenta; John E,24,0,25,1
1731508935221,COMM 80,A01,738710,Campbell; Robert Harold,79,0,80,1
1731508936251,COMM 87,A00,795241,Serlin; David,20,0,20,0
1731508937279,COMM 100C,A01,738712,Dewaard; Andrew Michael,22,0,25,3
1731508937279,COMM 100C,A02,738713,Dewaard; Andrew Michael,25,0,25,0
1731508937279,COMM 100C,A03,738714,Dewaard; Andrew Michael,22,0,25,3
1731508937279,COMM 100C,A04,738715,Dewaard; Andrew Michael,21,0,25,4
1731508937279,COMM 100C,A05,738716,Dewaard; Andrew Michael,24,0,25,1
1731508937279,COMM 100C,A06,738718,Dewaard; Andrew Michael,23,0,25,2
1731508937279,COMM 100C,A07,738720,Dewaard; Andrew Michael,24,0,25,1
1731508937279,COMM 100C,A09,738724,Dewaard; Andrew Michael,24,0,25,1
1731508937279,COMM 100C,A11,738726,Dewaard; Andrew Michael,24,0,25,1
1731508937279,COMM 100C,A12,738727,Dewaard; Andrew Michael,24,0,25,1
1731508938307,COMM 101,A01,738730,Ahn; Patricia Jeehyun,14,0,15,1
1731508938307,COMM 101,A02,738731,Ahn; Patricia Jeehyun,15,0,15,0
1731508938307,COMM 101,A03,738732,Ahn; Patricia Jeehyun,12,0,15,3
1731508938307,COMM 101,A04,738733,Ahn; Patricia Jeehyun,13,0,15,2
1731508939337,COMM 101D,A00,738737,Martinico; Daniel J,16,0,16,0
1731508940368,COMM 101K,A00,738743,Ahn; Patricia Jeehyun,13,0,16,3
1731508941395,COMM 101N,A00,738746,Martinico; Daniel J,16,0,16,0
1731508942426,COMM 101T,A00,738749,Halm; Gavin Patrick,14,0,18,4
1731508942426,COMM 101T,B00,738752,Halm; Gavin Patrick,18,0,18,0
1731508942426,COMM 101T,C00,795163,Dewey; Matthew D,10,0,10,0
1731508943452,COMM 102B,A01,738754,Peacher; Amanda M,8,0,9,1
1731508943452,COMM 102B,A02,738755,Peacher; Amanda M,9,0,9,0
1731508944482,COMM 102C,A01,738757,Campion; Camille E,3,0,6,3
1731508944482,COMM 102C,A02,738758,Campion; Camille E,6,0,6,0
1731508944482,COMM 102C,A03,738759,Campion; Camille E,6,0,6,0
1731508945511,COMM 103D,A00,799575,Davis; Zeinabu I.,30,0,30,0
1731508946539,COMM 103E,A00,738763,Dewey; Matthew D,29,0,30,1
1731508947568,COMM 106,A00,738764,Kidman; Shawna F,138,0,140,2
1731508948594,COMM 106M,A00,738765,Whitworth-Smith; Andrew C,67,0,75,8
1731508949621,COMM 106N,A00,738766,Schmidt; Thomas Rainer,21,0,30,9
1731508950646,COMM 107,A00,738767,Serlin; David,30,0,30,0
1731508951672,COMM 111A,A00,738769,Pavon Aramburu; Maria Laur,29,0,30,1
1731508952697,COMM 111B,A00,738770,Zilberg; Elana,38,0,40,2
1731508953725,COMM 111P,A00,738771,Ruskiewicz; Eva Marie,29,0,30,1
1731508954751,COMM 113T,A00,738774,Abuelhiga; Soraya Jill,28,0,30,2
1731508954751,COMM 113T,B00,738775,Fields; Gary,30,0,30,0
1731508954751,COMM 113T,C00,738776,McKenna; Denise,29,0,30,1
1731508955776,COMM 114I,A00,738780,Leuning; Grant Maurstad,30,0,30,0
1731508956802,COMM 114T,A00,738781,Walkover; Lillian B,29,0,30,1
1731508957827,COMM 120M,A00,738783,Lazitski Torres; Olga,30,0,30,0
1731508958856,COMM 124A,A00,738784,Irani; Lilly C,73,0,75,2
1731508959884,COMM 134,A00,738785,Kidman; Shawna F,29,0,30,1
1731508961940,COMM 138,A00,738786,Boateng; Boatema,30,0,30,0
1731508962969,COMM 145,A00,738788,Rojo Solis; Juan Jose,29,0,30,1
1731508964000,COMM 146,A00,738789,Ybarra; Megan,28,0,30,2
1731508965026,COMM 156,A00,738791,Staff,30,0,30,0
1731508966053,COMM 159,A00,738792,Cordoba Azcarate; Matilde,23,0,30,7
1731508967081,COMM 164,A00,738793,Dominguez Rubio; Fernando,25,0,25,0
1731508968105,COMM 177,A00,795164,Rojo Solis; Juan Jose,25,0,25,0
1731508969133,COMM 190,A00,738795,Boateng; Boatema,23,0,23,0
1731508969133,COMM 190,B00,738797,Staff,19,0,23,4
1731508969133,COMM 190,C00,738798,Wiering; Liesbeth,21,0,23,2
1731508970162,COMM 194,A00,770727,Hill; Seth J,9999,0,9999,0
1731508971188,COMM 196B,A00,738800,Dewaard; Andrew Michael,10,0,10,0
1731508972222,CSE 8A,A50,738815,Alvarado; Christine J.,39,0,40,1
1731508972222,CSE 8A,A51,738819,Alvarado; Christine J.,40,0,40,0
1731508972222,CSE 8A,A52,738823,Alvarado; Christine J.,40,0,40,0
1731508972222,CSE 8A,A53,738825,Alvarado; Christine J.,35,0,40,5
1731508972222,CSE 8A,A54,738826,Alvarado; Christine J.,37,0,40,3
1731508972222,CSE 8A,A55,799488,Alvarado; Christine J.,0,0,0,0
1731508973249,CSE 8B,A01,788635,Ochoa; Benjamin Lawrence,59,0,70,11
1731508974278,CSE 11,A01,788660,Cao; Yingjun,161,0,175,14
1731508975309,CSE 12,A01,788668,Cao; Yingjun,25,0,50,25
1731508976341,CSE 20,A01,786527,Jones; Miles E,18,0,25,7
1731508976341,CSE 20,A02,786528,Jones; Miles E,19,0,25,6
1731508977368,CSE 21,A01,786539,Jones; Miles E,46,0,50,4
1731508977368,CSE 21,A02,786540,Jones; Miles E,49,0,50,1
1731508978406,CSE 29,A50,738835,Soosai Raj; Adalbert Geral,0,0,5,5
1731508978406,CSE 29,A51,738840,Soosai Raj; Adalbert Geral,4,0,5,1
1731508978406,CSE 29,A52,738842,Soosai Raj; Adalbert Geral,3,0,5,2
1731508978406,CSE 29,A53,738844,Soosai Raj; Adalbert Geral,4,0,4,0
1731508978406,CSE 29,B50,738846,Soosai Raj; Adalbert Geral,0,0,5,5
1731508978406,CSE 29,B51,738847,Soosai Raj; Adalbert Geral,0,0,5,5
1731508978406,CSE 29,B52,738848,Soosai Raj; Adalbert Geral,1,0,5,4
1731508978406,CSE 29,B53,738849,Soosai Raj; Adalbert Geral,3,0,4,1
1731508979432,CSE 30,A01,788669,Chin; Bryan W.,42,0,50,8
1731508980458,CSE 87,A00,738901,Moshiri; Niema,19,0,20,1
1731508980458,CSE 87,B00,739036,Cottrell; Garrison W,20,0,20,0
1731508981490,CSE 95,A00,739094,Minnes Kemp; Mor Mia,100,0,100,0
1731508982521,CSE 100,A01,788682,Moshiri; Niema,21,0,50,29
1731508983552,CSE 100R,A01,739414,Moshiri; Niema,25,0,50,25
1731508984580,CSE 101,A01,788685,Saha; Barna,0,0,20,20
1731508984580,CSE 101,B01,788713,Saha; Barna,0,0,20,20
1731508985606,CSE 105,A01,786574,Minnes Kemp; Mor Mia,113,0,150,37
1731508986632,CSE 107,A01,786529,Heninger; Nadia A,136,0,146,10
1731508987659,CSE 110,A50,739705,Griswold; William G.,58,0,75,17
1731508987659,CSE 110,A51,739706,Griswold; William G.,74,0,75,1
1731508987659,CSE 110,A52,739707,Griswold; William G.,70,0,75,5
1731508988685,CSE 120,A01,786531,Pasquale; Joseph,88,0,146,58
1731508989710,CSE 122,A01,739739,Pannuto; Patrick William,0,0,25,25
1731508990736,CSE 127,A01,788718,Munyaka; Imani N. S.,174,0,192,18
1731508991766,CSE 130,A01,788720,Jhala; Ranjit,172,0,192,20
1731508992796,CSE 132A,A01,788721,Vianu; Victor Dan,163,0,196,33
1731508993826,CSE 134B,A01,788723,Powell; Thomas Allan,172,0,192,20
1731508994853,CSE 140,A01,786577,Rosing; Tajana Simunic,274,0,300,26
1731508995881,CSE 140L,A01,739761,Eldon; John,148,0,196,48
1731508996908,CSE 142,A01,788724,Swanson; Steven James,179,0,196,17
1731508997938,CSE 147,A00,739766,Rosing; Tajana Simunic,0,0,60,60
1731508998968,CSE 148,A01,785688,Tullsen; Dean Michael,13,0,20,7
1731508999995,CSE 150A,A01,788727,Solares; Edwin A,182,0,196,14
1731509001020,CSE 151A,A01,788728,Shang; Jingbo,171,0,250,79
1731509002050,CSE 151B,A01,787804,Cottrell; Garrison W,163,0,192,29
1731509003076,CSE 152A,A01,788729,Chandraker; Manmohan Krishna,163,0,192,29
1731509004108,CSE 156,A01,786532,Qin; Lianhui,133,0,146,13
1731509005142,CSE 160,A01,788730,Kastner; Ryan Charles,195,0,250,55
1731509006171,CSE 167,A01,788731,Chern; Albert Ren-Haur,176,0,192,16
1731509007202,CSE 169,A01,785224,Rotenberg; Steven Paul,0,0,0,0
1731509008229,CSE 181,A01,770733,Pevzner; Pavel Arkadjevich,31,0,35,4
1731509009259,CSE 190,A00,739790,Bandeira; Nuno Filipe Cabrita,45,0,50,5
1731509009259,CSE 190,B00,739791,Shalev; Aaron D,43,0,50,7
1731509009259,CSE 190,C00,739821,Ousterhout; Amy,36,0,50,14
1731509009259,CSE 190,D00,739834,McAuley; Julian John,189,0,196,7
1731509010287,CSE 191,A00,739839,Minnes Kemp; Mor Mia,9999,0,9999,0
1731509011313,CSE 197,001,799832,Minnes Kemp; Mor Mia,9999,0,9999,0
1731509012345,CSE 202,A00,739848,Impagliazzo; Russell,0,0,0,0
1731509013372,CSE 203B,A01,788732,Cheng; Chung Kuan,0,0,0,0
1731509014398,CSE 207A,A00,739858,Bellare; Mihir,0,0,0,0
1731509015425,CSE 209A,A00,739859,Grier; Daniel T,0,0,0,0
1731509016455,CSE 210,A00,739873,Coblenz; Michael J,0,0,0,0
1731509017482,CSE 219,A00,739901,Vaccaro; Kristen Marie,0,0,0,0
1731509018508,CSE 220,A01,796042,Staff,0,0,0,0
